key	text	tooltip
#Loc;1;text/db/advice_levels.loc		
advice_levels_onscreen_text_2139664523	Противник взяв гору. Треба відступити і перегрупуватися.	true
advice_levels_onscreen_text_2139665423	Вождь, не забувай: допомога і поради доступні в бою. Навчися користуватися ними.	true
advice_levels_onscreen_text_2139663222	Вірність характеризує ставлення персонажа до правлячої партії своєї фракції. До її збільшення призводять деякі політичні дії, а також навички, позитивні особливості та оточення персонажа. Негативні особливості та неприємні події можуть зменшити вірність. Якщо вона впаде до нуля, персонаж почне громадянську війну і може схилити до зради інших ваших підданих.	true
advice_levels_onscreen_text_2139664922	Вирішивши розділити Рим, останній імператор Феодосій довірив вам східну частину імперії. Зараз вона в небезпеці: з північного сходу наближаються орди гунів, від яких тікають навіть найлютіші варвари. Зігнані з насиджених місць вестготи та інші подібні племена пройдуть через ваші землі; не дозволяйте їм завдати шкоди своєму народу! Погляньте і на південний схід: держава Сасанідів досить сильна, щоб зазіхнути на східні землі. На заході поки спокійно, але Західна Римська імперія ледь стримує варварів на своїх кордонах. Можливо, вам вдасться приєднати її і відродити Рим у всій красі колишньої слави!	true
advice_levels_onscreen_text_2139665222	Звістка про напад римлян відправлена нашій кавалерії. Вона скоро повернеться на поле бою. Нам потрібно протриматися до її прибуття!	true
advice_levels_onscreen_text_2139665922	Велісарій поранений, його забрали з поля бою! Втрата полководця нам дорого обійдеться!	true
advice_levels_onscreen_text_2139666022	Тим часом зі сходу до ваших берегів вже придивляються жадібні і кровожерливі вікінги-дани. Будьте насторожі!	true
advice_levels_onscreen_text_1387459530	Обхідний маневр теж може скути ворога. Вишліть потужні бойові порядки противнику в фланг замість того, щоб атакувати в лоб. Тоді противнику доведеться розгорнути фронт, підставивши фланги вашим загонам, які спочатку стояли по центру.	true
advice_levels_onscreen_text_2139658422	Якщо ваша партія стане занадто могутньою, недовіра інших рано чи пізно призведе до боротьби за владу над вашою фракцією. Почнеться [[url:/manual/page/single-player/0037_enc_page_campaign_play_faction_politics#enc_text_politics_civil_war]]громадянська війна[[/url]]: інші партії об'єднаються, щоб захопити столицю і повалити ваш режим. Якщо ж вас вважатимуть занадто слабким правителем, то можуть оголосити ворогом держави і відправити у вигнання.	true
advice_levels_onscreen_text_2139664021	Ми розбиті! Відходимо в місто! Сподіваюся, вороги будуть до нас милосердні!	true
advice_levels_onscreen_text_2139664621	Вождь, вороги напали на наші землі!	true
advice_levels_onscreen_text_2139665021	Язичники встояли! Господи, за що ти залишив нас?!	true
advice_levels_onscreen_text_2139665521	З роками ваші придворні набираються досвіду і мудрості. Слідкуйте за їх розвитком.	true
advice_levels_onscreen_text_2139665621	Щоб наказати стрілецькому загону вступити в рукопашний бій, виберіть цей загін, а потім клацніть по противнику правою кнопкою миші, утримуючи натиснутою клавішу Alt.	true
advice_levels_onscreen_text_1170317847	Загони, що наступають щільним строєм, найкраща мішень для ваших стрільців. Зруйнуйте їх градом стріл, списів і каменів!	true
advice_levels_onscreen_text_2139664620	Вандали перекрили дорогу. В атаку!	true
advice_levels_onscreen_text_2139665120	Армія загартовується і міцніє в боях. Твоє військо стає грізною силою. Вождь, використовуй нові можливості своїх військ з максимальною користю.	true
advice_levels_onscreen_text_2139666120	Перемога на сході дозволить вам об'єднатися з союзними франками, які колись вже здобували перемогу над мусульманами.	true
advice_levels_onscreen_text_2139666220	Ще далі знаходиться Іберія. Далека від рідних берегів, вона, тим не менш, дуже багата і приваблива.	true
advice_levels_onscreen_text_2139658024	Завдання можна переглянути у вікні цілей. За невиконані завдання штрафів немає. Зате за успішне виконання завдання вас чекає нагорода, часто - якийсь позитивний ефект. Якщо завдання неможливо виконати з незалежних від вас обставин, воно буде скасовано.	true
advice_levels_onscreen_text_2139664727	Ми можемо вивести людей на південний берег Дунаю, за кордон Риму. Навряд чи гуни на нас нападуть там. Землі там родючі, люди багаті, можливості для нових завоювань невичерпні.	true
advice_levels_onscreen_text_1212661715	Кинути всю армію в атаку - означає відмовитися від усіх переваг. Навіть якщо вам вистачить сил, щоб перемогти, ви понесете величезні втрати, яких можна було б уникнути.	true
advice_levels_onscreen_text_2045097248	Репресії дозволяють зміцнити вашу владу і [[url:/manual/page/single-player/0044a_enc_page_campaign_play_province_public_order]]громадський порядок[[/url]]. Щоб почати репресії, введіть в поселення гарнізон.	true
advice_levels_onscreen_text_2047305771	Вибравши цей варіант, ви вимагатимете, щоб інша фракція стала вашим данником або маріонетковою державою. Ви будете надавати цій фракції військову підтримку, а натомість отримаєте певний відсоток її доходу, а в разі з маріонетковими державами - ще й необмежене право проходу. При цьому такі фракції можуть виявитися втягнутими у війну проти своєї волі. На відміну від звичайних союзників, вони не можуть не воювати на боці патрона: відмова призведе до війни з самим патроном.	true
advice_levels_onscreen_text_2139664126	Ворожа армія розгромлена, але наша головна мета - захоплення міста. Рухай війська до центральної площі!	true
advice_levels_onscreen_text_2139664326	Вождь, пам'ятай: погода може вплинути на результат битви. Правильно вибирай час для атаки.	true
advice_levels_onscreen_text_2139664626	Вандали встояли! Битва програна! Відходимо до моря!	true
advice_levels_onscreen_text_2139664726	Вождь, настав час нелегких рішень. Гуни наступають, наші сили нерівні. Нам доведеться піти з цих земель, якщо ми хочемо зберегти себе як народ.	true
advice_levels_onscreen_text_2139664826	Вождь, ворог порушив кордон!	true
advice_levels_onscreen_text_2139665126	Вождь, вимагай від римлян дозволу на перехід через Дунай. Навряд чи вони нам відмовлять.	true
advice_levels_onscreen_text_2139665326	Значки руїн на мапі кампанії позначають безлюдні регіони з руїнами покинутих поселень. Якщо поселення знелюднилося недавно, ґрунти навколо нього можуть бути виснажені, але з часом земля відновлює свою родючість. Давно покинуті регіони можуть бути багаті на ресурси.	true
advice_levels_onscreen_text_2139664025	Ти хочеш залишити позицію - і заради чого? Щоб захищати якийсь пагорб, поки вороги палять наші будинки? У цьому є якийсь стратегічний сенс? Ми приречені!	true
advice_levels_onscreen_text_2139664625	Блокада прорвана, вандали зметені! Вперед, на Карфаген!	true
advice_levels_onscreen_text_2139664725	Війна з гунами буде важкою. Нам слід урізноманітнити нашу тактику. Можна найняти агентів для підтримки наших військ або для нанесення ударів по ворогах.	true
advice_levels_onscreen_text_2139665825	Штурмуючи поселення, ви можете пошкоджувати його споруди і тим самим підривати бойовий дух захисників. Щоб дізнатися про те, наскільки вам це вдалося, вкажіть курсором на значок шкоди поселенню праворуч від індикатора балансу сил. Споруди можна знищувати і цілеспрямовано. У суху погоду для цього найкраще використовувати вогняні стріли.	true
advice_levels_onscreen_text_2139658427	Згодом приріст створює надлишок населення в населених пунктах, дозволяючи їм [[url:/manual/page/single-player/0045_enc_page_campaign_play_province_construction]]розширюватися[[/url]]. Деякі будівлі прискорюють [[url:/manual/page/single-player/0044_enc_page_campaign_play_province_regions#enc_text_manual_actions_campaign_provinces_growth]]приріст[[/url]] населення.	true
advice_levels_onscreen_text_2139660224	Зібравши групу з декількох загонів, ви можете передати її під командування штучного інтелекту. Така група буде виконувати базові завдання: атакувати вказану ціль, захищати певну позицію. Знищивши ціль, група продовжить обороняти поточну позицію, поки не отримає інших наказів.	true
advice_levels_onscreen_text_2139663924	Виявлено підтримуваний пристрій сенсорного керування. З його допомогою можна переміщати камеру, командувати військами на полі бою, керувати арміями на мапі кампанії, користуватися меню, а також виконувати безліч інших дій. На додаток до цього, ви можете користуватися екранною клавіатурою, що вмикається за допомогою меню управління. Для перегляду розділу енциклопедії, присвяченого сенсорному управлінню, клацніть [[url:/manual/page/single-player/0005_enc_page_help_keyboard_shortcuts]]тут[[/url]].	true
advice_levels_onscreen_text_2139664424	Вождь, вороги наближаються! Ми повинні прийняти бій або відступити!	true
advice_levels_onscreen_text_2139665524	Облога проходить за планом, мій вождь. Оборона противника слабшає!	true
advice_levels_onscreen_text_2139664429	Один з наших загонів зібрався з духом і готовий атакувати знову! Вони побиті, але не переможені!	true
advice_levels_onscreen_text_2139664829	Вождь, ми перемогли! Доля полонених у твоїх руках. Можеш залишити їх у себе, але іноді корисніше проявити милосердя або жорстокість.	true
advice_levels_onscreen_text_2139665429	Вождь, тобі слід знати: навколо вирує війна, але завжди знаходяться пройдисвіти, які бажають скористатися чужим нещастям. Слідкуй за політичною ситуацією.	true
advice_levels_onscreen_text_2139666029	Довгі століття негараздів загартували народ Ломбардії. Зараз йому знову доведеться встати назустріч смуті, в яку занурюється Італія.	true
advice_levels_onscreen_text_2139666129	Відступаючи, ви залишали за собою випалену землю, щоб нічого не дісталося ворогу. Але все одно ви повинні повернути цю землю собі.	true
advice_levels_onscreen_text_2139664128	Вождь, твій полководець може вплинути на результат битви! Його слово надихає людей! Використовуй його вплив!	true
advice_levels_onscreen_text_2139665928	Командир, вороги вже в місті! Зупиніть їх за будь-яку ціну!	true
advice_levels_onscreen_text_2139666028	Але, незважаючи на всі ці загрози, острови будуть вашими. Меч приведе Мерсію до величі!	true
advice_levels_onscreen_text_2139666328	Наші руки тверді, а дух ще твердіший. Після Риму нас чекає весь світ - велика мета, гідна гарамантів. Очольте свій народ і приведіть його до слави!	true
advice_levels_onscreen_text_1649185866	Тип місцевості впливає на швидкість переміщення загонів. Залишайтеся на дорозі або в низькій траві, щоб рухатися якомога швидше.	true
advice_levels_onscreen_text_2139663933	Погана звістка! Аецій убитий! Почувши про це, наші воїни впадуть духом!	true
advice_levels_onscreen_text_2139664333	Ми взяли Петродаву! Нарешті ми можемо помститися їм, вождь! Розоріть це місто дочиста, щоб весь світ дізнався, що вестготи не зламані.	true
advice_levels_onscreen_text_2139664533	Ми програли битву! Біжимо з поля бою, поки ще не пізно!	true
advice_levels_onscreen_text_1247116376	Якщо у ворога є кіннота або багато легких, рухливих піхотинців, варто тримати легку піхоту і стрільців недалеко від інших загонів підтримки: так їх не застануть зненацька.	true
advice_levels_onscreen_text_2139663932	Гуни наступають! Наближається велика битва!	true
advice_levels_onscreen_text_2139658532	[[url:/manual/page/single-player/0022_enc_page_campaign_play_military_ambush]]Засідка[[/url]] - це несподіваний напад на армію, що проходить. Під час засідки діють особливі правила: ви атакуєте ворога, поки той знаходиться в похідному порядку. Це дуже ефективний прийом, втім, він підходить не завжди. Ворог не зможе розгорнути війська до початку бою. Скористайтеся цим, щоб внести якомога більше сум'яття в його ряди.	true
advice_levels_onscreen_text_2139660231	Вступивши у війну, ви можете вказати ціль для всіх своїх союзників, данників і маріонеткових держав, хоча, можливо, деякі з них відмовляться атакувати її. Згодом союзники і самі можуть доручити вам подібні завдання.	true
advice_levels_onscreen_text_2139664231	Рекрути негайно приступають до тренувань. За їх навчання та спорядження буде заплачено зі скарбниці. Не зважай на витрати: якщо нам судилося загинути, ми дорого продамо свої життя!	true
advice_levels_onscreen_text_2139664631	Ми втратили Ольвію! Наш дім захопили вороги. Люди більше не вірять тобі, воїни не слухаються твоїх наказів. Пора рятуватися втечею, поки твої ж солдати не обернулися проти тебе.	true
advice_levels_onscreen_text_2139665231	Прийшла звістка, що сам імператор Валент загинув на полі бою! Його армія скоро обернеться втечею!	true
advice_levels_onscreen_text_2139665731	Орда - грізна сила, що поєднує продовольчий, економічний і військовий потенціал міста з маневреністю і міццю армії. Це ж є і її недоліком: втративши орду в бою, ви позбудетеся значної частини інфраструктури своєї фракції.	true
advice_levels_onscreen_text_2139665931	Противник перетворений на втечу! Ми перемогли!	true
advice_levels_onscreen_text_2139666231	Ви очолюєте передові загони могутньої імперії ефталітів. Поки ваші співвітчизники відчайдушно борються з державою Гуптів на сході, ви йдете на захід у вічному пошуку нових земель і багатств. На південь від вас розкинулася держава Сасанідів, підтримувана численними союзниками і сатрапами. Очевидно, що шлях до серця перських земель буде нелегким, а найродющі ділянки не здадуться без бою. Однак зараз уми шахів більше займає конфлікт з Візантією; скористайтеся цим, щоб завдати удару в спину. Землі навколо повні ворогів. Ідіть і винищіть їх. Нехай весь світ пізнає силу білих гунів!	true
advice_levels_onscreen_text_2139663230	Полководців, які досягли певного віку або рангу, можна нагороджувати почесними посадами і призначеннями. Це підвищує їхню вірність і вплив, так що посадами можна «підкуповувати» корисних, але потенційно небезпечних персонажів.	true
advice_levels_onscreen_text_2139664930	Прийшовши зі східних степів, ваш народ звик жити в постійному русі і боротьбі. Почувши про нього, цілі племена в жаху зриваються з насиджених місць. Погнавшись за готами, що втекли на південний захід, ви знайдете родючі землі Східної Римської імперії. Вандали, що пішли на захід, приведуть вас до кордонів її західної сестри, яка бідніша, але й слабкіша. На південному сході лежить багата держава Сасанідів, яка тільки й чекає, щоб її розграбували. Але перш ніж кидати виклик так званому «цивілізованому світу», вам варто зміцнити свої позиції, підкоривши північні племена. Весь світ буде танцювати під вашу дудку - або згорить у вогні!	true
advice_levels_onscreen_text_2139665130	Наші споруди в цьому місті пошкоджені. Головні будівлі повинні бути в повному порядку, щоб ми могли ними користуватися.	true
advice_levels_onscreen_text_2139665230	Вождь, наша кавалерія повернулася! Пошли її в бій з римлянами!	true
advice_levels_onscreen_text_2139665330	Щоб захопити покинуте поселення, направте туди свою армію. Колонізація вимагатиме не тільки грошових витрат на відновлення будівель, але й людей для заселення нової території. Кочові племена варварів також можуть захоплювати покинуті регіони.	true
advice_levels_onscreen_text_2139665530	Відмінно! Нові воїни знадобляться нам у майбутніх битвах.	true
advice_levels_onscreen_text_2139665730	Поклоніння великому Годану наклало сильний відбиток на лангобардів: назва і навіть зовнішність вашого народу є даниною мудрості цього бога. Як і він сам, ви компенсуєте брак могутності, такого необхідного в ці неспокійні часи, гострим розумом і дипломатичним талантом. Ваша красномовність вже завоювала серця німецьких сусідів; залишилося тільки вибрати серед них найсильнішого союзника. До вас прихильні і могутні франки з півночі, і сусідні алемани. Щоб довести їм свою цінність, ви можете розправитися з вандалами, які розоряють їхні землі. В кінці шляху вас чекає велика мета: Годан передбачив створення великої імперії лангобардів зі столицею в Римі!	true
advice_levels_onscreen_text_2139666230	Ви стоїте на порозі вічної слави. Вперед, вікінги!	true
advice_levels_onscreen_text_1216301252	Ви вибрали ціль за межами підсвіченої ділянки. Це означає, що персонаж не зможе досягти мети протягом даного ходу. Він продовжить рух протягом наступного ходу, якщо вороги не перегородить йому шлях.	true
advice_levels_onscreen_text_2139664237	Нам слід вдосконалювати методи ведення війни, якщо ми хочемо перемогти в майбутніх битвах. Направ людей на вивчення військової науки і тактики.	true
advice_levels_onscreen_text_2139665337	Від родючості земель провінції залежить виробництво їжі і прибутковість сільського господарства. Зруйновані та покинуті поселення знижують загальну родючість провінції; крім того, на неї впливає зміна клімату та зміна пір року.	true
advice_levels_onscreen_text_2139665637	Щоб вказати ділянку для обстрілу, виберіть метальні машини, а потім клацніть правою кнопкою миші на потрібній ділянці землі, утримуючи клавішу Alt.	true
advice_levels_onscreen_text_2139660136	Різні [[url:/manual/page/single-player/0018_enc_page_campaign_play_military_stances]]бойові порядки[[/url]] дозволяють війську підготуватися до будь-якої ситуації: засідки, [[url:/manual/page/single-player/0021_enc_page_campaign_play_military_sieges]]облоги[[/url]], марш-кидку, будівництва табору і так далі. Зміна бойового порядку коштує декількох очок дій. Військо буде зберігати порядок, поки не отримає новий наказ. Перебуваючи на борту, війська не можуть займати будь-який бойовий порядок.	true
advice_levels_onscreen_text_2139665736	Навіть могутнім воїнам потрібно відпочивати. Щоб дізнатися про переваги табору, вкажіть на його значок в меню режимів армії. Розбивши табір, ви прискорите поповнення і підвищите згуртованість, збільшите дохід і зростання населення, а також уникнете небойових втрат. Взимку наказ розбити табір може врятувати орду від загибелі.	true
advice_levels_onscreen_text_1213263346	Не забувайте: ви повинні захопити [[url:/manual/page/single-player/0084_enc_page_battle_play_phase_conflict_sieges]]поселення[[/url]], а не зруйнувати його! Щоб взяти верх, перебийте або змусьте втекти ворогів або захопіть центральну площу. Перед боєм переконайтеся, що облогові машини розташовані досить близько до ворожих укріплень.	true
advice_levels_onscreen_text_2139664635	Петродава пала! Натовпи біженців залишають місто. Як це могло статися, вождь? На тебе чекає вигнання. Можливо, з тебе вийде хороший землероб, бо правителем ти нікудишній.	true
advice_levels_onscreen_text_2139664935	Ваш народ розділений і перетворений на втікачів лютими гунами, що прийшли зі сходу. Ви, звичайно, можете нічого не робити і просто оселитися в найближчих підхожих землях, але є й більш привабливі можливості. На заході лежать непідкорені поля Риму, а на сході стоять нерозграбовані міста Сасанідів. Ви можете як об'єднати свій народ заради однієї мети, так і продовжити рухатися в двох напрямках відразу. Який би шлях ви не обрали, рано чи пізно він приведе аланів до величі!	true
advice_levels_onscreen_text_2139665135	Вождь, остготи просять миру. Перед обличчям гунських загроз нам слід уважно поставитися до цієї пропозиції.	true
advice_levels_onscreen_text_2139665435	Вождь, битва скоро почнеться! Розставляй загони відповідно до їх сили.	true
advice_levels_onscreen_text_2139665835	Розглядайте бойовий дух ворога як окрему ціль, яку потрібно атакувати. Підірвавши його, ви змусите ворога тікати і завершите бій з меншими втратами. Збиток бойовому духу завдають атаки з флангів, особливість «Страшні», свистячі стріли і бойовий клич вашого полководця. Смерть воєначальника ворога сіє паніку в усьому війську. Щоб підірвати бойовий дух окремого загону, знищіть половину його бійців менш ніж за 60 секунд.	true
advice_levels_onscreen_text_2139665935	Битва програна! Відходимо! Всі назад!	true
advice_levels_onscreen_text_2139666135	Іберійський півострів знову стане християнським. Зійдіть з гір і скиньте загарбників у море під прапором Спасителя!	true
advice_levels_onscreen_text_1264671506	Можна отримати додаткові кошти за рахунок [[url:/manual/page/single-player/0046_enc_page_campaign_play_province_trade_finance]]торгівлі[[/url]]. Використовуйте [[url:/manual/page/single-player/0038_enc_page_campaign_play_faction_diplomacy]]дипломатію[[/url]] для укладення торгових угод.	true
advice_levels_onscreen_text_2139664334	Воїни Євгенія перекрили нам шлях! Битва неминуча!	true
advice_levels_onscreen_text_2139664734	Схоже, римляни не бажають пускати нас на свої землі, вождь. Мабуть, слід звернутися до них ще раз, підсолодивши прохання дзвінкою монетою?	true
advice_levels_onscreen_text_2139665134	Вождь, скарбниця порожня! Солдати не отримують платні, коні не нагодовані, будинки руйнуються! Потрібно терміново вжити заходів, поки не почався бунт!	true
advice_levels_onscreen_text_2139657938	Якщо всі споруди в місті вдосконалені до межі, після певних подій ви зможете побудувати [[url:/manual/page/single-player/0045_enc_page_campaign_play_province_construction# enc_text_manual_actions_campaign_construction_legendary]]легендарну[[/url]] будівлю. Завершену будівлю не можна зруйнувати за жодних обставин. Фракція, яка першою побудує ту чи іншу легендарну будівлю, отримає в нагороду постійну [[url:/manual/page/single-player/0041_enc_page_campaign_play_faction_traits_faction]]особливість[[/url]] і всі супутні ефекти.	true
advice_levels_onscreen_text_2139658438	Після загибелі полководця всі кораблі та загони, що перебували під його командуванням, вважаються розбитими.	true
advice_levels_onscreen_text_2139658039	Ферми, ринки і порти постачають продовольство, яке споживають в поселеннях і деяких [[url:/manual/page/single-player/0045_enc_page_campaign_play_province_construction]]будівлях[[/url]] в межах поселень. Хоча продовольство автоматично розподіляється по всій території, якщо споживається більше, ніж виробляється, можуть початися перебої з продовольством, які, в свою чергу, призводять до заворушень і навіть [[url:/manual/page/ single-player/0044b_enc_page_campaign_play_province_public_order#enc_text_manual_public_order_rebellions]]заворушенням[[/url]]. Не забувайте покращувати будівлі, що виробляють продовольство.	true
advice_levels_onscreen_text_2139663139	При племінному або монархічному устрої вас спробують скинути, якщо ваша влада здасться занадто слабкою. Це призведе до громадянської війни. Подібні конфлікти тривають лише обмежений час, після чого автоматично укладається договір, умови якого визначають баланс сил на момент припинення конфлікту.	true
advice_levels_onscreen_text_2139663339	Чим більше поселення, тим більше їжі потрібно його жителям. З ростом поселення необхідно покращувати споруди, що відповідають за продовольство, інакше перебоїв у постачанні не уникнути.	true
advice_levels_onscreen_text_2139664139	Кажуть, що ворожий полководець загинув у бою! Скоро його воїни зовсім падуть духом!	true
advice_levels_onscreen_text_2139664239	Римляни наближаються! Мечі голі, полонених не брати!	true
advice_levels_onscreen_text_2139664339	Вождь, у мирний час слід менше мріяти про битви і більше приділяти увагу цивільним справам. Керуй провінціями, щоб твоя держава процвітала.	true
advice_levels_onscreen_text_2139664439	І знову в бій! До зброї, воїни! Покажемо їм, як б'ються вестготи!	true
advice_levels_onscreen_text_2139665239	Валент загинув, його армія рятується втечею! Перемога за нами! Тепер у готів знову є майбутнє!	true
advice_levels_onscreen_text_2139666239	Ми, анти, прийшли на схід Європи разом з іншими слов'янами. Однак уже зараз ми знаємо, що нашому народу визначена особлива доля.	true
advice_levels_onscreen_text_2139660238	Якщо початкова пропозиція або вимога іншої фракції вас не влаштовує, не варто відповідати категоричною відмовою. Зробіть зустрічну пропозицію на своїх умовах.	true
advice_levels_onscreen_text_2139664538	Вождь, обережно! Ворожі підкріплення на підході!	true
advice_levels_onscreen_text_2139665538	Ми підготували для вас список стратегічних цілей. Скористайтеся ним, вождь.	true
advice_levels_onscreen_text_2139666038	Насамперед треба зміцнити владу над півостровом. Сполето і Беневенто повинні визнати ваше панування або зникнути назавжди.	true
advice_levels_onscreen_text_2139666338	З честю пройшовши всі випробування, ми зможемо створити велику слов'янську цивілізацію, яка витримає випробування часом. Нам, дітям степів, судилося успадкувати Європу!	true
advice_levels_onscreen_text_1223289843	Якщо не звертати уваги на пошкоджені будівлі, вони будуть [[url:/manual/page/single-player/0045_enc_page_campaign_play_province_construction#enc_text_manual_actions_campaign_construction_repair]]ремонтуватися[[/url]] дуже повільно, зате безкоштовно. Якщо ж будівля зруйнована повністю, виділіть її і натисніть кнопку ремонту.	true
advice_levels_onscreen_text_1242280643	Вивчення нових [[url:/manual/page/single-player/0039_enc_page_campaign_play_faction_technology]]технологій[[/url]] допоможе вам привести фракцію до [[url:/manual/page/single-player/0013_enc_page_campaign_play_objectives]]величі[[/url]]. Щоб вибрати технологію для дослідження, відкрийте вікно технологій відповідною кнопкою.	true
advice_levels_onscreen_text_1245539238	Виснажлива спека і сильний холод втомлюють солдатів, які не звикли до таких погодних умов. Війська, набрані з місцевих жителів, не схильні до впливу цього фактора.	true
advice_levels_onscreen_text_2139664103	Гуни вигнані, Ольвія врятована! Остготи ще заплатять за все, що вони накоїв, але сьогодні ми святкуємо перемогу!	true
advice_levels_onscreen_text_2139664603	Народ збунтувався і піднявся зі зброєю в руках проти нашої влади. Потрібно придушити бунт!	true
advice_levels_onscreen_text_2139665003	Наш хоробрий полководець загинув у бою! Звістка про його смерть засмутила воїнів!	true
advice_levels_onscreen_text_2139666303	Століття тому до нашого порогу прийшли римляни. Вони вигнали наших сусідів і кинули нам виклик. Хоча згодом у нас з ними був мир, вони як і раніше залишаються незваними гостями.	true
advice_levels_onscreen_text_2139664602	Прекрасно! Тепер подивимося, як народ Петродави відповість на запропоновану йому оливкову гілку.	true
advice_levels_onscreen_text_2139664702	Наші кордони розширилися, і тепер ми зустрілися з новими народами на заході, за Карпатськими горами. Якщо пощастить, вони стануть нашими союзниками.	true
advice_levels_onscreen_text_2139665302	Облога поселень може тривати роками, поступово підриваючи надійність міських стін і сили захисників. Чим довше триває облога, тим важче доводиться захисникам поселення і, отже, тим легше нападникам прорвати оборону. Почавши бій після виснажливої облоги, ви помітите, що споруди поселення сильно пошкоджені, а бойовий дух захисників нижчий, ніж зазвичай.	true
advice_levels_onscreen_text_2139666102	Світ чекає на вас, Карле Великий. Об'єднайте свій народ - і королівство франків не знатиме земних кордонів!	true
advice_levels_onscreen_text_2139666202	На півдні ваші союзники-сакси стримують натиск слов'янських кочівників. Об'єднавшись, ви зможете захистити себе від цієї загрози.	true
advice_levels_onscreen_text_2139657902	Армія, яку перевозять на кораблі, може напасти на ворожий порт. Як тільки буде віддано наказ про атаку і кораблі підійдуть до берега, ваші люди зійдуть на сушу і вступлять у бій. Почавши битву, ви не зможете від неї відмовитися. Дружні війська на борту інших кораблів не зможуть вам допомогти. Підкріпленням можуть бути тільки армії, які вже зійшли на берег, причому тільки ті, які ще не втягнуті в бій.	true
advice_levels_onscreen_text_2139664401	Вождь, навіть з облоговими знаряддями штурм цього міста буде нелегким. Подумай ще раз, перш ніж атакувати!	true
advice_levels_onscreen_text_2139665501	Зараз наші воїни готові стріляти без наказу. Якщо треба, накажіть їм берегти боєприпаси.	true
advice_levels_onscreen_text_2139657903	Ворог напав на ваш берег. Якщо ви приймете бій, ваше військо вступить у бій з нападниками. Якщо відмовитеся, ви будете змушені відступити.	true
advice_levels_onscreen_text_2139664000	Вождь, накажи своїм людям атакувати ворога з тилу і флангів! Оточення зламає їхній дух.	true
advice_levels_onscreen_text_2139664400	Остготи зміцнюють свою столицю. Вождь, для штурму нам потрібні облогові знаряддя.	true
advice_levels_onscreen_text_2139664600	Ми програли! Воїни, відходимо до столиці!	true
advice_levels_onscreen_text_2139665000	Вождь, сенат просить нас сісти на кораблі і напасти на піратів, які грабують їхні кораблі. Як ми вчинимо?	true
advice_levels_onscreen_text_2139657704	На вкладці «Журнал» міститься детальна хронологія подій поточної кампанії.	true
advice_levels_onscreen_text_2139660207	Таким чином ви можете офіційно запропонувати іншій фракції закінчити війну.	true
advice_levels_onscreen_text_2139664007	Ворог не встояв перед натиском наших воїнів і втік!	true
advice_levels_onscreen_text_2139664607	Вождь, вороги наближаються! Ми повинні прийняти бій або відступити!	true
advice_levels_onscreen_text_2139664807	Вождь, ми втрачаємо людей у цій війні. Ми повинні поповнити сили на своїй території.	true
advice_levels_onscreen_text_2139665307	Загальна зміна європейського клімату в I тисячолітті н.е. призвела до того, що зими просунулися далеко на південь і стали довшими та суворішими. Тепер сніг може випадати навіть на узбережжі Середземного моря, а в деяких регіонах він буде лежати цілих три ходи і тільки потім розтане.	true
advice_levels_onscreen_text_2139665607	Вплив персонажа залежить від його особистих досягнень - таких, як служба на посаді губернатора, призначення на політичну посаду або військові перемоги. Його можна витратити на участь у політичних інтригах, тому успішний полководець або чиновник може принести вашій родині чималу користь.	true
advice_levels_onscreen_text_1572526606	Якщо ворог зайняв пагорб, підніміться до нього по найпологішому схилу. Навіть якщо це займе більше часу, ваші загони не так втомляться, коли досягнуть вершини пагорба.	true
advice_levels_onscreen_text_2139664906	Ваша влада на сході міцна: великій спадщині Ардашира нічого не загрожує. Прийшов час звернути погляд на захід. Рим розділений і оточений ворогами. Настав найпідхожіший час, щоб повернути землі Малої Азії та Леванту, які по праву повинні належати персам. Однак Східна Римська імперія і її релігія дуже могутні, тому розумніше буде проявити впевнену наполегливість, а не грубу силу. Погляньте і на північ, звідки наближається орда лютих гунів і їх союзників, спраглих багатства і крові цивілізованих народів. Поширивши своє мудре і справедливе правління на весь відомий світ, ви закладете фундамент імперії Сасанідів, яка простоять до кінця днів!	true
advice_levels_onscreen_text_2139665006	Полководець Велісарій важко поранений! Його забрали з поля бою! Солдати стривожені цією звісткою!	true
advice_levels_onscreen_text_2139665206	Вождь, Адріанополь захоплений повстанцями. Можливо, він стане нашим новим домом? Давай захопимо це місто, поки римляни не надіслали підкріплення і не зайняли його!	true
advice_levels_onscreen_text_2139665506	Наші воїни під обстрілом! Накажіть їм розімкнути стрій, щоб зменшити втрати.	true
advice_levels_onscreen_text_2139665906	Воїни, зайняти оборону! Вороги наближаються!	true
advice_levels_onscreen_text_2139664605	Сьогодні ми візьмемо Суассон! В атаку!	true
advice_levels_onscreen_text_2139664805	Вождь, римляни наступають! Сам імператор йде на чолі армії! У нас немає вибору, тільки битися. До зброї!	true
advice_levels_onscreen_text_2139665705	Клацніть в межах сектора, розташованого за кормою, щоб відвести корабель назад у вказаному напрямку.	true
advice_levels_onscreen_text_2139664104	Вождь, воїни готові до бою і чекають наказів.	true
advice_levels_onscreen_text_2139664204	Майстерня була пошкоджена в бою, її слід відновити, щоб робити обладунки.	true
advice_levels_onscreen_text_2139664404	Ми оточили Апулу, наші інженери готові будувати облогові знаряддя. Віддай наказ.	true
advice_levels_onscreen_text_2139664504	Наші вороги кидають щити і рятуються втечею! Перемога за нами!	true
advice_levels_onscreen_text_2139664704	Вождь! Величезне військо гунів наближається до наших земель! Ми повинні захистити наші східні рубежі!	true
advice_levels_onscreen_text_2139665104	370 рік нашої ери. З часу заснування імперії минуло вже 400 років. Колись великий Рим, влада якого на Середземномор'ї була безмежною, занепадає. Справа дійшла до того, що він виявився розділений надвоє.	true
advice_levels_onscreen_text_2139665204	Наші воїни сіли на кораблі, але у них немає досвіду мореплавання. Рада надіслала флот найманців для посилення нашої армії. Об'єднай їх і відправ у море.	true
advice_levels_onscreen_text_2139665304	Чим брудніше поселення, тим більша ймовірність, що в ньому почнеться епідемія. Хвороби призводять до небойових втрат і підривають громадський порядок; до того ж, епідемія може перекинутися на інші регіони торговими шляхами, а також разом з військами і агентами. Для запобігання хвороб зводите санітарні споруди або зносьте будівлі, що збільшують забруднення.	true
advice_levels_onscreen_text_2139657708	На вкладці [[url:/manual/page/single-player/0044a_enc_page_campaign_play_province_wealth#enc_text_manual_actions_campaign_wealth_tax]]податків[[/url]] ви дізнаєтеся про те, які податки ви збираєте і як податкове навантаження впливає на громадський порядок. Тут же можна змінити податкову ставку у вашій державі. Крім того, ви можете перейти в [[url:/manual/page/single-player/0044_enc_page_campaign_play_province_regions]]провінцію[[/url]] з найнижчим рівнем [[url:/manual/page/single-player/0044a_enc_page_campaign_play_province_public_order]]громадського порядку [[/url]]. Зазвичай зниження податкової ставки дозволяє поліпшити настрій населення.	true
advice_levels_onscreen_text_2139660209	Сила конфедерації в єдності фракцій, які об'єдналися перед обличчям спільної небезпеки. У цьому випадку окремі фракції втрачають свободу дій і передають свої найкращі війська і кораблі конфедерації. Держава, яка вела війну з фракцією, що увійшла в союз, може оголосити війну всім учасникам нового союзу.	true
advice_levels_onscreen_text_2139664709	У війні з гунами нам слід використовувати різноманітну оборонну тактику. Наприклад, засідки, польові укріплення - так ми отримаємо перевагу, якої позбавлені в зіткненні на відкритій місцевості.	true
advice_levels_onscreen_text_2139665409	Вождь, не витрачай час на готових на північ від нас! Ми повинні взяти столицю. Якщо Апула впаде, остготи будуть розгромлені.	true
advice_levels_onscreen_text_2139665909	Вороги прорвали оборону! Тисніть їх!	true
advice_levels_onscreen_text_2139664208	Ремонт майстерні почнеться негайно. Вождь, ми зробили все, що могли. Залишається лише приготуватися до нападу ворога.	true
advice_levels_onscreen_text_2139664308	Нові загони можна формувати тільки на своїй території. Найманців можна набирати, де завгодно. Нам слід подумати про посилення армії в ході кампанії.	true
advice_levels_onscreen_text_2139664508	Солдати, бачите свого ворога? Ці боягузи тікають, у них більше не залишилося волі до боротьби! Ми перемогли!	true
advice_levels_onscreen_text_2139666008	Приборкавши їх, ви убезпечите свої кордони. Більш серйозну загрозу становить Нортумбрія: розправившись з піктами, вона може стати вкрай небезпечним ворогом. Єдиний вихід - вчасно поглинути її.	true
advice_levels_onscreen_text_2139666108	Ваш народ боровся з мусульманами за кожну п'ядь землі, але він не може вічно ховатися за Кантабрійськими горами. Вороги не послаблюють натиск.	true
advice_levels_onscreen_text_1229686133	[[url:/manual/page/single-player/0044a_enc_page_campaign_play_province_public_order]] Громадський порядок[[/url]] відображає, наскільки населення покірне вашій владі. Занадто велика кількість незадоволених може призвести до [[url:/manual/page/single-player/0044a_enc_page_campaign_play_province_public_order#enc_text_manual_public_order_rebellions]]бунтів[[/url]]. Щоб запобігти їм, утримуйте податки на прийнятному рівні, забезпечуйте жителів їжею і розміщуйте в [[url:/manual/page/single-player/0044_enc_page_campaign_play_province_regions]]поселеннях[[/url]] гарнізони.	true
advice_levels_onscreen_text_1060240560	Організовуючи засідку, використовуйте маленькі, рухливі з'єднання в якості приманки. Залиште їх на виду, нібито наодинці, і сховайте неподалік сильну засідкову групу.	true
advice_levels_onscreen_text_2139665013	Ми вбили їхнього полководця! Дізнавшись про його долю, ворожі воїни впадуть духом!	true
advice_levels_onscreen_text_2139665213	Веселіше, солдати! Сам імператор йде вітати нас! Давайте влаштуємо теплий прийом йому і його армії!	true
advice_levels_onscreen_text_2139665313	Персонажів, залучених до політики, можна призначати губернаторами або полководцями. Губернатор може видавати провінційні едикти; при цьому на управління провінцією впливають його особливості, навички та оточення. У разі війни він особисто очолює гарнізон свого поселення на полі бою.	true
advice_levels_onscreen_text_2139658011	Кожна фракція має свої особливості. Вони діють за тим самим принципом, що й особливості персонажів: кожна з них має певний позитивний або негативний вплив на вашу державу. Особливості фракції не змінюються. Дізнатися про них більше можна на вкладці «Звіт».	true
advice_levels_onscreen_text_2139664112	До зброї, воїни! Будьте уважні! Уміння кожного з вас можуть вплинути на хід битви, тож використовуйте їх! В атаку!	true
advice_levels_onscreen_text_2139665112	Візантійському двору в Константинополі доводиться мати справу з релігійними заворушеннями та загрозою нападу Сасанідів.	true
advice_levels_onscreen_text_2139665512	Вождь, римляни стурбовані нашими віруваннями. Вони просять вас прийняти християнство. Якщо ви погодитеся, ми безсумнівно наслідуватимемо ваш приклад.	true
advice_levels_onscreen_text_2139666212	На заході, за морем, лежить острів Британія. Колись він входив до могутньої імперії, але її влада прийшла до кінця. Місцеві жителі, які загрузли в міжусобицях, навряд чи зможуть дати вам відсіч.	true
advice_levels_onscreen_text_2139666312	Втім, зараз їхня сила слабшає. Зайняті війною з північними гунами і варварами, вони приділяють Африці мало уваги. Ми можемо скористатися цим і повернути узбережжя собі.	true
advice_levels_onscreen_text_1000206666	На мапі кампанії одночасно натисніть Ctrl і S, щоб швидко зберегти гру. Натисніть Ctrl і L, щоб завантажити останнє швидке збереження. На легендарному рівні складності цього зробити неможливо.	true
advice_levels_onscreen_text_2139657712	Екран [[url:/manual/page/single-player/0046_enc_page_campaign_play_province_trade_finance]]торгівлі[[/url]] показує всі ресурси, що виробляються на ваших землях. Окремо позначені продукти, які йдуть на експорт. Тут же список ресурсів, які ви отримуєте від партнерів по торгівлі або зможете отримати, уклавши торговельну угоду. Для створення деяких [[url:/manual/page/single-player/0045_enc_page_campaign_play_province_construction]]будівель[[/url]] і [[url:/manual/page/single-player/0017_enc_page_campaign_play_military_recruit]] загонів[[/url]] необхідні певні типи ресурсів.	true
advice_levels_onscreen_text_2139664611	Вождь, громадський порядок понад усе. Ти повинен заспокоїти людей, інакше вони повстануть.	true
advice_levels_onscreen_text_2139665611	Чоловіків вашої фракції можна призначати на губернаторські та політичні посади. Для цього виберіть персонажа чоловічої статі, а потім клацніть на потрібну посаду в списку, розташованому в правій частині вікна.	true
advice_levels_onscreen_text_1041566911	Відбити атаку, що вже почалася, у фланг набагато складніше, ніж перешкодити противнику закінчити обхідний маневр. У цьому вам допоможе кіннота: для таких випадків тримайте її на флангах.	true
advice_levels_onscreen_text_2087532824	Не давайте ворогу сидіти в укриттях, краще використовуйте онагри та інші облогові знаряддя, щоб вибити його з укриття. Постарайтеся вигнати ворога на відкрите місце, так його буде легше добити.	true
advice_levels_onscreen_text_2139664510	Вороги зламані, вони розвертаються і тікають! Перемога за нами!	true
advice_levels_onscreen_text_2139664810	Дні стають все коротшими, дмуть холодні вітри. Скоро почнуться снігопади. Якщо армія опиниться взимку в чистому полі, вона втратить боєздатність.	true
advice_levels_onscreen_text_2139665110	Сенат Західної Римської імперії в Медіолані, що загруз у корупції, бореться з постійними заколотами і вторгненнями північних варварів.	true
advice_levels_onscreen_text_2139665810	У вашому оточенні завжди є надмірно честолюбні люди. Їх потрібно контролювати за допомогою дій, спрямованих на зменшення впливу або зміцнення вірності. Не допускайте, щоб лідер фракції втратив авторитет. Якщо його вплив впаде, військові перемоги виправлять становище.	true
advice_levels_onscreen_text_2139666110	Однак у вас є надія. На сході правителі Памплони, Сарагоси і Барселони відмовилися визнавати владу загарбників і повстали проти їх жорстокості. Їхній заколот підриває могутність Омеядів; захопивши ці ділянки, ви отримаєте силу для подальшої боротьби!	true
advice_levels_onscreen_text_1110538712	Війська можна розміщувати в поселеннях, щоб захистити жителів у разі [[url:/manual/page/single-player/0021_enc_page_campaign_play_military_sieges]]нападу[[/url]]. Крім того, присутність солдатів в поселенні знижує рівень [[url:/manual/page/single-player/0044b_enc_page_campaign_play_province_public_order#enc_text_manual_public_order_rebellions]]заворушень[[/url]].	true
advice_levels_onscreen_text_2139664517	Нас потіснили! Вождь, час відступати!	true
advice_levels_onscreen_text_2139664717	Не потрібно виснажувати себе війною, вождь. Тобі не обов'язково особисто керувати кожною сутичкою.	true
advice_levels_onscreen_text_2139665017	Імператор Феодосій загинув у бою! Ми залишилися без полководця!	true
advice_levels_onscreen_text_2139665117	Ні ті, ні інші ще не знають про наближення нової біди. Зі сходу йде велика орда гунів. Всім, хто опинився на її шляху, залишається тільки втеча або смерть.	true
advice_levels_onscreen_text_2139664016	Дух наших воїнів зламаний! Вони тікають з поля бою!	true
advice_levels_onscreen_text_2139664116	Вождь, місцевість приховує пересування ворога. Не втрачай пильності.	true
advice_levels_onscreen_text_2139664216	Рекрути готові до бою. Нехай продовжують тренування в очікуванні нападу.	true
advice_levels_onscreen_text_2139664316	Ми прийшли до Петродави, але захисники переважають нас числом. Штурм - не найкраще рішення.	true
advice_levels_onscreen_text_2139664816	Вождь, прийшла весна. Пора воювати. Піднімай армію.	true
advice_levels_onscreen_text_2139664916	Розділивши Рим, останній імператор Феодосій залишив вам важку спадщину. Ваші армії відчайдушно намагаються захистити Західну Римську імперію від варварських орд, а непомірні військові та цивільні витрати спустошують скарбницю. До того ж, громадський порядок в країні залишає бажати кращого; можливо, буде розумніше зосередити війська ближче до столиці, пожертвувавши прикордонними територіями. Зміцнивши інфраструктуру і позбувшись безпосередніх загроз, ви будете готові завдати удару у відповідь. Підкоріть землі своїх ворогів, а якщо зумієте, то і Східну Римську імперію. Створіть велику державу, гідну самого Августа!	true
advice_levels_onscreen_text_1019079545	Нападаючи на нерухомого ворога, не зближуйтеся з ним: краще почніть обстріл здалеку. Навіть якщо у ворога більше стрільців, така тактика може бути корисною.	true
advice_levels_onscreen_text_1621609724	Кнопкою [[url:/manual/page/single-player/0092n_enc_page_battle_play_interface_withdraw]]«Відкликати»[[/url]] можна вивести з бою загін або корабель, який найкоротшим шляхом попрямує до кордону мапи. Поки загін не покинув поля, його можна повернути - накажіть йому атакувати нову ціль або переміститися.	true
advice_levels_onscreen_text_2032462934	Розгортаючи війська, ви можете таємно поставити свої загони на вигідні позиції в межах зони розміщення ще до початку бою. Коли будете готові, натисніть на кнопку з сувоєм.	true
advice_levels_onscreen_text_2139664315	Вождь, це згубна місцевість. Тут мало їжі і немає укриттів. Якщо ми розіб'ємо табір тут, то втратимо багато людей.	true
advice_levels_onscreen_text_2139665715	Параметр «Режим союзу», доступний в меню налаштувань гри, допоможе вам розрізняти своїх і чужих на полі бою. Якщо він увімкнений, війська гравця забарвлюються в жовтий колір, союзники - в синій, а вороги - в червоний.	true
advice_levels_onscreen_text_2139666215	Південніше, на материку, живуть франки. Зараз вони роздроблені, але з появою єдиного короля можуть набути могутності. Було б мудро напасти на них, поки вони слабкі.	true
advice_levels_onscreen_text_2139660214	Уклавши оборонний союз, фракція зобов'язується надавати військову допомогу, тільки якщо союзнику офіційно оголосили війну. У цьому випадку всі інші союзники вступають у війну проти агресора. Оборонний союз може перерости у військовий або привести до утворення залежної держави.	true
advice_levels_onscreen_text_2139664214	Вороги наступають з двох боків! Будемо сподіватися, що встигнемо організувати оборону!	true
advice_levels_onscreen_text_2139664414	Вождь, наша армія готова штурмувати Апулу. Дійте без зволікання!	true
advice_levels_onscreen_text_2139664614	Наша армія зросла, і наші доходи більше не покривають витрати на її утримання. Якщо ми не вживемо термінових заходів, ми збанкрутуємо.	true
advice_levels_onscreen_text_2139665414	Вождь, ми можемо переміщати загони між арміями в міру необхідності. Розділи свою армію для боротьби з розрізненими силами ворога або об'єднай її для великої битви. Вибір за тобою.	true
advice_levels_onscreen_text_2139665714	У осілих варварів немає спеціальних військових споруд, але вони й не потрібні: у воєнізованому варварському суспільстві майже всі будівлі дозволяють наймати війська.	true
advice_levels_onscreen_text_2139658019	Тут показані нагороди, отримані за вирішення складних питань, в результаті певних подій, за виконання завдань, а також під впливом особливостей фракції. Особливості дають постійний ефект, інші поліпшення діють лише кілька ходів. Серед таких поліпшень додаток до доходу, здешевлення вербування або будівництва, додатковий досвід для загонів і так далі.	true
advice_levels_onscreen_text_2139658419	Коли [[url:/manual/page/single-player/0044b_enc_page_campaign_play_province_public_order#enc_text_manual_public_order_happiness]]незадоволення[[/url]] стає занадто сильним, може статися бунт або повномасштабний [[url:/manual/page/single-player/0044b_enc_page_campaign_play_province_public_order#enc_text_manual_public_order_rebellions]]повстання[[/url]]. Його можуть спровокувати такі фактори: [[url:/manual/page/single-player/0044_enc_page_campaign_play_province_regions#enc_text_manual_actions_campaign_provinces_growth]]нестача їжі[[/url]], високі податки, [[url:/manual/page/single-player/0044_enc_page_campaign_play_province_regions#enc_text_manual_actions_campaign_construction_culture]]конфлікти культур[[/url]] і ворожі армії, які розоряють ваші землі.	true
advice_levels_onscreen_text_2139664619	Перемога! Суассон пав! Ці землі належать франкам!	true
advice_levels_onscreen_text_2139664819	Вождь, скарбниця порожня! Солдати не отримують платні, коні не нагодовані, будинки руйнуються! Люди більше не вірять у тебе. Війна закінчена!	true
advice_levels_onscreen_text_2139665419	Вождь, уважно розставляй війська в бою! Кожен загін повинен прикривати фланг сусіда!	true
advice_levels_onscreen_text_2139665919	Ворожий полководець загинув у бою! Тепер його воїни втратять мужність!	true
advice_levels_onscreen_text_2139666319	Але пам'ятайте, що ми не єдиний африканський народ, який претендує на землі імперії. Щоб вони дісталися нам, слід діяти швидко і рішуче.	true
advice_levels_onscreen_text_1838504917	[[url:/manual/page/single-player/0018_enc_page_campaign_play_military_stances#enc_text_manual_actions_campaign_stances_raid]]Руйнуйте[[/url]] ворожі торгові шляхи, щоб їхній дохід не обернувся проти вас. Але пам'ятайте: напад на мирних торговців - це оголошення війни!	true
advice_levels_onscreen_text_2139665118	Скоро цей вибір постане і перед готами, які загрузли в міжусобицях. Те, що почалося як громадянська війна, закінчиться переселенням готів на землі Риму, появою гунів біля кордонів імперії і смертю імператора на полі бою...	true
advice_levels_onscreen_text_2139665718	Коли мігруюча фракція займає перше поселення, її орди втрачають всі споруди і перетворюються на звичайні армії. Це може призвести до підриву вашої економіки. Щоб уникнути подібних проблем, постарайтеся захопити кілька поселень відразу.	true
advice_levels_onscreen_text_2139666018	За морем лежать багаті землі Ірландії, але з ними краще бути обережними: місцеві жителі непокірні і дуже небезпечні.	true
advice_levels_onscreen_text_1412070137	Коли загін вступає в бій і перемагає, він отримує [[url:/manual/page/single-player/0028_enc_page_campaign_play_military_experience]]досвід[[/url]], який в подальшому дозволить битися ще ефективніше. Серед іншого, досвід підвищує бойовий дух. Досвідчені бійці з меншою ймовірністю втечуть навіть у важкій бойовій обстановці.	true
advice_levels_onscreen_text_2139657960	Вся інформація про вашу фракцію зібрана у вікні управління фракцією.	true
advice_levels_onscreen_text_2139664063	Підкріплення прибуває морем! Висаджуй їх на сушу, скоро вони знадобляться!	true
advice_levels_onscreen_text_2139664463	Вождь, наш полководець загинув на полі бою. Як таке могло статися?	true
advice_levels_onscreen_text_2139664963	Настав час великого переселення. На захід йде орда гунів, яка руйнує все на своєму шляху і зганяє народи з насиджених місць. Ведіть свій народ в родючі землі за Рейном: сили Західної Римської імперії занадто розтягнуті, щоб перешкодити вам переселитися туди. Але в ці землі прагнуть і інші племена, тож на вас чекає неабияка боротьба. Не забувайте і про землі за Середземним морем: Африка теж може стати вашою. Підкорення морських просторів відкриє перед вами справді безмежні можливості. Тоді Вандальське царство буде правити всім світом!	true
advice_levels_onscreen_text_2139665263	Вождь, наші люди доповідають, що будівлі в цьому місті зруйновані. Їх слід відновити.	true
advice_levels_onscreen_text_2139665463	Римлян занадто багато! Відходимо до берега! Битва програна, повелитель!	true
advice_levels_onscreen_text_2139665763	У розпорядженні західних і східних римлян з самого початку гри є ряд технологій, які перераховані в лівій частині відповідного екрану. Однак коли ці фракції знайдуть нові шляхи виживання в зміненому світі, ці старі знання будуть втрачені.	true
advice_levels_onscreen_text_2139666263	До того ж, землі, через які пройшли гуни, можуть дістатися нам. Так, вони випалені і порожні, але вправні землероби слов'ян здатні повернути родючість будь-якому ґрунту.	true
advice_levels_onscreen_text_1424352004	Ця кнопка переводить всі можливі загони в [[url:/manual/page/single-player/0092j_enc_page_battle_play_interface_melee]]режим ближнього бою[[/url]]. Отримавши наказ атакувати, ваші люди будуть битися в ближньому бою, поки ви знову не натиснете на цю кнопку.	true
advice_levels_onscreen_text_2139664262	На місця, воїни! Не віддамо Равенну!	true
advice_levels_onscreen_text_2139665462	Ворожі моряки рятуються втечею! Наше царство врятовано!	true
advice_levels_onscreen_text_2139665562	Погані новини, вождь! Частина наших загонів підняла бунт і готується розв'язати громадянську війну. Бунтівників потрібно розгромити, хоча це сильно підірве нашу військову міць.	true
advice_levels_onscreen_text_2139666262	Наближаються гуни. Гнані мінливим кліматом, вони рвуться зі своїх степів, знищуючи все на своєму шляху. Вже скоро їхня дика орда підійде до наших кордонів. Але надія ще є: можливо, ми зуміємо вирішити справу миром і купити свою безпеку.	true
advice_levels_onscreen_text_2139664061	Ще одна атака! Гуни наближаються під прикриттям лісу! Зброю до бою!	true
advice_levels_onscreen_text_2139666161	Ваш народ живе в Паннонії вже багато століть, але зараз для нього настали непрості часи.	true
advice_levels_onscreen_text_2139658563	Будьте обережні, стріляючи по ворогу, якщо ваші війська вже вступили в рукопашну: ви можете потрапити по своїх!	true
advice_levels_onscreen_text_2139660260	Перед початком бою подумайте про те, в якому шикуванні виводити ваших воїнів. Грамотний вибір бойової побудови може визначити результат всієї битви.	true
advice_levels_onscreen_text_2139664960	Колись ваш народ жив на північ від Дунаю, а зараз він знову змушений покинути насичені місця, рятуючись від навали гунів. Ваші родичі гепіди вже підкорені; звільнивши їх, ви зможете відвоювати свої землі. Однак гунів це не зупинить, тому буде розумніше продовжити шлях, поки ви не знайдете підхоже місце, щоб оселитися і накопичити сили. Східна Римська імперія багата і сильна, так що краще відправитися в родючі, але менш захищені західні краї. Там ви зможете повернути втрачену могутність. Велике і освічене Остготське царство стане надійним заслоном на шляху темряви!	true
advice_levels_onscreen_text_2139658364	Пам'ятайте, що у кожного вашого загону є унікальні [[url:/manual/page/single-player/0085_enc_page_battle_play_phase_conflict_abilities]]уміння [[/url]], що дозволяють йому краще проявити себе в бою.	true
advice_levels_onscreen_text_2139663967	Повелитель, ми програли цю битву! Йдемо, поки ще не пізно!	true
advice_levels_onscreen_text_2139664367	Вождь, твої командири набувають досвіду з кожною перемогою! Правильно використовуй їхні нові здібності!	true
advice_levels_onscreen_text_2139664767	Римська імперія сильна, але її територія занадто розтягнута, і допомога союзників їй не завадить. У Константинополі спалахнуло повстання, там потрібна наша допомога.	true
advice_levels_onscreen_text_2139664867	Народ все ще бунтує. Повстання має бути придушене, але слід подумати про зниження податків або посилення гарнізону, щоб уникнути заворушень у майбутньому.	true
advice_levels_onscreen_text_2139665867	Ваш народ - останній оплот культури піктів у Британії. Римляни, які захопили більшу частину острова, загнали вас в холодні північні землі, немов собак у клітку, але цим посіяли насіння власної загибелі. За довгі роки суворого життя ваш народ озлобився і здичавів: його воїнам не терпиться накинутися на залишки вмираючої імперії за валом Адріана. До них готові приєднатися ебдани, що живуть за великою водою, а ось каледонських сусідів, зломлених багаторічною війною, схоже, доведеться вмовляти. Але разом з ними ви зможете увірватися в південні землі вихором вогню і смерті!	true
advice_levels_onscreen_text_2139660266	Починаючи облогу поселення, не забудьте вибрати оптимальне шикування!	true
advice_levels_onscreen_text_2139665466	Наш полководець убитий! Його смерть - величезна втрата для всієї армії!	true
advice_levels_onscreen_text_2139665666	Поповнення відбувається швидше, якщо корабель знаходиться у вашому морському регіоні або в морському регіоні союзника.	true
advice_levels_onscreen_text_2139665866	Якщо військові сили орди складаються з одного полководця, то в разі його смерті (наприклад, в результаті замаху або від старості) все населення і споруди цієї орди будуть втрачені. Слідкуйте, щоб у підпорядкуванні ватажка орди завжди були загони.	true
advice_levels_onscreen_text_2139666066	Але найбільшою загрозою все ж залишаються франки. Поки вони роздроблені, але якщо у них з'явиться єдиний король, перед ними не встоїть ніхто.	true
advice_levels_onscreen_text_2139666166	Південні сусіди-хорвати намагаються повалити ваш каганат, а з півночі натискають інші слов'янські племена, спонукувані заздрістю до родючих аварських земель. Цю загрозу не можна залишати без уваги.	true
advice_levels_onscreen_text_2139657866	Захопивши поселення, ви можете зробити його своїм або просто розграбувати. В останньому випадку ваша скарбниця отримає більше золота, зате громадський порядок знизиться набагато сильніше, ніж якби ви просто зайняли поселення.	true
advice_levels_onscreen_text_2139664265	Але що це? Гуни напали на остготів і розбили їх наголову! Ми врятовані!	true
advice_levels_onscreen_text_2139665065	Наші безстрашні воїни вбили імператора Юліана! Тепер його армія впаде духом!	true
advice_levels_onscreen_text_2139665165	Вождь, наші люди більше не прив'язані до землі. Ми починаємо переселення. Сенат вимагає нашої допомоги в землях на південь від Дунаю - там спалахнуло громадянське повстання.	true
advice_levels_onscreen_text_2139665365	В обложеному поселенні є певні точки, захоплення яких дає вашій армії різні переваги. До таких точок належать ворота, вежі та площі. Щоб захопити точку, ваші воїни повинні перебувати біля неї доти, доки замість ворожої прапори не буде піднято ваше. Чим більше загонів знаходиться поруч з точкою, тим швидше це відбувається. Вершники можуть захоплювати точки, не злізаючи з коней.	true
advice_levels_onscreen_text_2139665865	Після багаторічних мандрів північними берегами і островами ваш народ нарешті знайшов батьківщину. Пекучий крижаний вітер і суворі чорні води ще свіжі у вашій пам'яті, тому ви сповнені рішучості розгромити ворожих варинів. Для цієї мети вам варто заручитися підтримкою сусідніх ругіїв. Але ваша нова батьківщина неродюча і бідна; вибравши талановитого полководця і відправивши його на південь, ви зможете обзавестися кращими землями, що спорожніли в смутні часи. Насіння, кинуте в цей родючий грунт, може вирости у велике місто, а при належному догляді - і в імперію.	true
advice_levels_onscreen_text_2139666265	Нехай гуни грабують і палять інших! Там, де пройшла хвиля їхнього нестримного гніву, залишається мир. Наш мир!	true
advice_levels_onscreen_text_1590729744	На вкладці «Звіт» відображаються основні статистичні дані про вашу фракцію, за допомогою яких ви можете швидко оцінити хід кампанії.	true
advice_levels_onscreen_text_2139665964	Довгі століття ваша держава мирно процвітала далеко від світових цивілізацій, залишаючись останнім з великих африканських царств. Але спокійні часи закінчилися: через зростання важливості індійського шляху Прянощів Аксум опинився в центрі загальної уваги. Рим бачить у вас цінного союзника, натякаючи на спільну віру і загрозу з боку хім'яритів. Ви можете скористатися цією дружбою, щоб перетнути Червоне море і підкорити собі всі торгові шляхи Сходу, а можете відмовитися від неї і повернутися до давніх традицій свого народу. Можливо, це дозволить вам об'єднати регіон і назавжди відігнати римлян від берегів Африки. Доля царства у ваших руках!	true
advice_levels_onscreen_text_1629386802	Ви можете зайняти [[url:/manual/page/single-player/0044_enc_page_campaign_play_province_regions]]поселення[[/url]], не вступаючи в бій: терплячий [[url:/manual/page/single-player/0047a_enc_page_campaign_play_characters_generals_admirals]]полководець[[/url]] може уникнути битви, протримавши місто в облозі протягом декількох ходів. Це довго, зате рано чи пізно голод і невдоволення простих городян відкриють перед вами ворота міста.	true
advice_levels_onscreen_text_2139658369	Дипломатичні відносини або війна можливі тільки з тими фракціями, з якими у вас є спільні кордони. Відправляйте кораблі вздовж берегів, посилайте агентів в незвідані землі, щоб зустріти інші фракції, але будьте обережні! Не заходять занадто далеко без надійного прикриття, щоб не стати жертвою вороже налаштованих сусідів. Крім того, ваш корабель може залишитися без команди, зайшовши занадто далеко у відкрите море.	true
advice_levels_onscreen_text_2139658569	У вікні фінансів відображається інформація про ваше фінансове становище, включаючи оподаткування і торгівлю.	true
advice_levels_onscreen_text_2139664169	Гуни - кочові воїни зі східних степів, ми дуже мало знаємо про них. Вони воюють верхи, грабують і спустошують все на своєму шляху. Ще одна армія помічена біля наших земель. Вони ще пошкодують про те, що вступили на службу до ворогів вестготів.	true
advice_levels_onscreen_text_2139664469	Наш полководець загинув! Звістка про його смерть вже поширюється серед воїнів!	true
advice_levels_onscreen_text_2139665069	Наш хоробрий полководець віддав життя в бою! Вшануймо його пам'ять перемогою!	true
advice_levels_onscreen_text_2139665969	Ви - справжні володарі Аравійського півострова, спадкоємці славних традицій арабських царств. Колись ваш народ боровся за контроль над багатими портами Сходу, але з часом зросла сила дозволила йому підкорити сусідів і створити велику державу, яка за кілька століть розвитку увібрала в себе тільки найкраще. Зараз вашому процвітанню загрожує Аксумське царство, яке зміцнилося завдяки прийняттю християнства і дружбі з Римом. Щоб відвести загрозу, завдайте удар першими. Приборкавши аксумітів, як слід, замисліться над питаннями релігії. Що буде краще: повернутися до віри предків або прийняти іудаїзм, щоб стати новим Богообраним народом?	true
advice_levels_onscreen_text_2139666069	Вороги всюди, але Ломбардія знала і більш жорстокі бурі. Якщо треба, вона буде битися з усім світом!	true
advice_levels_onscreen_text_2139666269	Наш народ знайшов домівку в жорстокій боротьбі, заплативши за неї своєю і чужою кров'ю. І зараз, коли весь світ тріщить по швах, ми не поступимося ні п'яди своєї землі.	true
advice_levels_onscreen_text_1224585565	Відправляючи кінноту галопом, будьте обережні: вона швидко втомиться від такого темпу, а втомлені загони гірше проявляють себе в бою.	true
advice_levels_onscreen_text_1259146729	Фракція стала вашим данником або маріонетковою державою. Ви будете надавати їй військову підтримку, а натомість отримаєте певний відсоток її доходу, а в разі з маріонетковими державами - ще й необмежене право проходу. При цьому такі фракції можуть виявитися втягнутими у війну проти своєї волі. На відміну від звичайних союзників, вони не можуть не воювати на боці свого пана: відмова призведе до війни з самим патроном.	true
advice_levels_onscreen_text_2139663968	Вождь, з'явилися остготи! Їхнє військо незліченне! Подивись сам!	true
advice_levels_onscreen_text_2139664668	Ворог викликає на бій! Треба діяти!	true
advice_levels_onscreen_text_1020531268	Розмістивши воєначальника неподалік від його людей, ви підвищите бойовий дух війська.	true
advice_levels_onscreen_text_2139663973	Вождь, наші воїни готові. Вони поклялися, що нога остгота не ступить на землю Ольвії!	true
advice_levels_onscreen_text_2139665873	Каледонцям добре знайомий гіркий смак поразки. Велика змова вільних племен проти Риму була придушена саме на ваших землях, що обернулося їх розоренням. Тепер же вас турбують чутки, що пікти і ебдани - ваші сусіди і кровні брати - готують нове повстання заради звільнення Британії. Ви відмовилися брати в ньому участь, замість цього звернувшись до заморських союзників. Сакси, відчувши слабкість Риму, вже поспішають до східних берегів. Вони не заспокояться доти, доки не наздоженуть останнього загарбника ваших земель. Приєднавшись до них, ви зможете отримати свою частку здобичі.	true
advice_levels_onscreen_text_2139666073	Ваш батько привів франків до величі, але залишив вам лише половину королівства.	true
advice_levels_onscreen_text_2139666173	Франки, що живуть на заході, загрузли в міжусобицях, але рано чи пізно вони об'єднаються і піднімуть меч проти всіх, хто не поклоняється єдиному богу.	true
advice_levels_onscreen_text_1431102331	Готуючись прийняти удар кінноти, піхотний загін повинен бути нерухомим. У такому випадку воїни встигнуть підготуватися до бою і понесуть менше втрат.	true
advice_levels_onscreen_text_2139664972	Світ змінюється. Попереду довгі холоди; щоб вижити, вашому народу доведеться покинути рідні землі і відправитися на південь. Але для початку спорядіть кораблі і розвідайте сусідні береги. Племена, що їх населяють, безсилі перед вашими воїнами, а щедра здобич забезпечить вас засобами для майбутніх випробувань. Вам належить завоювати далекі землі старіючих імперій, роздираних віковими чварами, і жалюгідних народів, повністю позбавлених волі до перемоги. По морю чи по суші, але ви повинні прийти на південь і підкорити його. Тоді про ваші подвиги складатимуть пісні до кінця днів!	true
advice_levels_onscreen_text_2139665172	Вождь, у нас погані новини! Командувач флотом впав за борт у бою і загинув!	true
advice_levels_onscreen_text_2139665472	Наші воїни під обстрілом! Направте їх в укриття або вбийте ворожих стрільців!	true
advice_levels_onscreen_text_2139665572	Служачи вам, персонажі набудуть впливу при дворі. Не дозволяйте їм здобути надмірну владу, здатну похитнути баланс сил.	true
advice_levels_onscreen_text_2139664071	У остготів, напевно, багато грошей, раз вони купили собі стільки союзників. Наші воїни втомилися. Дай їм відпочити при першій нагоді.	true
advice_levels_onscreen_text_2139664371	Вождь, грошові вливання можуть заспокоїти жителів Петродави. Зниження податків або звільнення від них зробить жителів провінції більш доброзичливими.	true
advice_levels_onscreen_text_2139664671	Вождь, ворог атакує! Війська на позиції!	true
advice_levels_onscreen_text_2139664771	Вождь, наша армія захопила Адріанополь. Наші люди займають житла, ми можемо побудувати тут зал ради і відновити місто.	true
advice_levels_onscreen_text_1085557272	Якщо противник бореться спиною до пагорбів, будьте готові до того, що він відступить на більш високі позиції.	true
advice_levels_onscreen_text_2139657673	Щоб зробити ділову [[url:/manual/page/single-player/0038_enc_page_campaign_play_faction_diplomacy]]пропозицію[[/url]], двічі клацніть на фракцію зі списку, а потім виберіть дипломатичні дії, клацаючи на них. На столі переговорів ви зможете побачити всю пропозицію повністю. Щоб прибрати пункт, клацніть на кнопку поруч з ним. Підготувавши угоду, надішліть її іншій стороні.	true
advice_levels_onscreen_text_2139664170	Оборона Ольвії ще не відновлена після нападу ворога, на це потрібен час. Остготи будуть продовжувати набіги зі свого поселення в Петродаві. Ми повинні підготуватися.	true
advice_levels_onscreen_text_2139664270	Одоакр мертвий! Тримайте стрій, перемога вже близько!	true
advice_levels_onscreen_text_2139665170	Вождь, з'явився ворожий флот! Воїни, піднімайте прапори і готуйтеся до бою!	true
advice_levels_onscreen_text_2139665270	На вкладці «Сім'я» показана структура правлячої сім'ї вашої фракції. Членів цієї родини можна оголошувати спадкоємцями, призначати на політичні посади, одружувати, розлучати, дискредитувати за допомогою пліток або навіть вбивати. Вибравши портрет персонажа, ви побачите список дій, які можна з ним зробити. Щоб призначити персонажа на посаду, виберіть її в правій частині вкладки.	true
advice_levels_onscreen_text_2139664277	Равенна встояла! Повстання придушено! Ми перемогли!	true
advice_levels_onscreen_text_2139664377	Вождь, люди голодують! Після взяття Петродави нам не вистачає провізії. Потрібно збільшити виробництво їжі, інакше нам загрожує бунт.	true
advice_levels_onscreen_text_2139664577	Вождь, вогонь слід використовувати з обережністю. Підпал міста посіє паніку в рядах захисників, але від згорілого міста менше користі після перемоги.	true
advice_levels_onscreen_text_1217512772	Тут ви можете керувати торговими угодами. Коли угода укладена, виникає торговий шлях між двома державами, який принесе обопільну вигоду вам і вашому партнеру. Кількість торгових шляхів не обмежена.	true
advice_levels_onscreen_text_2139660176	Розвідники спеціалізуються на таємних операціях. Їх можна найняти за допомогою кнопки найму агентів, вибравши поселення, в якому є певні споруди. Розвідники залишаються невидимими для ворога, поки не будуть розкриті. Вони вразливі для воїнів, але вкрай ефективні проти жерців.	true
advice_levels_onscreen_text_2139664476	Вороги вбили нашого полководця! Ми відбили його тіло, але чутки про нещастя вже поповзли серед солдатів!	true
advice_levels_onscreen_text_2139666276	Гуни всюди, вони розоряють все на своєму шляху. Але ми говоримо: нехай приходять! Так, їх незліченна кількість, але наш народ сильний і рішучий. Ми не схилимося перед ордою.	true
advice_levels_onscreen_text_2139664175	Земля годує і захищає нас. Густі ліси і глибокі річки захищають нас від ворогів, обмежують їх шляхи наступу.	true
advice_levels_onscreen_text_2139664375	Римляни погрожують нам боєм. Приготуйте вогнеметні кораблі. Влаштуємо їм гарячий прийом!	true
advice_levels_onscreen_text_2139664975	Світ змінюється. Попереду довгі холоди; щоб вижити, вашому народу доведеться покинути рідні землі і вирушити на південь. Але для початку спорядіть кораблі і розвідайте сусідні береги. Племена, що населяють їх, безсилі перед вашими воїнами, а щедра здобич забезпечить вас засобами для майбутніх випробувань. Вам належить завоювати далекі землі старіючих імперій, роздираються віковими чварами, і жалюгідних народів, начисто позбавлених волі до перемоги. По морю або по суші, але ви повинні прийти на південь і підкорити його. Тоді про ваші подвиги будуть складати пісні до кінця днів!	true
advice_levels_onscreen_text_2139665375	Якщо на полі бою є поселення або садиба, то на боці фракції, що контролює регіон, можуть виступити мирні жителі. Вони або спробують атакувати ворогів, або відразу втечуть. Мирні жителі не здатні завдати серйозної шкоди, але цілком можуть порушити лад ворога, зробивши його вразливим для ваших військ.	true
advice_levels_onscreen_text_2139657977	Енциклопедія гри «Total War: Аттіла» містить детальну інформацію про всі аспекти гри: загони, споруди, технології та сам ігровий процес. Ви можете перейти до енциклопедії в будь-який час за допомогою відповідної кнопки в лівому верхньому куті мапи кампанії або поля бою, а також за допомогою кнопки із знаком питання, яка є на більшості вікон.	true
advice_levels_onscreen_text_2139660274	Ви збираєтеся захищати переправу. Може, використовувати для цього особливе шикування?	true
advice_levels_onscreen_text_2139664574	Солдати! Після довгих років війни ми готові увійти в столицю ворога! Нагостріть мечі! Сьогодні річки почервоніють від ворожої крові! Вперед!	true
advice_levels_onscreen_text_2139665274	Якщо в провінції призначено губернатора, в ній можна видавати едикти. Вони діють, поки губернатор залишається на посаді, і можуть впливати на дохід, виробництво їжі або громадський порядок. Кількість едиктів, що діють одночасно, обмежена числом провінцій, в яких є губернатори.	true
advice_levels_onscreen_text_2139665674	Поповнення відбувається швидше, якщо загін знаходиться в поселенні.	true
advice_levels_onscreen_text_2139666074	Другою половиною править ваш брат Карломан, хоча для процвітання держави необхідний єдиний король. Ним по праву повинні стати ви - зробіть все, що для цього буде потрібно.	true
advice_levels_onscreen_text_1308478569	Кіннота, що вийшла в фланг противника, вкрай небезпечна. Однак змішана група піших і кінних ще небезпечніша, хоча і не така стрімка. Ваша піхота вдарить по ворожій, а ваша кіннота зможе безперешкодно сіяти паніку і смерть.	true
advice_levels_onscreen_text_2139663379	До провінції входить до чотирьох регіонів, в кожному з яких є центральне поселення. Найбільше і добре укріплене з них - це столиця провінції. Решта поселень набагато менші і не мають стін, поки не будуть поліпшені до максимального рівня.	true
advice_levels_onscreen_text_2139664979	Світ змінюється. Попереду довгі холоди; щоб вижити, вашому народу доведеться покинути рідні землі і відправитися на південь. Але для початку спорядьте кораблі і розвідайте сусідні береги. Племена, що населяють їх, безсилі перед вашими воїнами, а щедра здобич забезпечить вас засобами для майбутніх випробувань. Вам належить завоювати далекі землі старіючих імперій, роздираються віковими чварами, і жалюгідних народів, начисто позбавлених волі до перемоги. По морю або по суші, але ви повинні прийти на південь і підкорити його. Тоді про ваші подвиги будуть складати пісні до кінця днів!	true
advice_levels_onscreen_text_2139665879	Століття нелегкого існування на кордоні римських земель не завадили розвитку гельської культури, тому плем'я ебданів зараз процвітає. Довгі роки ви спостерігали, як Рим втрачає свою могутність, і зараз настав час об'єднати вільні племена Британії, щоб вигнати загарбників. Сусідні пікти, з якими вас пов'язують міцні узи, готові підтримати вас, а ось каледонці протестують, тому їх голос треба заглушити. Об'єднавшись, ви побудуєте на руїнах римської Британії нову вільну імперію, яку очолять ебдани.	true
advice_levels_onscreen_text_2139665979	Римляни тричі відкинули вас. Вони засіли в Константинополі, забувши про те, що його стіни колись були окроплені вашою кров'ю. Тепер же готи перетворилися на їхніх слухняних ляльок, а вас кинули гнити в пустелі. Але досить! Цариця Мавія зібрала плем'я і наказала вам закріпити успіх минулих бунтів. Несіть вогонь і смерть від Єгипту до Константинополя; покажіть римлянам, наскільки вони помилилися! Цього разу миру не буде! З кожною перемогою ваша міць буде зростати, залучаючи все більше союзників, і коли-небудь весь схід об'єднається під прапором нової імперії Танухідів!	true
advice_levels_onscreen_text_2139666179	Очевидно, що ви не зможете вічно залишатися в Паннонії. Пора розширити межі своїх володінь!	true
advice_levels_onscreen_text_2139663978	Вороги йдуть з мечами і списами. Вони збираються розграбувати наше місто. Атакують в пішому строю. Дуже скоро вони будуть тут.	true
advice_levels_onscreen_text_2139664378	Римський флот розбитий! Море наше!	true
advice_levels_onscreen_text_2139664678	Вождь, взяття Апули підвищило престиж нашого народу. Звістка про наші подвиги розлетілася по всьому світу.	true
advice_levels_onscreen_text_2139665378	Якщо ваш загін опиниться під обстрілом, накажіть йому розімкнути стрій, вибравши вільне шикування. Розпорошившись, воїни будуть менш вразливі для ворожих пострілів, але якщо при цьому на них нападе загін ближнього бою, вони ризикують бути знищеними. Ви можете і самі скористатися цим: обстріляйте противника, щоб він розірвав стрій, а потім завдайте стрімкого удару кіннотою.	true
advice_levels_onscreen_text_2139665978	Ваша держава молода, але її столиця Хіра вже встигла стати перлиною арабської культури. Її краса змушує горді племена пустель без сорому шукати вашого заступництва.  Навіть Сасаніди, які колись були вашими заклятими ворогами, тепер розглядають вас як найціннішого союзника - в основному, через близькість до римських кордонів. І справді, лише дружні до Риму гассаніди утримують вас від захоплення багатих середземноморських міст. Захопивши гассанідські землі, ви можете поширювати в них як зороастризм, так і недавно прийняте християнство. Останнє допоможе вам здобути незалежність від зарозумілих персів і перетворитися на самостійну наддержаву!	true
advice_levels_onscreen_text_2139666278	Весь інший світ вразливий перед гунами. У римлян, чиї землі лежать на півдні, вже не вистачає військ, щоб захистити свої безкрайні володіння. Якщо ви не пропустите шанс, вони можуть стати нашими.	true
advice_levels_onscreen_text_1217586072	[[url:/manual/page/single-player/0044a_enc_page_campaign_play_province_wealth#enc_text_manual_actions_campaign_wealth_tax]] Податки[[/url]] встановлюються для всієї фракції, а не для окремих [[url:/manual/page/single-player/0044_enc_page_campaign_play_province_regions]]провінцій[[/url]]. Збираючи тривалий час високі податки, ви підвищите [[url:/manual/page/single-player/0044a_enc_page_campaign_play_province_public_order]]незадоволення[[/url]] населення і сповільните економічне зростання.	true
advice_levels_onscreen_text_4066993	Зараз в цьому регіоні немає ваших військ. Його при бажанні зможе захопити будь-який жадібний сусід.	true
advice_levels_onscreen_text_1392703367	Натисніть пробіл, щоб прискорити пересування всіх персонажів, військ і кораблів на мапі кампанії. Щоб повернутися до колишнього темпу, натисніть пробіл ще раз.	true
advice_levels_onscreen_text_2139658540	Ворог напав на вас із [[url:/manual/page/single-player/0022_enc_page_campaign_play_military_ambush]]засідки[[/url]]. Оскільки ви були захоплені зненацька, до початку бою у вас не буде часу на шикування. Крім того, можливо, що ворожі загони засіли по обидва боки дороги, і вам доведеться вести бій на два фронти.	true
advice_levels_onscreen_text_2139663943	Наш союзник Теодоріх загинув у бою! Його воїни ще б'ються, але скоро впадуть духом!	true
advice_levels_onscreen_text_2139664643	Вождь, бережися! Великі сили ворога на підході!	true
advice_levels_onscreen_text_1391140702	Блокада - це кордон з кораблів, який зупиняє всю торгівлю, що проходить через порт, і не випускає кораблі без бою. Блокаду можна прорвати, розбивши ворожу флотилію. Щоб заблокувати порт, клацніть по ньому правою кнопкою миші. Якщо в порту є ворожий флот, то з'явиться значок, що показує, що порт в блокаді. Якщо ж порт порожній, ваші кораблі можуть зайти туди і відразу його зайняти.	true
advice_levels_onscreen_text_2139657841	У цій провінції назрівають заворушення, оскільки більшість її населення сповідує іншу віру. Для насадження своєї релігії відправте туди жерців.	true
advice_levels_onscreen_text_2139658041	[[url:/manual/page/single-player/0053_enc_page_campaign_play_characters_ancillaries]]Оточення[[/url]] - це домочадці та предмети, з якими стикаються персонажі, виконуючи різні завдання, і які впливають на вміння персонажів. Предмети та домочадці з'являються в міру розвитку кампанії. Їх можна передати [[url:/manual/page/single-player/0047_enc_page_campaign_play_characters]]персонажу[[/url]] відразу ж або зберегти на майбутнє.	true
advice_levels_onscreen_text_2139664242	Аттілу вибили з сідла і забрали з поля бою! Тепер гуни втратять свою хоробрість!	true
advice_levels_onscreen_text_2139664742	Відмінно! Нашим людям знадобиться деякий час, щоб зібрати майно і вирушити в дорогу. Не можна втрачати пильності!	true
advice_levels_onscreen_text_2139665242	Відмінно! З цими бойовими кораблями під нашим командуванням ми можемо без побоювання вийти в море!	true
advice_levels_onscreen_text_2139665542	Борючись, наші воїни набули нового досвіду. Розпоряджайтеся ним гідно.	true
advice_levels_onscreen_text_2139657942	Деякі [[url:/manual/page/single-player/0040_enc_page_campaign_play_faction_missions]]події[[/url]], що вимагають вашого рішення, відкриваються автоматично, і ви не зможете продовжити гру, поки не зробите вибір. Вибирайте з розумом: неправильне рішення може мати серйозні наслідки для всієї вашої фракції.	true
advice_levels_onscreen_text_2139664041	Відходимо, відходимо! Остготи обійшли нас і напали на місто! Воїни, захищайте свої будинки!	true
advice_levels_onscreen_text_2139664741	Прекрасно! Це обійшлося недешево, але римляни дали нам дозвіл на прохід.	true
advice_levels_onscreen_text_2139664941	На півдні зараз небезпечно через дрібні війни і загрозу навали гунів, тому вам краще звернути свій погляд в інший бік. Легкою здобиччю для вас можуть стати землі в Британії, яка майже повністю вийшла з-під влади Риму. Холод, що насувається з півночі, вже турбує жителів цього острова, які здатні заподіяти чимало лиха, якщо вирішать вторгнутися на материк, тому вам краще принести війну на їхні власні землі. Боріться, перемагайте і підкорюйте, щоб вписати плем'я саксів в аннали історії!	true
advice_levels_onscreen_text_2139665441	Залиште в резерві сухопутні війська. У них немає навичок бою на морі, тому вони стануть легкою здобиччю досвідчених моряків.	true
advice_levels_onscreen_text_2139658443	Екіпажі кораблів накопичують досвід майже так само, як сухопутні війська, за одним винятком: якщо корабель вийшов з бою - здався, втік або пішов на дно, - всі залишені очки досвіду, які міг би набрати його екіпаж, діляться між кораблями противника.	true
advice_levels_onscreen_text_2139660140	Загони можна [[url:/manual/page/single-player/0017_enc_page_campaign_play_military_recruit]]набирати[[/url]] відразу до війська, і не важливо, знаходиться воно в поході або стоїть гарнізоном в поселенні. Набрати ви зможете тільки ті типи військ, які доступні в [[url:/manual/page/single-player/0044_enc_page_campaign_play_province_regions]]регіоні[[/url]], де знаходиться армія: набирати людей з інших регіонів неможливо. Щоб почати [[url:/manual/page/single-player/0018_enc_page_campaign_play_military_stances]]найм[[/url]], використовуйте відповідні кнопки.	true
advice_levels_onscreen_text_2139664440	Готуйтеся, хоробрі! Попереду манить і сяє військова слава! Ми йдемо на битву!	true
advice_levels_onscreen_text_2139665540	Вождь! Нас більше нікому захищати! Ми зазнали поразки!	true
advice_levels_onscreen_text_2139665940	Імператор Юстиніан будує грандіозні плани. Сидячи на константинопольському троні, він збирається повернути Риму західні провінції, захоплені варварами. Однак поки це лише задуми. Для їх втілення потрібен талановитий полководець, гідний Юлія Цезаря і Октавіана Августа. Юстиніан знайшов таку людину: ним виявився Велісарій. Насамперед ми повинні повернути контроль над Середземним морем: наявність безпечних шляхів постачання і торгівлі дозволить утримувати армію і наблизить мрію про відродження єдиної імперії. Але вандальський флот занадто сильний, щоб атакувати його безпосередньо. Тому треба захопити володіння вандалів у Північній Африці: тільки тоді з'явиться надія на звільнення Вічного міста. Коли Африка знову стане нашою, ми кинемо виклик остготам, які узурпували владу в Італії. Того, хто поверне Рим у руки римлян, чекає велика слава!	true
advice_levels_onscreen_text_2139666140	Після смерті короля франків Піпіна Короткого ви змогли безкарно грабувати його землі. Але скоро все зміниться. Вашому народу знадобиться сильний правитель.	true
advice_levels_onscreen_text_2139660147	При виборі фракції ви також вибираєте одну з сімей або партій, що входять в її політичну систему. Лідер фракції одночасно очолює і правлячу партію, значимість якої складається з особистого впливу всіх її членів. Полководці збільшують вплив, здобуваючи перемоги, а губернатори - завершуючи будівельні проекти. Популярність партії залежить від її впливу в порівнянні з опозицією.	true
advice_levels_onscreen_text_2139664147	Вождь, ми зазнали невдачі! Перегрупуємося і спробуємо ще раз!	true
advice_levels_onscreen_text_2139664247	Перемога! Римляни не встояли під натиском могутніх гунів! Вперед, на Константинополь!	true
advice_levels_onscreen_text_2139665547	Вам варто приділити більше уваги здоров'ю народу. Хвороби можуть підірвати нашу боєздатність.	true
advice_levels_onscreen_text_2139665947	Смерть Теодоріха занурила Остготське царство в хаос. Спадкоємець Аталаріх ще не досяг повноліття; країною править його мати, проте інші члени правлячого роду будують плани, готуючись захопити владу при найменшій нагоді. Але справа не обмежується внутрішніми чварами. Франки і лангобарди загрожують північним кордонам царства, а Візантія не втрачає надії повернути його в лоно імперії. Однак навіть у ці непрості часи у нас є надія. Римляни висадилися в Північній Африці; поки вони зайняті війною з вандалами, ми можемо вирішити проблеми на півночі, щоб потім зосередитися на південному і східному напрямку. Щоб у народу остготів було майбутнє, ми повинні за будь-яку ціну утримати Італію. Якщо ж нам вдасться захопити ще й Африку з Балканами... . Що ж, тим краще!	true
advice_levels_onscreen_text_2139658045	У персонажа є не тільки [[url:/manual/page/single-player/0051_enc_page_campaign_play_characters_skills]]навички [[/url]], але й деякі [[url:/manual/page/single-player/0052_enc_page_campaign_play_characters_traits]]особливості[[/url]], що впливають на його здібності. Одні особливості притаманні [[url:/manual/page/single-player/0047_enc_page_campaign_play_characters]]персонажам[[/url]] з самого початку, інші з'являються в міру розвитку кампанії.	true
advice_levels_onscreen_text_2139660246	Місця бойової слави, де ви здобули важкі і значущі перемоги, відзначаються на мапі кампанії особливими знаками. Наведіть курсор на меморіал, щоб побачити детальну інформацію.	true
advice_levels_onscreen_text_2139663546	Для найму агента виберіть провінцію і відкрийте вікно «Найняти агента». Найм відбувається миттєво, але його вартість може варіюватися в залежності від фракції, наявності певних будівель, особливостей персонажа та інших факторів.	true
advice_levels_onscreen_text_2139664246	Ворожий полководець загинув від руки нашого воїна! Скоро його армія впаде духом!	true
advice_levels_onscreen_text_2139664446	Друзі! Ми знову йдемо в бій! Ніякої пощади ворогу!	true
advice_levels_onscreen_text_2139664946	Настав ваш час. Західна Римська імперія ослаблена політичними чварами, а її армія розрізнена. Рано чи пізно оточеному ворогом Риму доведеться вивести війська з земель Рейну для захисту інших кордонів. Коли це станеться, будьте готові завдати удару по суші або по морю, а до тих пір задовольняйтеся грабунком сусідніх племен. Остерігайтеся північан: наступаючі холоди женуть їх все далі на південь. Не варто забувати і про гунів, орда яких вже розорила східні землі і продовжує шлях на захід. Але рано чи пізно ви побудуєте велике Франкське королівство, здатне впоратися з будь-ким, хто наважиться кинути вам виклик!	true
advice_levels_onscreen_text_2139665046	Наша армія розбита! Ми програли! Відступаємо, поки не пізно!	true
advice_levels_onscreen_text_2139665646	Щоб наказати загону піднятися на стіну, виберіть його і перемістіть на потрібну ділянку стіни, побудувавши в одну шеренгу.	true
advice_levels_onscreen_text_2139665946	Великий Хлодвиг об'єднав наш народ і вселив у нього жагу до завоювань. Римляни, вестготи, алемани, бургунди - всі вони намагалися стати на шляху франків і всі зазнали краху, втративши і землі, і гідність. Нещодавно бургундський правитель Гундобад жорстоко вбив сім'ю королеви Клотільди, і тепер її прийомний син, наш король Теодоріх, виступив з військом, щоб покарати лиходія і його нечестивий народ. Розправившись з бургундами, ми продовжимо шлях на південь: туди, де вестготи зализують свої рани, з тугою дивлячись на відібрані нами землі. Їхні володіння, що залишилися, стануть окрасою нашої держави! Однак частину сил нам потрібно зберегти в резерві. Римляни мріють повернути Італію - зруйнувавши їхні мрії, ми зможемо підкорити всі колишні римські володіння на заході континенту. Ми - єдині захисники істинної віри. Господь винагородить нас, дозволивши створити в Європі нову християнську імперію!	true
advice_levels_onscreen_text_2139666246	На півдні живуть римляни, які досягли вершин цивілізації. Дружба з ними може виявитися корисною. Доведіть їм, що вони помиляються, вважаючи нас лісовими дикунами.	true
advice_levels_onscreen_text_2139657746	Порти не тільки приносять дохід від [[url:/manual/page/single-player/0046_enc_page_campaign_play_province_trade_finance]]торгівлі[[/url]], але й дозволяють будувати військові кораблі. Майте на увазі, що кораблі можна замовляти безпосередньо у флотилій.	true
advice_levels_onscreen_text_2139664145	Ми перемогли! Петродава захоплена готськими військами!	true
advice_levels_onscreen_text_2139665145	Чудово! Використовуй ці мапи, коли будеш прокладати шлях для нашого народу.	true
advice_levels_onscreen_text_2139665745	Назва вашого народу означає «всі люди», що пов'язано з незвичайним союзом племен, з якого він виник. Побоюючись римлян, що причаїлися за Рейном, племена шукали взаємної підтримки - і в кінці кінців самі стали здійснювати набіги на землі Риму. Зараз з ним укладено мир, але пам'ять про нищівну поразку під Аргенторатом продовжує переслідувати вас. Втім, перед тим, як штурмувати це місто, вам потрібно зміцнити позиції: якщо ви надмірно розтягнете сили, вандали зі сходу неодмінно цим скористаються. Для захисту від них ви можете закликати на допомогу германських родичів: маркомани, лангобарди і франки готові стати під ваші прапори за першим покликом.	true
advice_levels_onscreen_text_2139666145	Пам'ятайте: могутність франків - в єдності, а зараз вони роздроблені. Скористайтеся цим з максимальною вигодою для себе.	true
advice_levels_onscreen_text_2139664044	Вождь, ти керуєш обороною міста! Об'єднай сили і відбий напад! Не здавай місто!	true
advice_levels_onscreen_text_2139664344	Євген загинув у бою! Тепер його воїни неминуче падуть духом!	true
advice_levels_onscreen_text_2139665344	Баррикади служать для оборони поселень. З їх допомогою можна змушувати противника йти під постріли або прикривати стрільців від ворожого натиску. Кількість барикад залежить від розміру поселення і тривалості облоги. Щоб знищити свою барикаду, виберіть загін, а потім клацніть по барикаді правою кнопкою миші при натиснутій клавіші ALT.	true
advice_levels_onscreen_text_1247479159	Ви можете призначити, коли підкріплення вступатимуть у бій, клацаючи по загонах лівою кнопкою миші і розміщуючи їх у потрібному порядку. Крайній лівий загін буде першим.	true
advice_levels_onscreen_text_1882907085	Під час штурму поселення багато родів військ можуть підійматися по ворожих стінах. Виберіть загін і клацніть правою кнопкою миші по потрібній ділянці стіни.	true
advice_levels_onscreen_text_2139665749	Родючість має вирішальне значення для виживання. Щоб дізнатися її рівень, увімкніть фільтр «Родючість» на оглядовій мапі. Чим він нижчий, тим менше їжі виробляється в регіоні і тим повільніше поповнюються армії. У ході кампанії клімат буде погіршуватися, що позначиться на родючості всього світу.	true
advice_levels_onscreen_text_2139666249	Але не забувайте про свої корені. Пам'ятайте: серед нас багато вправних землеробів, здатних зібрати багатий урожай навіть на найбідніших ґрунтах.	true
advice_levels_onscreen_text_2139664348	Ті, хто ще залишився в Петродаві, тепер бунтують проти нашої влади. Нам слід заспокоїти їх, якщо ми хочемо зберегти владу над цим містом і продовжити війну з остготами.	true
advice_levels_onscreen_text_2139664548	Вождь, чудові новини! Наші союзники надіслали підкріплення!	true
advice_levels_onscreen_text_2139665248	Вождь, наш народ слідує за армією на південь. Наші ремісники можуть покращувати табори, але для армії необхідне місце постійної дислокації. Краще нам не зупинятися на цих землях, поки гуни переслідують нас.	true
advice_levels_onscreen_text_2139665848	Деякі фракції можуть наймати загони з особливістю «Нальотник». Нальотники швидше захоплюють ключові точки і можуть підпалювати споруди в поселеннях, кидаючи смолоскипи. Втім, остання перевага може обернутися недоліком, якщо ви плануєте окупувати поселення після бою.	true
advice_levels_onscreen_text_2139666048	Набирає силу і Папська область, створена і підтримувана франками. Вона займає дорогоцінні землі Італії, а значить, повинна служити в першу чергу вашим інтересам.	true
advice_levels_onscreen_text_1119796260	Дохід залежить від ринкових цін на ваші [[url:/resources]]товари[[/url]], які, в свою чергу, визначаються співвідношенням попиту і пропозиції у всіх фракцій і [[url:/manual/page/single-player/0046_enc_page_campaign_play_province_trade_finance]]торгових[[/url]] партнерів. Найсвіжіші дані ви знайдете у вікні торгівлі.	true
advice_levels_onscreen_text_1212482652	Перестрахуйтеся - розмістіть невеликий кінний резерв по центру. У бою ви зможете відправити вершників туди, де вони найбільше потрібні.	true
advice_levels_onscreen_text_1217921189	На початку кожного ходу з вашої скарбниці видається певна сума на утримання військ. Вона йде на платню і на покупку всього необхідного для армії.	true
advice_levels_onscreen_text_1242837398	Продукцію вашої фракції можна [[url:/manual/page/single-player/0046_enc_page_campaign_play_province_trade_finance]] продавати[[/url]] іншим державам, уклавши торговельну угоду у вікні [[url:/manual/page/single-player/0038_enc_page_campaign_play_faction_diplomacy]]дипломатії[[/url]]. Після укладення угоди на мапі з'явиться торговий шлях. Ваші морські торгові шляхи відображаються жовтим кольором, торгові шляхи нейтральних фракцій - білими, ворожих - червоними. Сухопутні торгові шляхи позначені биком з возом в північних регіонах і верблюдами на півдні і на сході. Фракція може прокласти необмежену кількість торгових шляхів.	true
advice_levels_onscreen_text_2139664253	Римляни встояли! Відходимо, воїни! Відходимо!	true
advice_levels_onscreen_text_2139664453	До зброї, воїни! Труба кличе! За нашого Бога і нашу свободу! В бій!	true
advice_levels_onscreen_text_2139665353	Хоробрість і дисципліна воїнів залежить від їх бойового духу - почуття гордості і впевненості в своїх силах. Бойовий дух підвищується на тренуваннях, у міру накопичення досвіду і в присутності полководця. Якщо ж полководець гине, а вороги перевершують загін чисельністю, бойовий дух падає. Індикатор бойового духу знаходиться під прапором загону.	true
advice_levels_onscreen_text_2139665553	Час і гроші, витрачені на розвиток інфраструктури, стократ окупляться в битві. В Апулі нас чекає жорстокий бій, тому нам потрібно підготувати найкращі війська.	true
advice_levels_onscreen_text_2139666153	Набагато більшу небезпеку становлять слов'яни, що живуть на сході. Об'єднавшись з франками, вони охоче спробують захопити ваші землі. Завдайте удар першими.	true
advice_levels_onscreen_text_1759254827	Шкала над задіяними в перевезенні кораблями показує, на якому етапі знаходиться завантаження.	true
advice_levels_onscreen_text_2139657851	Цей регіон бідніє з кожним днем. Необхідно знизити податки, інакше люди почнуть голодувати!	true
advice_levels_onscreen_text_2139660252	При розгортанні можна розставляти наступні нерухомі об'єкти для захисту або нападу: барикади, ями з сіркою, вогняні кулі, гострі камені, вовчі ями, частокіл та кілля.	true
advice_levels_onscreen_text_2139663952	Ми вбили Аттілу! Посилити натиск! Відправимо його воїнів слідом за ним!	true
advice_levels_onscreen_text_2139664052	Вождь! Кажуть, що ці вершники - гуни, східний народ на службі у остготів. Давай покажемо їм, на що ми здатні, і гуни проклянуть день, коли виступили проти нас!	true
advice_levels_onscreen_text_2139665952	Змістивши Хільдеріха і захопивши вандальський трон, Гелімер вирішив перебудувати царство за зразком свого великого предка Гейзеріха. Однак повалення монарха, дружнього Риму, привернуло увагу візантійського імператора. Він вислав армію полководця Велісарія, щоб повернути Північну Африку в лоно імперії. Ми повинні терміново вжити заходів, щоб не дозволити римлянам закріпитися в наших володіннях. Захистивши африканські землі, ми займемося Сардинією і Корсикою. Ці острови повинні належати вандалам, але для їх захоплення нам знадобиться посилити флот. Однак панування на морі - лише сходинка на шляху до Вічного міста. Затвердивши свою владу в Африці і Західному Середземномор'ї, ми попрямуємо до Італії: той, хто хоче правити світом, повинен володіти Римом!	true
advice_levels_onscreen_text_2139666252	На сході лютують гуни, а захід занурюється в хаос великих змін. Розкол Європи відкриває перед нами привабливі перспективи.	true
advice_levels_onscreen_text_2139658052	Це дерево навичок. Тут в обмін на очки досвіду, отримані персонажами в кампанії, можна отримати корисні навички. У міру вдосконалення персонажі набирають очки досвіду, поступово підвищуючи свій рівень, і їм відкриваються все нові навички.	true
advice_levels_onscreen_text_2139663351	З моменту створення армія починає створювати [[url:/manual/page/single-player/0029_enc_page_campaign_play_military_legacies]]традиції[[/url]], які складаються в боях і битвах. Це дозволяє війську розвивати особливі [[url:/manual/page/single-player/0051_enc_page_campaign_play_characters_skills]]навички [[/url]] майже так само, як це роблять [[url:/manual/page/single-player/0047_enc_page_campaign_play_characters]]персонажі[[/url]]. Набравши нову армію, ви можете передати їй традиції розпущеного або знищеного війська.	true
advice_levels_onscreen_text_2139664551	Вождь, облогові знаряддя готові! Накажи почати штурм Апули!	true
advice_levels_onscreen_text_2139664651	Вождь, до нас наближається численне вороже військо! Прийми рішення.	true
advice_levels_onscreen_text_2139664751	Вождь, в Адріанополі бунтівники розгромили місцевий гарнізон. Римський сенат вимагає, щоб ми придушили повстання. У разі успіху це місто стане нашим новим домом.	true
advice_levels_onscreen_text_2139665451	Вождь, ворогів ніде не видно. Ми повинні вислати розвідку і знайти їх. Будь обережний, стережися засідки.	true
advice_levels_onscreen_text_1475059206	Втоми ворога, змусь його побігати, демонструючи уявну слабкість: наприклад, постав маневрені легкі загони в уразливу позицію.	true
advice_levels_onscreen_text_2139658053	У деяких регіонів є культурні особливості або ресурси, що дозволяють зводити особливі споруди, їх тип залежить від регіону. Ці споруди будуються точно так само, як і звичайні, хоча і дають певні переваги або важливі ресурси.	true
advice_levels_onscreen_text_2139658553	Не посилайте кінноту в атаку на списоносців, це призведе до важких втрат. Набагато ефективніше атакувати списоносців з тилу або з флангів.	true
advice_levels_onscreen_text_2139660150	Вплив персонажа, залученого в політику вашої фракції, може поступово збільшуватися або зменшуватися в залежності від військових перемог і поразок, виконання губернаторських обов'язків, а також завдань і дилем. Вплив можна витрачати на здійснення політичних дій в інтересах кар'єри персонажа або партії, в якій він перебуває.	true
advice_levels_onscreen_text_2139664950	Ваш народ прийшов з далеких земель за Сарматським морем, але його дорога ще не закінчена. Подібно до безлічі інших племен, він продовжує йти на південний захід, рятуючись від похолодання і навали гунів. Минулі образи, завдані Східною Римською імперією, дають вам право грабувати її володіння, але селитися в них зовсім не обов'язково. Ходять чутки, що Західна Римська імперія слабка і не здатна захистити свої багаті і родючі землі. Дочекайтеся, поки вона впаде, а потім побудуйте на її руїнах велике Вестготське королівство!	true
advice_levels_onscreen_text_2139665050	Цар загинув на полі бою! Доля відвернулася від нас!	true
advice_levels_onscreen_text_2139665857	Слідкуйте за індикатором згуртованості, розташованим у вікні відомостей про армію. Вказавши на нього курсором, ви побачите список факторів, що впливають на згуртованість. Якщо вона впаде занадто низько, частина вашої армії підніме заколот і перейде на бік сепаратистів.	true
advice_levels_onscreen_text_2139666157	На півночі союзники-дани зберігають вірність вашим спільним богам. Разом ви зможете повернути назад хвилю християнства, що захлеснула Європу.	true
advice_levels_onscreen_text_1913603768	Ви можете повернутися до показаних раніше порад, використовуючи кнопку «назад» у цьому вікні. Підсвічені та підкреслені слова — це гіперпосилання на енциклопедію, в якій міститься більше відомостей про той чи інший предмет. Клацніть ЛКМ на портреті радника, щоб повторити щойно з'явилося повідомлення.	true
advice_levels_onscreen_text_2139664056	Ворог атакує в кінному строю! Став проти них списоносців!	true
advice_levels_onscreen_text_2139664156	Темні хмари збираються над горизонтом, вождь. Уважно вивчи мапу.	true
advice_levels_onscreen_text_2139664356	Язичники втекли! Слава Господу, ми перемогли!	true
advice_levels_onscreen_text_2139665056	Ворожий полководець втоптаний в бруд нашими хоробрими воїнами! Його армію чекає та ж доля!	true
advice_levels_onscreen_text_2139665156	Вождь, ми можемо негайно вирушити в дорогу, але при цьому ми залишимо всі наші міста.	true
advice_levels_onscreen_text_2139658456	Ви залишили поселення без захисту. Обережніше! Якщо його захоплять, ваша фракція може бути знищена ще до початку кампанії.	true
advice_levels_onscreen_text_2139658556	У цьому списку показані події в хронологічному порядку, але їх можна відсортувати за назвами. Клацніть на подію, щоб дізнатися більше. Подробиці важливих подій відкриваються автоматично.	true
advice_levels_onscreen_text_2139664155	Прокинься, вождь! На тебе чекають великі справи. Ми виграли битву, але програємо війну.	true
advice_levels_onscreen_text_2139664455	Ворог близько! До зброї! Виконайте свій обов'язок, воїни, на славу Божу! Вперед!	true
advice_levels_onscreen_text_2139665155	Перехід через Дунай римляни розцінять як напад. Ми повинні отримати дозвіл від їхніх правителів.	true
advice_levels_onscreen_text_2139665355	Швидкі в бою і дешеві в утриманні грабіжники можуть підпалити обложене поселення. Однак за ними потрібно стежити: через вкрай низьку дисципліну вони часто порушують накази. Підпал поселення підриває бойовий дух його захисників; чим довше триває пожежа, тим більше шансів, що вони здадуться.	true
advice_levels_onscreen_text_2139665254	Ми зробили все можливе для підготовки армії. Тепер слід зайнятися зміцненням наших позицій.	true
advice_levels_onscreen_text_2139665654	Поповнення відбувається швидше, якщо загін знаходиться на вашій території або на території союзника.	true
advice_levels_onscreen_text_1273390037	У болотистих низинах, у западинах серед схилів легко влаштувати пастку або відрізати загін від решти війська. Уникайте таких місць самі, але заманюйте в них ворога.	true
advice_levels_onscreen_text_1953611164	Бунт у цій провінції переріс у збройне [[url:/manual/page/single-player/0044a_enc_page_campaign_play_province_public_order#enc_text_manual_public_order_rebellions]]повстання[[/url]]! Немає сенсу обговорювати мирне вирішення проблеми, відправте туди війська і розбийте бунтівників!	true
advice_levels_onscreen_text_1591689763	Вірний спосіб знищити кінноту - кинути її на списи. Кіннота буде цілішою, якщо вдарить списоносців у фланг або в тил, але ще краще використовувати піхотинців.	true
advice_levels_onscreen_text_2139664059	Ольвія впала! Ми зазнали поразки! Що ж тепер буде з нами?	true
advice_levels_onscreen_text_2139664159	Залишки остготського війська відступають на свої землі. Вони воюють не вмінням, а числом. Тепер вони збирають нове військо проти нас.	true
advice_levels_onscreen_text_2139664259	Чудово! Згодом результати їхніх досліджень допоможуть нам. А поки нам залишається тільки чекати приходу ворога.	true
advice_levels_onscreen_text_2139664759	Переселення на територію Риму відкриває перед нами нові можливості. Землі там родючі, люди багаті, можливості для нових завоювань невичерпні.	true
advice_levels_onscreen_text_2139665459	Ось він, римський флот! Сьогодні ми здобудемо велику перемогу! До бою!	true
advice_levels_onscreen_text_2139665959	Наш народ пройшов довгий шлях від жменьки жалюгідних біженців, які шукали порятунку за Рейном, до повновладних господарів багатої і родючої Іберії. Але спочивати на лаврах ще зарано. З приходом до влади малолітнього спадкоємця, а насправді - його матері, в нашій державі спалахнули міжусобиці, які не вщухають досі. Гірше того, жадібні франки скористалися цим, щоб позбавити нас володінь у Галлії. Ми неодмінно відновимо справедливість і покладемо край завоюванням франків, але спочатку треба вирішити більш нагальні проблеми. Свеби, що живуть на заході, вже багато років турбують нас війною: поки ми не відкинемо їх від своїх кордонів, наша армія не зможе піти в наступ. Повернувши втрачене, ми зможемо задуматися про створення нової імперії. Зовсім поруч, за протокою, розкинулася Африка - ми з легкістю відберемо її у вандалів, які загрузли в розкоші і втратили смак до завоювань. Але бережіться римлян. Їхня армія вже йде по колишніх землях імперії, прагнучи відродити її. Коли вона дістанеться до Іспанії, ми повинні бути готові її зустріти. І ми будемо готові!	true
advice_levels_onscreen_text_2139666159	Грізне єдине божество, що сходить з неба, загрожує знищити багатьох богів землі і води. Лише вашому народу під силу зупинити його. Тож підійміть зброю на славу предків!	true
advice_levels_onscreen_text_2139666259	Ми, венеди, першими з слов'ян прийшли на землі Європи. Але зараз всьому, що досягнуто нашим народом, загрожує велика небезпека. Щоб вижити, ми повинні встояти перед нею.	true
advice_levels_onscreen_text_1949671761	Ваша армія зазнала втрат, вам слід [[url:/manual/page/single-player/0026_enc_page_campaign_play_military_replenish]]поповнити[[/url]] ряди! Якщо армія знаходиться в дружній провінції і не робить марш-кидок, сили відновляться автоматично. Відновлення буде швидшим, якщо армія перейде в режим [[url:/manual/page/single-player/0018_enc_page_campaign_play_military_stances#enc_text_manual_actions_campaign_stances_muster]]вербування[[/url]]. Чим ближче армія до провінції, де є новобранці, тим швидше прийде поповнення. Якщо нових людей не додається, можливо, ваше військо знаходиться на ворожій землі або несе великі небойові втрати.	true
advice_levels_onscreen_text_2139663958	Сьогодні великий день! Гуни розбиті! Святкуємо перемогу!	true
advice_levels_onscreen_text_2139664358	Ми взяли Петродаву, але ворог ще сильний. Його столиця Апула занадто близько до наших нових володінь. Якщо ми хочемо остаточно розгромити остготів, це місто має впасти. Воно добре укріплене. Нам потрібно збільшити армію.	true
advice_levels_onscreen_text_2139664658	Вождь, ворог близько! До бою!	true
advice_levels_onscreen_text_2139664858	У Петродаві зростає населення, і ми можемо розширити межі міста. Слід побудувати ферму, щоб зменшити нестачу продовольства.	true
advice_levels_onscreen_text_2139665258	Інформація про поточні події та навколишній світ знайдеться, якщо її пошукати. Будь уважний до того, що відбувається навколо.	true
advice_levels_onscreen_text_2139666058	На півдні візантійська фема Сицилія не залишає наївних надій відродити втрачену імперію. Слідкуйте за нею в обидва.	true
advice_levels_onscreen_text_1227695361	Стоячи на одному місці протягом ходу і довше, ваша армія зможе закріпитися на точці. Це означає, що в разі нападу ваше військо встигне підготуватися і розмістити укріплення.	true
advice_levels_onscreen_text_1499695591	Щоб перемістити військо цілком, переконайтеся, що в ньому є [[url:/manual/page/single-player/0047a_enc_page_campaign_play_characters_generals_admirals]]полководця[[/url]], виберіть поселення або полководця, потім клацніть правою кнопкою миші по точці, куди ви хочете відправити солдатів. Відпустіть кнопку миші, і армія рушить у дорогу.	true
advice_levels_onscreen_text_1218788185	Ви набрали стільки військ, що бюджет тріщить по швах. Пора захопити нові землі: це допоможе розподілити витрати, а ваші солдати нарешті послужать на благо батьківщини!	true
advice_levels_onscreen_text_1833752382	Щоб висадити армію або персонажа, виберіть потрібне судно, наведіть курсор на берег і клацніть правою кнопкою.	true
advice_levels_onscreen_text_1217604599	На мапі кампанії можна відзначити до чотирьох «гарячих точок» для камери. Наведіть камеру на потрібне місце і натисніть SHIFT і клавіші від F1 до F12, щоб відзначити його. Щоб повернути камеру на таку точку, натисніть відповідну клавішу «F». Закладки не можна видаляти, але можна створювати нові поверх старих.	true
advice_levels_onscreen_text_1232708197	Навколо кожної армії і флоту є «зона контролю», яка позначається на мапі. Ви не можете увійти в цю зону, якщо тільки не збираєтеся напасти на армію.	true
advice_levels_onscreen_text_1093841867	Здійснюючи обхідний маневр, вибирайте шлях так, щоб ворог не бачив ваших пересувань: наприклад, ховайте загони за пагорбами або за деревами.	true
advice_levels_onscreen_text_2139663983	Схоже, остготи дражнять нас: встали табором за містом. Давайте нападемо, поки вони не напали першими!	true
advice_levels_onscreen_text_2139664483	Вождь, за нашими відомостями, наші воїни вбили ворожого полководця! Без нього в ворожих рядах запанує паніка!	true
advice_levels_onscreen_text_2139665283	Династичні шлюби зміцнюють зв'язки між фракціями. Подібно до обміну дарами, вони тимчасово покращують ставлення, але їх ефект триває набагато довше. Щоб такий шлюб став можливим, в обох фракціях повинні бути підхожі члени правлячої родини.	true
advice_levels_onscreen_text_2139664182	Очевидно, остготи заплатили гунам, і ось вони знову виступили проти нас. Нам доводиться відбивати атаки відразу з двох боків. Наша армія зможе краще організувати оборону в місті. Відведи війська в місто.	true
advice_levels_onscreen_text_2139664782	Гуни перейшли Дунай! Невже вони ніколи не перестануть переслідувати нас?	true
advice_levels_onscreen_text_2139664982	Це засідка! Воїни, до бою!	true
advice_levels_onscreen_text_2139665682	Поповнення відбувається швидше, якщо корабель знаходиться у вашому порту.	true
advice_levels_onscreen_text_2139666082	Допомогти в неминучій війні з братом можуть Баварія і Ломбардія, проте не варто покладатися на таких ненадійних «друзів».	true
advice_levels_onscreen_text_2139664081	У складі нашого підкріплення є метальники. Слідкуй, щоб вони були під захистом, і направляй їх туди, де вони завдадуть ворогу найбільшої шкоди.	true
advice_levels_onscreen_text_2139664581	Вороги зломлені, вони розвертаються і тікають! Апула наша!	true
advice_levels_onscreen_text_2139664781	Ми повинні спробувати закріпитися на цих землях. Схоже, римляни хочуть торгувати з нами.	true
advice_levels_onscreen_text_2139665481	Наближаються ворожі списоносці! Вступи в ближній бій!	true
advice_levels_onscreen_text_2139665581	Можна переміщати загони між арміями. Виберіть одну з них і клацніть правою кнопкою миші по іншій. Пам'ятайте, в кожній армії може бути тільки один командир: якщо перемістити всі загони в одну армію, полководець другий залишиться без військ. Це стосується і кораблів.	true
advice_levels_onscreen_text_2139665981	Півстоліття тому ви звільнили Аль-Андалус. З часу великої мандрівки Пророка, мир йому і благословення, минуло 146 років. Ви - останні з Омеядів, вигнані з рідних земель підступними Аббасидами. Тут, на західних землях Аль-Андалуса, ваш халіфат отримав шанс відродитися.	true
advice_levels_onscreen_text_1500507282	Це відомості про провінції під вашим управлінням: чисельність населення, рівень громадського порядку, дохід. Дані сортуються за будь-яким показником. Тут же є відомості про сусідні провінції - вони допоможуть планувати майбутні завоювання.	true
advice_levels_onscreen_text_2139665180	Повідомляють, що командувач ворожим флотом загинув у бою з нашими хоробрими воїнами! Бойовий дух його моряків впаде!	true
advice_levels_onscreen_text_2139665480	Наближається ворожа кіннота! Накажіть списоносцям зупинити її!	true
advice_levels_onscreen_text_2139665780	Після кожної битви слід проводити ревізію військ і об'єднувати неповні загони. Клацніть по картках двох однакових загонів, утримуючи CTRL, а потім вкажіть на одну з них і виберіть значок об'єднання. При цьому ви не тільки заповните втрати, але і вивільните кошти для найму нових військ.	true
advice_levels_onscreen_text_2139666280	Але будьте обережні. Римляни слабкі, проте у них є союзники - наші вороги, які боягузливо покинули свої будинки і тепер жадібно дивляться на наші.	true
advice_levels_onscreen_text_2139657684	У розділі «Дипломатія» ви можете укладати союзи з іншими фракціями, вести торгівлю або оголошувати війну. Щоб почати переговори, натисніть на кнопку дипломатії і двічі натисніть на фракцію, яку хочете вибрати.	true
advice_levels_onscreen_text_2139666087	Вірним союзником батька був Папа Римський. Якщо він покличе, франки прийдуть на допомогу. Гнів Ломбардії неминучий, старі рани так просто не загоюються, але для вас це не повинно мати значення.	true
advice_levels_onscreen_text_2139664386	Наша армія підійшла до Петродави, але до перемоги ще далеко. Наші люди готові до бою, вождь. Нападемо ж і покажемо нашу доблесть!	true
advice_levels_onscreen_text_2139664586	Вождь, потрібно негайно приступити до будівництва облогових знарядь. І не знімати облогу, поки вони не будуть готові.	true
advice_levels_onscreen_text_2139665286	Лідери фракцій мають особливості характеру, які можуть впливати на дипломатичні ставлення. Ці особливості перераховані під портретом лідера в лівій частині даної панелі. Після смерті лідера може змінитися наступник з абсолютно іншим характером, що призведе до радикальних змін у зовнішній політиці.	true
advice_levels_onscreen_text_2139665786	Призначивши губернатора, ви зможете видати в провінції едикт. Клацніть на закладці «Губернатори» праворуч вгорі, виберіть підхожого кандидата і вкажіть провінцію, яку він очолить. Для мігруючих фракцій ця можливість доступна тільки в стані осілості.	true
advice_levels_onscreen_text_2139666186	На південному заході за річкою По розкинулася Італія, а далі за Альпами чекають Німеччина і Франція. Підкорити їх буде непросто, але від цього залежить саме виживання аварів.	true
advice_levels_onscreen_text_2139663985	До зброї, воїни! Десять солідів тому, хто принесе голову ворожого командира!	true
advice_levels_onscreen_text_2139664185	Наші війська несуть великі втрати, вождь. Але ще є люди, готові захищати свої будинки від ворогів. Починай тренувати їх зараз, щоб вони були готові, коли прийде ворог.	true
advice_levels_onscreen_text_2139657687	Клацніть по ділянці міні-мапи, щоб перейти до потрібного району. Клацніть на кнопку стратегічного огляду, щоб відкрити велику мапу. Кнопки над міні-картою дозволяють переглядати списки військ, флотів і регіонів вашої фракції, відомі вам держави, а також повідомлення про важливі події.	true
advice_levels_onscreen_text_2139660184	Жерці - чудові адміністратори і майстри маніпуляції. Їх можна найняти за допомогою кнопки найму агентів, вибравши поселення, в якому є певні споруди. Жерці вразливі для шпигунів, але вкрай ефективні проти воїнів.	true
advice_levels_onscreen_text_2139663984	Остготи йдуть! Вождь, потрібно зустріти їх на височині! Це допоможе нам тримати оборону!	true
advice_levels_onscreen_text_2139664184	Чудово! Тепер будь-яку атаку на Ольвію зустріне вся наша армія!	true
advice_levels_onscreen_text_2139664284	Все скінчено! Рим втратив Італію! Рятуйтеся втечею!	true
advice_levels_onscreen_text_2139664384	Римський флот занадто сильний! Відходимо до берега і перегруповуємося на суші!	true
advice_levels_onscreen_text_2139665384	Лучники найбільш ефективні при атаці з тилу і правого флангу, оскільки з цих напрямків противникам складніше прикриватися щитами. Підірвавши бойовий дух ворожої загін, накажіть лучникам використовувати палаючі або свистячі стріли, щоб змусити його втекти.	true
advice_levels_onscreen_text_2139664289	Чудово! Тепер наші будинки позбавлені загрози, а наші люди готові до наступу. Ми чекаємо наказу!	true
advice_levels_onscreen_text_2139664389	Захисники Петродави сховалися за стінами від нашої величезної армії! Атакуємо без зволікання!	true
advice_levels_onscreen_text_2139664589	Римляни слабкі! Час завдати удару! Тільки накажіть, володар!	true
advice_levels_onscreen_text_2139665489	Наші воїни похитнулися! Сила духу покинула їх!	true
advice_levels_onscreen_text_2139666189	У цих землях - майбутнє народу. Простягни руку, каган, і візьми його!	true
advice_levels_onscreen_text_2139666289	Ми не боїмося їхніх погроз. Наші землі - землі слов'ян. Весь світ охоплений пожежею, але ми не відчуваємо її полум'я. Нехай вона спопелить тих, хто загрожує склавинам!	true
advice_levels_onscreen_text_2139664288	Тепер ясно, що гуни і остготи - не союзники, як ми раніше думали. Гуни небезпечні, ми повинні підготуватися до наближення їх основних сил. Нам слід закінчити війну з остготами - вони ослаблені після розгрому. В атаку!	true
advice_levels_onscreen_text_2139664688	Наша зростаюча міць дозволяє набрати нові війська. Нам слід найняти ще одного полководця.	true
advice_levels_onscreen_text_2139665588	Якщо ви граєте за варварів, а вороги підійшли зовсім близько до вашого останнього поселення, ви можете кинути його і перетворити свою фракцію в орду. Орди позначаються на мапі кампанії значками возів. Вони переміщаються разом з усім населенням та інфраструктурою, а їжу добувають шляхом грабування провінцій, в яких розбили табір.	true
advice_levels_onscreen_text_2139665688	Поповнення відбувається швидше, якщо загін знаходиться в регіоні, де був набраний.	true
advice_levels_onscreen_text_1912850156	Легка кіннота розіб'є легку піхоту, важка кавалерія поб'є легку. Вся кіннота вразлива для списоносців. Підбирайте для вершників підхожого супротивника.	true
advice_levels_onscreen_text_2139664493	Ворожий полководець вибитий з сідла і заколотий! Звістка про його загибель пошириться серед ворогів і зробить нашу роботу за нас.	true
advice_levels_onscreen_text_2139665193	Битва програна! Вождь, час відступати!	true
advice_levels_onscreen_text_2139663992	Тримайте стрій! Не дозволяйте оточити себе! Наші воїни найкраще б'ються, коли не бояться ударів з тилу!	true
advice_levels_onscreen_text_2139664592	Признач гідного придворного на посаду губернатора Петродави. Вибір за тобою.	true
advice_levels_onscreen_text_1857473489	Очки дії закінчилися, дочекайтеся наступного ходу.	true
advice_levels_onscreen_text_2139660191	Воїни - це бойові герої і майстри військової справи. Їх можна найняти за допомогою кнопки найму агентів, вибравши поселення, в якому є певні споруди. Воїни вразливі для жерців, але вкрай ефективні проти доглядачів.	true
advice_levels_onscreen_text_2139664191	Рекрути приступлять до тренувань негайно, вождь.	true
advice_levels_onscreen_text_2139664591	Ви перемогли, повелитель! Римляни втекли в пустелю!	true
advice_levels_onscreen_text_2139665291	Один з ваших союзників зазнав нападу і вступив у війну, і попросив вас про допомогу. Відмова призведе до розриву союзу і важких дипломатичних наслідків. Ретельно обміркуйте своє рішення.	true
advice_levels_onscreen_text_2139664090	Нас атакують! З півночі!	true
advice_levels_onscreen_text_2139664390	До зброї, воїни! Десять солідів тому, хто першим вибереться на стіни! В бій!	true
advice_levels_onscreen_text_2139664790	Римляни вимагають, щоб ми відшкодували збитки, завдані гунами. Яка нахабність!	true
advice_levels_onscreen_text_2139664990	Як ми і передбачали, гуни повернулися. Наші джерела повідомляють, що вони збираються напасти на нас. Час готуватися до війни.	true
advice_levels_onscreen_text_2139665190	Ми перемогли! Ті, що вижили, чіпляються за уламки кораблів і благають про пощаду! Перемога!	true
advice_levels_onscreen_text_2139665390	Облога поселень може тривати роками, поступово підриваючи надійність міських стін і сили захисників. Чим довше триває облога, тим важче доводиться захисникам поселення і, отже, тим легше нападникам прорвати оборону. Почавши бій після виснажливої облоги, ви помітите, що споруди поселення сильно пошкоджені, а бойовий дух захисників нижчий, ніж зазвичай.	true
advice_levels_onscreen_text_2139665990	Однак є ті, хто прагне цьому перешкодити. З північного заходу, з-за Кантабрійських гір, вам загрожують християни-астурійці. Знищивши їх, ви підкорите собі весь Іберійський півострів.	true
advice_levels_onscreen_text_2105808871	Якщо населення провінції дуже незадоволене, починаються бунти. Ви можете спробувати задобрити народ, знизивши податки, або відправити війська навести порядок. Що б ви не вирішили, поспішіть, поки бунт не переріс у [[url:/manual/page/single-player/0044a_enc_page_campaign_play_province_public_order#enc_text_manual_public_order_rebellions]]повстання[[/url]]!	true
advice_levels_onscreen_text_2139658394	Час від часу трапляються стихійні лиха, які можуть пошкодити будівлі, знизити темпи зростання і добробуту або призупинити виробництво їжі. Все це викличе невдоволення в суспільстві.	true
advice_levels_onscreen_text_2139664197	Відмінно! Якщо пощастить, стіни будуть готові до того, як наблизиться ворог.	true
advice_levels_onscreen_text_2139664497	Ворожий командир убитий. Він помер, проклинаючи твоє ім'я! Залишилося відправити його військо слідом за ним!	true
advice_levels_onscreen_text_2139664797	Вождь, сенат Східної Римської імперії звинуватив нас у падінні Адріанополя. Вони вимагають перетворити нас на рабів і збираються надіслати війська!	true
advice_levels_onscreen_text_2139665697	Поповнення відбувається швидше, якщо корабель знаходиться у вашому порту або порту союзника, в якому можна будувати судна даного типу.	true
advice_levels_onscreen_text_2139665997	Аль-Андалус стане першим кроком до тотального підкорення мусульманами Європи і всього світу. Вперед, емір! Нехай відроджений вами халіфат стане вічним!	true
advice_levels_onscreen_text_2139664096	Ми розгромлені! Ольвія захоплена гунами! Рятуйся втечею!	true
advice_levels_onscreen_text_2139664596	Вождь, призначення губернатора може знизити невдоволення в Петродаві. Признач вправного придворного на цю посаду, і він займеться умиротворенням народу.	true
advice_levels_onscreen_text_2139664696	Правильне рішення. Цей воєначальник збере ще одну армію для захисту наших земель і народу.	true
advice_levels_onscreen_text_2139664996	У ці важкі часи може знадобитися стратегічний огляд.	true
advice_levels_onscreen_text_2139666096	І, нарешті, на Іберійському півострові набирає силу ісламський халіфат. Одного разу ви вже впоралися з ним, але це питання треба вирішити остаточно.	true
advice_levels_onscreen_text_2139666296	Ми, гараманти, споконвіку живемо на півночі Африки. Наш народ як і раніше сильний, але в світі є ті, хто загрожує його безпеці.	true
advice_levels_onscreen_text_2139657696	На вкладці сім'ї та політики міститься інформація про партії вашої правлячої фракції. Тут можна розподіляти посади і приймати політичні рішення.	true
advice_levels_onscreen_text_2139664195	Нехай місцеві жителі будують захисні споруди. Стіни навколо міста допоможуть стримати натиск ворога.	true
advice_levels_onscreen_text_2139664595	Правильне і своєчасне рішення. Губернатор вживе заходів, які заспокоять населення.	true
advice_levels_onscreen_text_2139665395	Деякі воїни в цій армії можуть продовжити навчання. Витрать гроші на їх тренування і спорядження, щоб вони могли краще служити тобі.	true
advice_levels_onscreen_text_2139665795	Дослідивши певні технології і збудувавши необхідні споруди, ви зможете поліпшити свої війська, екіпірувавши їх більш якісним спорядженням і наділивши новими здібностями. Врахуйте, що ця можливість залежить від військ, присутніх в регіоні або орді, де були виконані вищезазначені вимоги.	true
advice_levels_onscreen_text_2139666195	З давніх-давен ваш народ, вірний богам предків, живе на цих землях. Прийшов час вирушити до чужих берегів назустріч новим багатствам. Але спершу потрібно зміцнити кордони.	true
advice_levels_onscreen_text_2139665994	На північному сході оселилися франки, які одного разу вже перемагали мусульман. Знищте їх - і незабаром вся Європа впаде до ваших ніг.	true
advice_levels_onscreen_text_2139657998	Вивчіть ігрове вікно бою. Натискайте на кнопки, щоб дізнатися більше про їх призначення. Наведіть курсор на кнопку, щоб викликати спливаючу підказку, або скористайтеся енциклопедією гри.	true
advice_levels_onscreen_text_1220977758	Ваша фракція - банкрут! У вас в [[url:/manual/page/single-player/0046_enc_page_campaign_play_province_trade_finance#enc_text_manual_hud_finances]]скарбниці[[/url]] не залишилося грошей, але ви можете дещо зробити, щоб виправити ситуацію. Підніміть податки, якщо це можливо, укладіть нові торговельні угоди, прокладіть торгові шляхи, розпустіть непотрібні війська.	true
advice_levels_onscreen_text_2139660199	Договір про ненапад - угода двох фракцій про те, що вони не будуть нападати одна на одну. Такий договір можна порушити в будь-який момент, але це не пройде даром. Порушення договору протягом десяти ходів з моменту його укладення вважається зрадою, а зраднику набагато складніше укладати будь-які інші угоди.	true
advice_levels_onscreen_text_2139664299	Вождь, люди втомлені марш-кидком. Потрібен привал.	true
advice_levels_onscreen_text_2139665299	Зрозумівши, що противник неминуче захопить регіон, ви можете зруйнувати розташоване в ньому поселення, щоб позбавити ворогів здобичі. При цьому невелика частка цінностей, вивезених його жителями, надійде до вашої скарбниці. Врахуйте, що варварська фракція, здатна до переселення, в разі втрати всіх поселень автоматично перетворюється на орду.	true
advice_levels_onscreen_text_2139665599	Політичний вплив сім'ї визначається двома факторами: контролем і пануванням. Контроль - це ваша здатність керувати елітою фракції і ситуацією в цілому, що залежить від того, як ви вирішуєте політичні питання і реагуєте на події. Поліпшити його може бути непросто. Панування - це ваша влада над простим населенням, яка залежить від впливу членів вашої родини в порівнянні з іншими персонажами.	true
advice_levels_onscreen_text_2139665999	На південному заході знаходиться слабкий, але гордий Вессекс, а на заході живуть неспокійні валлійці.	true
advice_levels_onscreen_text_1747583890	Тут містяться відомості про [[url:/manual/page/single-player/0013_enc_page_campaign_play_objectives]]цілі[[/url]], завдання та умови перемоги. Кожна фракція, перш ніж досягти перемоги, повинна здійснити певні [[url:/manual/page/single-player/0044_enc_page_campaign_play_province_regions]]завоюванняl[[/url]]]. Клацніть на завдання, щоб подивитися, скільки часу на нього залишилося, або прочитати його умови.	true
advice_levels_onscreen_text_2139665198	Бунтівники напали на Фессалоніки, зруйнували укріплення і спалили місто. Наша бездіяльність виявилася настільки згубною, що Сенат постановив усунути тебе, вождь! Слід тікати, поки тебе не заарештували!	true
advice_levels_onscreen_text_2139665498	Вороги стоять на височині! Атакуйте їх обережніше!	true
advice_levels_onscreen_text_2139665598	Руйнування, влаштовані на мапі кампанії, відбиваються і на полі бою. Ремонт пошкоджених укріплень вимагає часу, якого у жителів обложеного поселення дуже мало. Без метальних машин і облогових знарядь штурм столиці провінції можливий тільки після певного терміну облоги, протягом якого ваші воїни влаштують проломи в міських стінах.	true
advice_levels_onscreen_text_2139665898	Люті гуни відтіснили ваш народ в саме серце ворожої Римської імперії. Ви змогли відсидітися за Рейном, але більше чекати не можна: залишившись тут надовго, ви ризикуєте накликати на себе гнів Риму. Тим часом алемани, ваші родичі і союзники, захищають землі ваших предків від вторгнення вандалів. Ви можете їм допомогти, але ваша справжня доля не там, а на заході - в казково багатій Іспанії. Попереду довгий і важкий шлях через чужі землі, господарі яких будуть чинити вам перешкоди на кожному кроці. Але на цьому шляху у вас буде чимало шансів здобути багатство і славу, а в його кінці ви зможете змусити римлян поділитися своїми родючими землями!	true
advice_levels_onscreen_text_2139665998	Королівство Мерсія панує у володіннях англосаксів, але на острові залишилося ще багато непідкорених земель...	true
advice_levels_onscreen_text_1599262495	Фаза очікування дозволяє вибрати найбільш підхожі погодні умови для битви. Наприклад, якщо у противника багато метальної та стрілецької зброї, дощ значно знизить її ефективність.	true
advice_levels_onscreen_text_1219328082	У багатьох вікнах ви можете помітити кнопку із знаком питання. Це кнопка допомоги. Клацніть по ній, щоб отримати детальну інформацію про те, що робить це вікно.	true
advice_levels_onscreen_text_1129360188	Піхотинці дозволяють уповільнити ворога, поки кіннота знищує його фланги. Втім, щоб скувати ворога і нанести удар, підійдуть найрізноманітніші поєднання піших, кінних і стрілецьких загонів.	true
advice_levels_onscreen_text_1900236590	Давніх торгових партнерів пов'язує не тільки договір, але і взаємна повага. Чим довше існує торговельна угода, тим більший прибуток приносять торгові шляхи.	true
advice_levels_onscreen_text_1877282481	Ви можете регулювати швидкість битви, прискорюючи і сповільнюючи час, поставити гру на паузу або включити уповільнений режим. Щоб повернутися до нормального плину часу, натисніть на кнопку в центрі.	true
advice_levels_onscreen_text_1782364698	Тут показані всі війська і кораблі, які можна [[url:/manual/page/single-player/0017_enc_page_campaign_play_military_recruit]] найняти[[/url]] в даній [[url:/manual/page/single-player/0044_enc_page_campaign_play_province_regions]]провінції[[/url]]. Клацніть правою кнопкою миші по картці загону або корабля, щоб подивитися його опис. Клацніть по картці лівою кнопкою миші, щоб додати її в чергу. Щоб видалити картку з черги, клацніть по ній. Вартість набору показана внизу, час - в лівому верхньому куті.	true
advice_levels_onscreen_text_1310965009	У легкої піхоти є спеціальні палі, щоб стримувати натиск ворожої кінноти. Кілля можна застосувати в будь-який момент, натиснувши відповідну кнопку у вікні управління битвою.	true
advice_levels_onscreen_text_2126291480	Ви успішно здійснили набіг на ворожий торговий шлях. Тепер весь їхній дохід у вас в скринях!	true
advice_levels_onscreen_text_1213169590	У вікні огляду показані картки кораблів і загонів, які входять до даної армії або флоту. Клацніть по картці, щоб вибрати загін; подвійне клацання наблизить до нього камеру. Призупинивши гру і клацнувши по картці правою кнопкою миші, ви відкриєте енциклопедію.	true
advice_levels_onscreen_text_1198010380	Ви вибрали персонажа з фракції, яку не можете контролювати. Виберіть вашого персонажа, щоб дізнатися більше про його здібності.	true
advice_levels_onscreen_text_1291133193	Атака в тил - найефективніший спосіб розбити піхоту за допомогою вершників. Будьте уважні: розумний противник напевно прикриє своїх піхотинців.	true
advice_levels_onscreen_text_1749194297	Не слід починати битву атакою на кращих бійців противника. В ідеалі ви повинні змусити ворога втекти, навіть не стикаючись з його найсильнішими загонами.	true
advice_levels_onscreen_text_428071084	Вишикувавшись в клин, вершники проводять особливо запеклі атаки. Вони врізаються в уразливі місця і в проломи в рядах ворога, розриваючи фронт і сіючи паніку і смерть. Це шикування можна вибрати відповідною кнопкою у вікні управління битвою.	true
advice_levels_onscreen_text_464946411	Тут зібрані відомості про те, який вплив має побудова, і її докладний опис. Більшість побудов дозволяють [[url:/manual/page/single-player/0045_enc_page_campaign_play_province_construction]]зводити[[/url]] більш досконалі будівлі, так що всю цю інформацію варто вивчити. І не забудьте заглянути в [[url:/home]]енциклопедію[[/url]].	true
advice_levels_onscreen_text_-878278296	Кожна армія несе [[url:/manual/page/single-player/0026_enc_page_campaign_play_military_replenish]]небойові втрати[[/url]] через хвороби та дезертирство. Вони збільшуються в пустелях і холодних районах, якщо тільки це не рідні краї бійців. Небойові втрати можливі і у відкритому морі.	true
advice_levels_onscreen_text_143874018	По можливості створіть резерв за першим рубежем оборони. Резервні загони заповнять утворені діри в строю і допоможуть відбити атаку з флангу.	true
advice_levels_onscreen_text_327923206	Один з ваших наземних торгових шляхів атакований ворожою армією. Якщо ви не втрутитеся, вороги заберуть собі весь ваш дохід!	true
advice_levels_onscreen_text_390129783	Маючи перевагу в кількості стрілецьких загонів, спробуйте прогнати ворога з висоти тільки стрілами і метальною зброєю. Використовуйте всі інші можливості, перш ніж вступати в ближній бій на пагорбі.	true
advice_levels_onscreen_text_-393224185	Схопіть ворога за горло, а потім вдарте по болючому місцю. Цей нехитрий план працює безвідмовно. Нехай частина вашої армії тримає ворога на місці, поки інша обходить його і завдає смертельного удару.	true
advice_levels_onscreen_text_-97375295	Досвідчений командувач вміє отримати вигоду з будь-якої ситуації. У тумані або густому димі неважко заховати невеликі або сильно пошкоджені кораблі. Подібний хід ускладнить завдання ворога, що може вплинути на результат битви.	true
advice_levels_onscreen_text_606296587	Ваш порт заблокований ворожою флотилією. Це не завадить вам будувати нові кораблі або ремонтувати пошкоджені, проте блокада перерве морську торгівлю вашого міста і зменшить ваші доходи. Атакуйте ворожий флот, щоб прорвати блокаду і відновити торгівлю.	true
advice_levels_onscreen_text_646906330	[[url:/manual/page/single-player/0092b_enc_page_battle_play_interface_compass]]Компас[[/url]] допомагає уточнити накази. За допомогою трьох стрілок у його верхній частині ви можете змінити напрямок руху загону, корабля або групи.	true
advice_levels_onscreen_text_700219983	Якщо ваші стрільці та легка піхота відігнали ворогів, не дозволяйте своїм стрільцям переслідувати їх, щоб вони не вплуталися в бій з головними силами противника.	true
advice_levels_onscreen_text_579859038	Сховайте сильні загони за лінією слабких. Якщо противник кинеться в наступ, ви зможете швидко вивести сильний загін і завдати вирішального удару.	true
advice_levels_onscreen_text_-595875202	Складно перемогти в бою тільки за рахунок чисельної переваги: важливий баланс військ і здібності полководця. Перш ніж кидатися в бій, оцініть співвідношення сил і дані про підкріплення. Пам'ятайте: якщо на вас напали, ви не завжди зможете ухилитися від бою. Кнопки в цьому вікні позначають ваші бойові можливості. Щоб дізнатися про них більше, наведіть на них курсор миші.	true
advice_levels_onscreen_text_632989552	Всі землі і поселення, які відомі вашій фракції, але знаходяться поза полем вашого зору, приховані туманом війни. Використовуйте агентів і війська, щоб заздалегідь розкривати підступні задуми ваших суперників.	true
advice_levels_onscreen_text_-537894077	[[url:/manual/page/single-player/0082_enc_page_battle_play_phase_conflict_groups]] Зібрані в групу[[/url]] загони або кораблі можна вишикувати в [[url:/manual/page/single-player/0081_enc_page_battle_play_phase_conflict_army_formations]]бойовий порядок[[/url]]. Виберіть порядок зі списку. Наведіть курсор на кожен з варіантів, щоб побачити його опис.	true
advice_levels_onscreen_text_952924146	Кнопкою абордажу ви віддаєте своєму кораблю наказ наблизитися до судна противника і захопити його. Наказ можна скасувати, віддавши кораблю будь-яку іншу команду.	true
advice_levels_onscreen_text_843806652	Віддавши накази на пересування, натисніть «Пробіл», і ви побачите, куди ваші загони повинні прийти. На точках призначення з'являться силуети ваших бійців. Користуйтеся цією функцією при розміщенні військ.	true
advice_levels_onscreen_text_856417993	Тут ви можете отримати інформацію про будь-який виділений об'єкт. Для військ перераховані загони, що входять до їх складу, для флоту - кораблі.	true
advice_levels_onscreen_text_-509629283	Звідси ви дізнаєтеся, який вплив має [[url:/manual/page/single-player/0039_enc_page_campaign_play_faction_technology]]технологія[[/url]], і отримаєте її докладний опис. Деякі технології необхідні для [[url:/manual/page/single-player/0045_enc_page_campaign_play_province_construction]]будівництва[[/url]] певних будівель, тому всю цю інформацію варто вивчити. Крім того, не забудьте заглянути в [[url:/home]]енциклопедію[[/url]].	true
advice_levels_onscreen_text_-339955577	Наказавши «згуртувати ряди», полководці піднімають бойовий дух загону або повертають мужність бійцям, що похитнулися. Це вміння не діє на загони зі зламаним бойовим духом - вони взагалі не слухають наказів. Щоб застосувати це вміння, наведіть курсор на будь-яку точку поблизу полководця.	true
advice_levels_onscreen_text_-825618887	Один з ваших морських торгових шляхів атакований ворожими кораблями. Якщо ви не втрутитеся, вороги так і будуть привласнювати ваш дохід.	true
advice_levels_onscreen_text_-245999870	Поки що ви розкрили не весь потенціал, який несуть природні багатства і культурні споруди цього регіону. Розвивайте такі місця. Це вплине на настрій населення, досвід агентів і військ, дохід, точність зброї, якість обладунків і так далі.	true
advice_levels_onscreen_text_-865899355	Природні ресурси можна знайти в багатьох регіонах. Видобуток цих ресурсів підвищує дохід від торгівлі, а в деяких випадках покращує якість виробленої зброї та броні. Будівництво або поліпшення садиб, рудників і особливих регіональних споруд дозволяє отримати максимум користі з наявних ресурсів.	true
advice_levels_onscreen_text_-152525085	Ви вже давно не вивчали нових [[url:/manual/page/single-player/0039_enc_page_campaign_play_faction_technology]]технологій[[/url]]. Можливо, ваші суперники пішли далеко вперед. Ідеї, які забезпечать вашій фракції перевагу над суперниками, розробляються у вікні технологій.	true
advice_levels_onscreen_text_-237447599	Право проходу є проявом довіри. Таке право дозволяє не тільки проводити військо через межі іншої держави, але й поповнювати його без дипломатичних штрафів.	true
advice_levels_onscreen_text_659772888	Полководець може [[url:/manual/page/single-player/0017_enc_page_campaign_play_military_recruit]]наймати[[/url]] війська безпосередньо в поході. Для цього відкрийте вікно найму і клацніть ЛКМ по загону, щоб додати його в чергу. Для видалення загону клацніть ще раз. Найняті війська додаються до армії полководця. Не переміщуйте армію в процесі [[url:/manual/page/single-player/0018_enc_page_campaign_play_military_stances#enc_text_manual_actions_campaign_stances_muster]]найму[[/url]].	true
advice_levels_onscreen_text_298768787	У бою між двома загонами списоносців все вирішує чисельна перевага і рівень підготовки. Використовуйте особливості ландшафту або надішліть своїм воїнам підкріплення.	true
advice_levels_onscreen_text_309592755	Щоб перешкодити ворогу на переправі, перш за все відійдіть, щоб вивести бійців з-під ворожих стріл. Коли основні сили противника почнуть переправу, відправте кілька загонів зупинити їх.	true
advice_levels_onscreen_text_593395637	Кнопка швидкості руху дозволяє прискорювати і сповільнювати рух загонів і кораблів. На великій швидкості бійці раніше досягнуть пункту призначення, проте втомиться вони набагато швидше.	true
advice_levels_onscreen_text_124410149	Якщо ворог готується до битви, дозвольте йому наблизитися. Його загони вичерпають сили під час переходу.	true
advice_levels_onscreen_text_942566659	Маневруйте, щоб перехопити ініціативу і змусити противника грати за вашими правилами. Навіть якщо ви не завершите маневр, ви відвернете ворога і порушите його власні плани.	true
advice_levels_onscreen_text_637136615	У сусідньому регіоні почалося збройне повстання. Хвиля заколотів може досягти і ваших земель. Постарайтеся запобігти цьому: збільште гарнізони або знизьте податки.	true
advice_levels_onscreen_text_-550746044	Армія, чисельність загонів якої недостатня для ефективного бою, легко може бути знищена. Щоб уникнути цього, об'єднайте два загони в один, вибравши їх і натиснувши клавіші Ctrl+M.	true
advice_levels_onscreen_text_-737235711	Це вікно дозволяє вручну об'єднувати армії або флоти, якщо потрібно зібрати особливо сильне військо. Щоб перевести загін з однієї армії в іншу, виберіть цей загін, а потім натисніть на кнопку з галочкою. При цьому ви можете вибрати відразу кілька загонів. Пам'ятайте, що у кожного війська може бути тільки один командир: перемістивши всі загони в одну з армій, ви залишите другу без військ. Все вищесказане стосується і кораблів.	true
advice_levels_onscreen_text_-788769149	Кіннота чудово підходить для обхідних маневрів. Вершники можуть швидко обійти ворога і вдарити в фланг або в тил. Втім, досвідчений полководець, швидше за все, буде готовий до такого маневру.	true
advice_levels_onscreen_text_-758254518	Якщо ворог перевершує вас числом, підготуйте собі шляхи до відступу. Так ви скоротите втрати в разі, якщо обставини складуться не на вашу користь.	true
advice_levels_onscreen_text_297255339	Тут наведено відомості про всі відомі вам фракції: чи можна з ними вести торгівлю, їх дипломатичний статус і їх ставлення до вас. Дані сортуються за будь-яким з показників.	true
advice_levels_onscreen_text_405775560	Якщо прапор загону став білим, значить, бійці втекли і більше не будуть виконувати ваші накази. Якщо поблизу виявиться полководець, можливо, йому вдасться повернути їх за допомогою особливого вміння, і воїни знову стануть вам підкорятися.	true
advice_levels_onscreen_text_-519238000	Полководці розгортають свої війська відповідно до рангу: полководець нижчого рангу починає першим. Це дозволяє більш іменитому командувачу оцінити розташування ворога і вибрати більш вигідне шикування.	true
advice_levels_onscreen_text_-757350914	Копальні полегшують видобуток золота і заліза, необхідних для торгівлі та виробництва зброї.	true
advice_levels_onscreen_text_-795357910	Якщо на [[url:/manual/page/single-player/0044a_enc_page_campaign_play_province_public_order#enc_text_manual_public_order_rebellions]]повстання[[/url]] не звертати уваги, вони швидко набирають силу. У таких випадках краще діяти негайно, інакше бунтівники захоплять всю [[url:/manual/page/single-player/0044_enc_page_campaign_play_province_regions]]провінцію[[/url]].	true
advice_levels_onscreen_text_-939651342	Щоб захопити укріплене або захищене гарнізоном поселення, часто доводиться починати облогу. Під час облоги ваші війська оточують поселення і намагаються взяти захисників виснаженням або ж починають активний штурм.	true
advice_levels_onscreen_text_-512693646	По можливості атакуйте противника з висоти. Перевага завжди у тих, хто вище по схилу.	true
advice_levels_onscreen_text_313094221	Ця кнопка скасовує накази і змушує вибрані кораблі та загони зупинитися. Натисніть кнопку швидше, ніж віддати новий наказ.	true
advice_levels_onscreen_text_-600261031	Будь-яка армія, флотилія або агент можуть отримати відомості про ворожі армії, кораблі та поселення, які знаходяться в безпосередній близькості від них або в їх полі зору. Наскільки докладними будуть отримані відомості, залежить від спостерігача. Так, розвідники зможуть дізнатися більше, ніж воїни.	true
advice_levels_onscreen_text_-109318922	Якщо вбити воєначальника, бойовий дух ворога буде підірваний.	true
advice_levels_onscreen_text_-722605174	Ця кнопка дозволяє об'єднати загони або кораблі в [[url:/manual/page/single-player/0082_enc_page_battle_play_phase_conflict_groups]]групу[[/url]] - так буде зручніше віддавати накази. Щоб вибрати групу ще раз, клацніть на закладці з її номером або натисніть відповідну клавішу. Щоб розпустити групу, клацніть ще раз на цій кнопці.	true
advice_levels_onscreen_text_-474106108	Тут показана інформація про [[url:/manual/page/single-player/0047_enc_page_campaign_play_characters]]персонажа[[/url]], який є вашим союзником, ворогом або налаштований нейтрально. Дізнайтеся його ім'я, місцезнаходження, [[url:/manual/page/single-player/0052_enc_page_campaign_play_characters_traits]]особливості[[/url]] і [[url:/manual/page/single-player/0051_enc_page_campaign_play_characters_skills]]навички [[/url]], а також відомості про його [[url:/manual/page/single-player/0053_enc_page_campaign_play_characters_ancillaries]]допоміжні засоби[[/url]].	true
advice_levels_onscreen_text_-855205336	Клацніть правою кнопкою, щоб [[url:/manual/page/single-player/0019_enc_page_campaign_play_military_movement]]відправити[[/ur]] армію або флот в будь-яке місце підсвіченої ділянки. Для [[url:/manual/page/single-player/0016_enc_page_campaign_play_military_attack]]атаки [[/url]] клацніть правою кнопкою миші на вороже [[url:/manual/page/single-player/0044_enc_page_campaign_play_province_regions]]поселення[[/url]] або армію. Клацніть правою кнопкою миші на море, і ваша армія автоматично спуститься на кораблі. Можна з'єднати два дружні війська або флотилії, направивши їх в одну точку.	true
advice_levels_onscreen_text_-426685576	Деякі види військ - майстри маскування, вони можуть залишатися майже невидимими на будь-якій місцевості. Розташовуйте такі частини осторонь від основних сил, щоб ворог їх не помітив. Відразу після початку битви можна влаштувати раптову атаку з флангу.	true
advice_levels_onscreen_text_111349601	Пагорби простіше обороняти, оскільки атака на спуску дає додаткові переваги в бою. Краще дати бій на крутому схилі, а не на плоскій вершині.	true
advice_levels_onscreen_text_336059036	Гроші можна вимагати або просити. Золотом виплачують репарації і данину, відкуповуються від нападу. Виплати, які не є частиною дипломатичної угоди, вважаються даром однієї держави іншій.	true
advice_levels_onscreen_text_969317109	У вашій скарбниці недостатньо коштів, щоб щось будувати в цей хід. Підвищіть податки, збільште торговельні зв'язки або розпустіть непотрібні війська, щоб відразу підвищити дохід.	true
advice_levels_onscreen_text_-729505557	Шкала балансу сил дозволяє порівняти міць вашої армії і війська противника.	true
advice_levels_onscreen_text_-388492343	У вашій скарбниці ледь вистачає коштів, щоб покрити поточні витрати. Щоб збирати податки з провінцій більш ефективно, покращуйте міста в міру можливості.	true
advice_levels_onscreen_text_886642523	Дорожня система [[url:/manual/page/single-player/0044_enc_page_campaign_play_province_regions]]провінції[[/url]] розвивається з ростом добробуту. Чим вища якість доріг, тим швидше по них пересуваються [[url:/manual/page/single-player/0016_enc_page_campaign_play_military_attack]]війська[[/url]] і агенти. Крім того, поліпшення доріг збільшує радіус огляду як з дороги, так і з боку найближчого поселення. Дороги збільшують шанс виявити ворожих [[url:/manual/page/single-player/0047_enc_page_campaign_play_characters]]агентів[[/url]].	true
advice_levels_onscreen_text_528599210	Скарбниця - це гроші, якими на даний момент володіє ваша фракція. Поруч з обсягом скарбниці вказані дата і очікувана сума доходу на наступний хід.	true
advice_levels_onscreen_text_259529015	Миготливий прапор означає, що ваш загін ось-ось похитнеться і кинеться втечу. Ваш полководець може надихнути солдатів на бій. Використовуйте цю здатність, щоб повернути бійцям присутність духу. Деякі елітні типи піхоти також можуть надихати соратників.	true
advice_levels_onscreen_text_-925500629	Виберіть цей пункт, щоб вимагати від фракції вступити у війну на вашому боці. Таким чином ви можете обзавестися новим союзником, якщо ситуація складається не на вашу користь. Ви і самі можете запропонувати фракції військову підтримку, щоб підвищити шанси на успішне укладення угоди.	true
advice_levels_onscreen_text_-854614115	У позиції на пагорбі багато переваг. У вас буде перевага в ближньому бою, а крутий підйом вимотує противника. Нарешті, стріляти зверху вниз набагато зручніше.	true
advice_levels_onscreen_text_942378261	Намагайтеся вишикувати військо єдиним фронтом. Ворог негайно використає будь-які прогалини, щоб зайти вам в тил або розірвати стрій, що неминуче призведе до катастрофи.	true
advice_levels_onscreen_text_131718024	Щоб зайняти висоту раніше за ворога, не намагайтеся його перегнати. Підійдіть до позиції непомітно, щоб ворог не бачив причин поспішати. По можливості відверніть його гарною приманкою.	true
advice_levels_onscreen_text_588232477	Захопивши [[url:/manual/page/single-player/0044_enc_page_campaign_play_province_regions]]поселення[[/url]], слід залишити в ньому сильний гарнізон, який зможе придушувати заворушення до тих пір, поки число жителів не досягне норми, а зруйновані споруди не будуть [[url:/manual/page/single-player/0044_enc_page_campaign_play_province_regions]]відновлені[[/url]].	true
advice_levels_onscreen_text_-981340853	Краще, якщо піхота зустрічає ворога зустрічним ударом, а не чекає атаки на місці. Секрет у тому, щоб рушити війська в останній момент: так ваші загони не встигнуть втомитися або порушити стрій.	true
advice_levels_onscreen_text_667337653	У цьому вікні показана статистична інформація про обрану провінцію. У правій його частині перераховані фактори, що впливають на громадський порядок, а в лівій - на місцеву економіку. Щоб звільнити провінцію від податків, скористайтеся позначкою в лівій нижній частині панелі.	true
advice_levels_onscreen_text_113649401	Дуже великі армії або флоти, що складаються з двох і більше груп, не завжди можуть битися як єдине ціле. У складі двох армій фракція може виставити не більше сорока загонів одночасно.	true
advice_levels_onscreen_text_-895189344	Ваш полководець вміє надихати найближчих бійців, але тільки своїх, а не союзних. Поруч з полководцем загін, що похитнувся, може зібратися з духом і залишитися в бою.	true
advice_levels_onscreen_text_-325593809	Витрати на утримання армії залишили вашу фракцію без грошей. [[url:/manual/page/single-player/0017_enc_page_campaign_play_military_recruit]] Найм[[/url]] військ і [[url:/manual/page/single-player/0045_enc_page_campaign_play_province_construction]]будівництво[[/url]] призупинені до тих пір, поки у вас не з'являться кошти. Ви можете скоротити витрати, розпустивши непотрібні війська.	true
advice_levels_onscreen_text_-234487411	Щоб здійснити обхідний маневр, потрібно обігнути бойові порядки противника і вдарити в фланг або в тил. Решта ваших загонів повинні атакувати в лоб, не даючи ворогу розвернутися і відбити фланговий удар.	true
advice_levels_onscreen_text_463216958	Вибравши цей пункт, ви попросите фракцію розірвати союз з третьою стороною. Користуйтеся цим, щоб запобігти створенню небезпечних коаліцій проти вашої держави. Ви і самі можете запропонувати розірвати союз для поліпшення своєї позиції на переговорах.	true
advice_levels_onscreen_text_132393743	Якщо вам нав'язали бій в гірській ущелині, притисніться до стін ущелини, щоб один з флангів впирався в крутий схил. Якщо є можливість, розмістіть на висоті своїх стрільців.	true
advice_levels_onscreen_text_737354545	Ви можете дозволити бійцям [[url:/manual/page/single-player/0092f_enc_page_battle_play_interface_fire]]стріляти по готовності[[/url]]. Вимкнувши цей режим, ви збережете боєприпаси, але ваші загони і кораблі не почнуть стрілянину, поки не отримають спеціальний наказ.	true
advice_levels_onscreen_text_932121968	Ворог спробує обійти ваші укріплення або взяти їх штурмом. Нехай лучники відстрілюють ворогів на підході, а війська ближнього бою добивають тих, хто дістався до площі. Завдання ворога - знищити захисників. Якщо ваші люди втечуть, ви також програєте битву!	true
advice_levels_onscreen_text_-245662021	Лінійне шикування не завжди найкраще. Сходинка, злам або вигин у ваших рядах дозволять двом вашим загонам одночасно вдарити по одному ворожому. Не забувайте, що противник може використовувати схожу тактику.	true
advice_levels_onscreen_text_-594453008	Вибравши загін стрільців або метальників, ви побачите кнопку режиму перестрілки. За замовчуванням цей режим вимкнений; натиснувши на кнопку, ви увімкнете його. У режимі перестрілки загін прагне уникати ближнього бою і атакує ворога стрілами, дротиками або камінням з пращі.	true
advice_levels_onscreen_text_44290589	Швидкий кінний загін - невигідна ціль для стрілецьких військ. Звичайно, ви можете вести стрілянину і навіть вбити кілька вершників, але краще вибрати для обстрілу щільний бойовий порядок, що стоїть нерухомо або рухається прямо на вас.	true
advice_levels_onscreen_text_68074087	У поселенні, яке вважається адміністративним центром [[url:/manual/page/single-player/0044_enc_page_campaign_play_province_regions]]регіону[[/url]], знаходяться і [[url:/manual/page/single-player/0039a_enc_page_campaign_play_province_trade_finance]] торгові[[/url]] і [[url:/manual/page/single-player/0020_enc_page_campaign_play_military]]військові[[/url]] споруди. Поселення споживають значну частину продовольства провінції. Дуже важливо покращувати споруди, пов'язані з харчуванням, інакше голоду не уникнути.	true
advice_levels_onscreen_text_17591341	Кіннота завдає додаткової шкоди, коли на скаку врізається в ряди противника. Вершники можуть розкидати ворога серією смертоносних ударів, чергуючи відступи і напади.	true
advice_levels_onscreen_text_68241043	Тепер ваше військо готове влаштувати [[url:/manual/page/single-player/0022_enc_page_campaign_play_military_ambush]]засідку[[/url]]. Пам'ятайте, що ворог може точно так само непомітно оточити ваших людей.	true
advice_levels_onscreen_text_97123942	Таймер показує час до кінця битви. За цей період атакуюча сторона повинна змусити ворога втекти або знищити його. Захисникам для перемоги потрібно протриматися відведений час, так що вони можуть перемогти, навіть якщо атакуючих на порядок більше.	true
advice_levels_onscreen_text_-1567524386	Проста піхота чудово підходить для того, щоб притримати ворога на місці, поки ви обходите його з флангу. Пам'ятайте: чим нижчий клас піхоти, тим швидше вона буде зламана і втече.	true
advice_levels_onscreen_text_-1394403499	У цьому [[url:/manual/page/single-player/0044_enc_page_campaign_play_province_regions]]регіоні[[/url]] є порт, який використовує не всі свої можливості. Покращуйте порти, щоб [[url:/manual/page/single-player/0045_enc_page_campaign_play_province_construction]]будувати[[/url]] більш потужні і важкі кораблі, торгувати з іншими державами і збільшувати дохід, що надходить до скарбниці.	true
advice_levels_onscreen_text_-1528505088	Тут показані всі споруди поселення. Наведіть на них курсор, щоб подивитися, що ще можна [[url:/manual/page/single-player/0045_enc_page_campaign_play_province_construction]]побудувати[[/url]]. Клацніть по будівлі правою кнопкою миші, щоб прочитати її опис. Клацніть лівою кнопкою миші, щоб додати її в чергу на будівництво, і ще раз - щоб прибрати звідти.	true
advice_levels_onscreen_text_-1395907252	Будівлі, які пов'язані з виробництвом їжі, не забезпечують вашу державу достатньою кількістю продовольства, що призводить до перебоїв у постачанні. Як можна швидше поліпшіть всі подібні будівлі: постійний голод призведе до зростання невдоволення.	true
advice_levels_onscreen_text_-1961998855	Легка кавалерія з великим успіхом переслідує легких піхотинців і стрільців. Вона допомагає прикривати маневри і добивати ізольовані загони. Якщо противник виставив легких вершників, позбудьтеся їх - якщо наздоженете.	true
advice_levels_onscreen_text_-2014914668	Розміщуйте кінноту на флангах, це дасть вам простір для маневру. Вона зупинить обхідний маневр ворога, а при нагоді сама вдарить у фланг.	true
advice_levels_onscreen_text_164466	Ви успішно заблокували ворожий порт. Однак, це не завадить їм будувати нові кораблі або ремонтувати пошкоджені. Зате блокада істотно знизить дохід від торгівлі через порт.	true
advice_levels_onscreen_text_-2017583094	Тут ви зможете дослідити [[url:/manual/page/single-player/0039_enc_page_campaign_play_faction_technology]]технологію[[/url]], яка дасть вам перевагу над [[url:/manual/page/single-player/0013_enc_page_campaign_play_objectives]]суперниками[[/url]] . Виберіть предмет дослідження. Для цього не потрібні ніякі споруди, проте для будівництва деяких [[url:/manual/page/single-player/0045_enc_page_campaign_play_province_construction]]будівель[[/url]] будуть потрібні певні технології. Наведіть курсор на назву технології, щоб побачити короткий опис, дізнатися, який ефект дасть технологія і скільки часу потрібно для її вивчення.	true
advice_levels_onscreen_text_-1755835367	[[url:/manual/page/single-player/0092_enc_page_battle_play_interface]] Міні-мапа[[/url]] дозволяє поглянути на поле бою з висоти пташиного польоту, уточнити розташування ваших військ, кораблів або видимих ворогів і оцінити місцевість. За допомогою такої мапи ви також можете віддавати накази.	true
advice_levels_onscreen_text_-1901858416	Так ви можете офіційно оголосити війну іншій фракції. Перш ніж розв'язати війну, ретельно обміркуйте наслідки такого рішення.	true
advice_levels_onscreen_text_-1030015586	У режимі оборони ваші загони будуть прагнути утримати стрій, відбиваючи атаку, і не будуть переслідувати ворога, що похитнувся. Щоб увімкнути цей режим, виберіть загін і натисніть кнопку «Режим оборони».	true
advice_levels_onscreen_text_-1341063580	Легка кавалерія - відмінна приманка для ворога. Заманюйте ворогів в засідку, змушуйте їх покинути стрій, або нехай вони просто витратять всі сили, ганяючись за вашими вершниками!	true
advice_levels_onscreen_text_-2039862233	Тут показана статистика битви. У цьому ж вікні ви можете вибрати, що робити із захопленим поселенням: [[url:/manual/page/single-player/0021_enc_page_campaign_play_military_sieges#enc_text_manual_army_attack_capture_occupy]]окупувати[[/url]], [[url:/manual/page/single-player/0021_enc_page_campaign_play_military_sieges#enc_text_manual_army_attack_capture_loot]]розграбувати[[/url]], розороти або зруйнувати.	true
advice_levels_onscreen_text_-1002927119	Торгові судна ворога - чесна здобич під час війни. Коли торговий маршрут знаходиться в зоні вашого впливу, переведіть кораблі в режим нальоту, і ви отримаєте дохід від нальотів на ворожий торговий флот.	true
advice_levels_onscreen_text_-1875830202	Зустрівши ворога, у якого більше стрільців, ніж у вас, вступайте в рукопашну якомога швидше.	true
advice_levels_onscreen_text_-1243953931	Ця функція дозволить укладати військові союзи. Ви зможете покликати такого союзника на допомогу під час війни. Пам'ятайте, що й іншій стороні може знадобитися ваша підтримка. Відмова в допомозі призведе до розірвання союзу.	true
advice_levels_onscreen_text_-1076388291	Вибравши загін стрільців або метальників, ви побачите кнопку режиму перестрілки. За замовчуванням цей режим вимкнений; натиснувши на кнопку, ви увімкнете його. У режимі перестрілки загін прагне уникати ближнього бою і атакує ворога стрілами, дротиками або камінням з пращі.	true
advice_levels_onscreen_text_-1442955838	Хоробрість і дисципліна воїнів залежить від їх бойового духу - почуття гордості і впевненості в своїх силах. Бойовий дух підвищується на тренуваннях, у міру накопичення досвіду і в присутності полководця. Якщо ж полководець гине, а вороги перевершують загін числом, бойовий дух падає. Індикатор бойового духу знаходиться під прапором загону.	true
advice_levels_onscreen_text_-1961571108	Після угоди між вами і вашим новим торговим партнером буде прокладено торговий шлях. Ретельно охороняйте його: вороги можуть руйнувати торгові шляхи, підриваючи вашу економіку.	true
advice_levels_onscreen_text_-1744509802	Можливо, ворог спробує обійти вас з флангу, використовуючи кінноту. Будьте передбачливі. Розмістіть на флангах піхотні резерви, здатні перехопити вершників.	true
advice_levels_onscreen_text_-1009457400	Якщо ворог намагається припинити обхідний маневр вашої кінноти (наприклад, вислав на перехоплення свою піхоту), скасуйте маневр, але залиште кінноту там, де вона буде становити загрозу. Так ви виснажите ворога, не зазнавши жодних втрат.	true
advice_levels_onscreen_text_-2134517828	Якщо противник пішов в глибоку оборону, спровокуйте атаку діями легкої піхоти або застрільників. Приведений в сказ противник діє поспішно і безрозсудно.	true
advice_levels_onscreen_text_-1899489232	Загін, оточений в ближньому бою, не може втекти і буде битися до останньої краплі крові. Будьте обережні: найнебезпечніший ворог - той, кому нічого втрачати.	true
advice_levels_onscreen_text_-1467085177	Розмістіть лінію оборони там, де ворог зібрав основні сили. Але якщо він сильний у всьому, уникайте його. Завдайте удар, коли його не чекають.	true
advice_levels_onscreen_text_-1381776408	Керувати камерою на мапі кампанії легко. Щоб рухатися вперед, натисніть W, назад - S. Кнопки A і D рухають камеру вліво-вправо. Q і E - розворот. Також ви можете затиснути колесо прокрутки миші і потягнути мишу в потрібну сторону. Або просто підведіть курсор до краю екрану, щоб зрушити мапу. Змінити масштаб можна кнопками X і Z або колесом прокрутки.	true
advice_levels_onscreen_text_-1246754910	Як правило, найкраща тактика - оточити ворога і обсипати його стрілами з боків і тилу. Навіть якщо він розвернеться, щоб відбити удар, його порядки будуть порушені. Скористайтеся замішанням, щоб відправити в бій кінноту.	true
advice_levels_onscreen_text_-1241185070	Це вікно показує важливу інформацію про певний тип загону. Тут вказані: кількість людей, вартість [[url:/manual/page/single-player/0017_enc_page_campaign_play_military_recruit]]найму[[/url]], витрати на утримання, статистика, вміння загону і докладний опис.	true
advice_levels_onscreen_text_-1282356525	Головні якості легкої кінноти - витривалість і рухливість. Такі вершники ідеально підходять для розвідки. Навіть потрапивши в біду, вони завжди зуміють врятуватися на своїх швидких скакунах.	true
advice_levels_onscreen_text_-1060140303	Зобразити відступ, принісши в жертву слабкий загін, - вірний спосіб виманити захисників з укріпленої позиції або заманити ворога в засідку. Однак не забувайте: удаваний відступ нерідко переходить у справжній!	true
advice_levels_onscreen_text_-1890476358	Якщо ви збираєтеся напасти на ворога, що розташувався за річкою, для початку ослабте його шквалом стріл і дротиків і лише потім вступайте в рукопашну.	true
advice_levels_onscreen_text_-1871866990	На загальний рівень задоволеності населення впливають різні фактори, в тому числі рівень оподаткування, культурні відмінності, наслідки воєн, нестача їжі, імміграція, наявність розважальних споруд, забруднення та дії ворожих агентів. Якщо цей рівень падає настільки низько, що репресії вже не в змозі підтримувати його, виникає ризик повстання.	true
advice_levels_onscreen_text_-1062679364	Натисніть клавішу Backspace, щоб зупинити пересування своїх військ, кораблів і агентів на мапі кампанії.	true
advice_levels_onscreen_text_-1516645363	Якщо на вашому боці чисельна перевага, оточіть ворога і перебийте всіх до останнього. Не щадіть їх!	true
advice_levels_onscreen_text_-1808504559	Порти, садиби та інші землеробські споруди підвищують дохід і запаси їжі у всіх ваших регіонах. Щоб уникнути нестачі продовольства, своєчасно покращуйте такі об'єкти.	true
advice_levels_onscreen_text_-1701749777	Навчіться використовувати всю ударну силу кінноти. Вводячи вершників у бій, обов'язково змушуйте їх прискоритися за кілька футів до ворожої формації. Для цього двічі клацніть по противнику правою кнопкою миші. Не варто швидко долати великі відстані: ви тільки даремно втомите вершників.	true
advice_levels_onscreen_text_-1969897884	Щоб розбити озброєну списом піхоту за допомогою вершників, бийте з флангу. Не слід кидатися прямо на списи: списоносці краще за інших знають, як боротися з кіннотою.	true
advice_levels_onscreen_text_-1995657968	Тут перераховані всі активні війська і агенти вашої фракції. Тут же вказані очки дій, чисельність, ім'я воєначальника, його ранг і ступінь його відданості. Дані сортуються за будь-яким з показників.	true
advice_levels_onscreen_text_-1906180227	Кіннота вкрай вразлива, якщо захищається в нерухомому строю. Не ставте її в лінію оборони, якщо не збираєтеся потім вислати її в бій. Для того, щоб закрити утворену пролом, тримайте в резерві піхоту.	true
advice_levels_onscreen_text_-1666667854	Щоб захистити цінні загони від стріл і списів противника, можна прикрити їх загонами простої піхоти.	true
advice_levels_onscreen_text_-1594313916	При обороні важливо знати, як далеко можуть [[url:/manual/page/single-player/0019_enc_page_campaign_play_military_movement]]просунутися[[/url]] війська нападників. Клацніть по ворожій армії, щоб побачити, як далеко вона зможе дійти. Якщо ворожа армія перегороджує вам шлях, місце зустрічі буде підсвічено. Щоб пройти його, доведеться битися або вибрати інший шлях.	true
advice_levels_onscreen_text_-1581561178	Чим довше діяла угода, тим більшим буде штраф за розірвання союзу. Довіра між партнерами з часом зростає і чим більше повага до вашої фракції, тим гіршим буде розчарування.	true
advice_levels_onscreen_text_-2023390722	Не посилайте кінноту в атаку на дерев'яні палі. На великій швидкості коні не зможуть відразу зупинитися, а зіткнення загрожує їм загибеллю.	true
advice_levels_onscreen_text_-1999396619	У цьому вікні показана інформація про [[url:/manual/page/single-player/0047_enc_page_campaign_play_characters]]персонажів[[/url]] вашої фракції. Тут містяться їхні імена, положення на мапі, [[url:/manual/page/single-player/0052_enc_page_campaign_play_characters_traits]]особливості[[/url]] та [[url:/manual/page/single-player/0051_enc_page_campaign_play_characters_skills]]навички [[/url]], а також відомості про [[url:/manual/page/single-player/0053_enc_page_campaign_play_characters_ancillaries]]додаткових персонажів або об'єкти[[/url]].	true
advice_levels_onscreen_text_-1805368716	Керувати камерою на полі бою зовсім нескладно. Щоб зрушити мапу, підведіть курсор до краю екрана. Використовуйте клавішу «W», щоб зрушити камеру вперед, «S» - назад, клавіші «A» і «D» для руху в сторони. Клавіші «X» і “Z” або колесо прокрутки дозволять наблизити або віддалити камеру. Клавіші «+» і «-» змінять кут огляду.	true
advice_levels_onscreen_text_-2004663178	Обхідний маневр - не єдиний спосіб зайти за лінію оборони. Знайдіть вразливе місце в строю противника, послабте його за допомогою стрільців, а потім пробийте пролом основною масою воїнів.	true
advice_levels_advice_item_title_1019079545	Нерухомі цілі	true
advice_levels_advice_item_title_1621609724	Кнопка «Відкликати»	true
advice_levels_advice_item_title_2032462934	Розгортання військ	true
advice_levels_advice_item_title_2139665715	Режим союзу	true
advice_levels_advice_item_title_2139666215	Королівство данів	true
advice_levels_advice_item_title_2139660214	Оборонний союз	true
advice_levels_advice_item_title_2139665714	Військові ланцюжки варварів	true
advice_levels_advice_item_title_1110538712	Гарнізони	true
advice_levels_advice_item_title_2139664916	Західна Римська імперія	true
advice_levels_advice_item_title_1000206666	Швидке завантаження/збереження	true
advice_levels_advice_item_title_2139657712	Торгівля	true
advice_levels_advice_item_title_2139665611	Губернатори	true
advice_levels_advice_item_title_1041566911	Захист флангів кіннотою	true
advice_levels_advice_item_title_2087532824	Ворог на пагорбі	true
advice_levels_advice_item_title_2139665810	Політика	true
advice_levels_advice_item_title_2139666110	Королівство Астурія	true
advice_levels_advice_item_title_1060240560	Ловля на живця (засідки)	true
advice_levels_advice_item_title_2139665313	Губернатори	true
advice_levels_advice_item_title_2139658011	Особливості фракції	true
advice_levels_advice_item_title_2139666212	Королівство данів	true
advice_levels_advice_item_title_2139666312	Гараманти	true
advice_levels_advice_item_title_2139666319	Гараманти	true
advice_levels_advice_item_title_1838504917	Нальоти на торгові шляхи	true
advice_levels_advice_item_title_2139665718	Осілість	true
advice_levels_advice_item_title_2139666018	Королівство Мерсія	true
advice_levels_advice_item_title_2139658019	Можливі ефекти	true
advice_levels_advice_item_title_2139658419	Заворушення	true
advice_levels_advice_item_title_2139665705	Задній хід	true
advice_levels_advice_item_title_2139665304	Забруднення і хвороби	true
advice_levels_advice_item_title_2139657704	Журнал	true
advice_levels_advice_item_title_2139660207	Прохання про мир	true
advice_levels_advice_item_title_2139665307	Зміна клімату	true
advice_levels_advice_item_title_2139665607	Набуття впливу	true
advice_levels_advice_item_title_1572526606	Штурм пагорба	true
advice_levels_advice_item_title_2139664906	Держава Сасанідів	true
advice_levels_advice_item_title_2139657902	Штурм з моря	true
advice_levels_advice_item_title_2139657903	Штурм з моря!	true
advice_levels_advice_item_title_2139666303	Гараманти	true
advice_levels_advice_item_title_2139665302	Наслідки облоги	true
advice_levels_advice_item_title_2139666102	Королівство Карла Великого	true
advice_levels_advice_item_title_2139666202	Королівство данів	true
advice_levels_advice_item_title_1229686133	Громадський порядок	true
advice_levels_advice_item_title_2139660209	Створення конфедерації	true
advice_levels_advice_item_title_2139666008	Королівство Мерсія	true
advice_levels_advice_item_title_2139666108	Королівство Астурія	true
advice_levels_advice_item_title_2139657708	Податки	true
advice_levels_advice_item_title_1213263346	Штурм укріплень	true
advice_levels_advice_item_title_2139664935	Алани	true
advice_levels_advice_item_title_2139665835	Бойовий дух ворога	true
advice_levels_advice_item_title_2139666135	Королівство Астурія	true
advice_levels_advice_item_title_1264671506	Укладення торговельних угод	true
advice_levels_advice_item_title_1216301252	Кілька ходів	true
advice_levels_advice_item_title_2139665337	Родючість	true
advice_levels_advice_item_title_2139665637	Обстріл	true
advice_levels_advice_item_title_2139660136	Режими військ	true
advice_levels_advice_item_title_2139665736	Орди	true
advice_levels_advice_item_title_2139658532	Напад із засідки	true
advice_levels_advice_item_title_2139660231	Взаємодія на війні	true
advice_levels_advice_item_title_2139665731	Орди	true
advice_levels_advice_item_title_2139666231	Білі гуни	true
advice_levels_advice_item_title_2139663230	Почесні посади	true
advice_levels_advice_item_title_2139664930	Гуни	true
advice_levels_advice_item_title_2139665330	Колонізація	true
advice_levels_advice_item_title_2139665730	Лангобарди	true
advice_levels_advice_item_title_2139666230	Королівство данів	true
advice_levels_advice_item_title_1247116376	Захист стрільців	true
advice_levels_advice_item_title_1223289843	Ремонт пошкоджених будівель	true
advice_levels_advice_item_title_1242280643	Технології	true
advice_levels_advice_item_title_1245539238	Суворий клімат	true
advice_levels_advice_item_title_2139663139	Громадянська війна	true
advice_levels_advice_item_title_2139663339	Нестача їжі	true
advice_levels_advice_item_title_2139666239	Анти	true
advice_levels_advice_item_title_2139660238	Зустрічна пропозиція	true
advice_levels_advice_item_title_2139666038	Королівство Ломбардія	true
advice_levels_advice_item_title_2139666338	Анти	true
advice_levels_advice_item_title_2139657938	Легендарні будівлі	true
advice_levels_advice_item_title_2139658438	Втрата полководця	true
advice_levels_advice_item_title_2139658039	Поставки їжі	true
advice_levels_advice_item_title_2139665825	Збитки поселенню	true
advice_levels_advice_item_title_2139658427	Зростання регіону	true
advice_levels_advice_item_title_2139660224	Штучний інтелект управління групами	true
advice_levels_advice_item_title_2139663924	Сенсорне управління	true
advice_levels_advice_item_title_2139658024	Завдання	true
advice_levels_advice_item_title_1212661715	Бережіть людей	true
advice_levels_advice_item_title_2045097248	Репресії	true
advice_levels_advice_item_title_2047305771	Залежні держави	true
advice_levels_advice_item_title_2139665326	Занедбані регіони	true
advice_levels_advice_item_title_1387459530	Обхід з флангу	true
advice_levels_advice_item_title_2139658422	Громадянська війна	true
advice_levels_advice_item_title_2139665621	Стрільці в ближньому бою	true
advice_levels_advice_item_title_1170317847	Ціль для далекобійних машин	true
advice_levels_advice_item_title_2139666120	Королівство Астурія	true
advice_levels_advice_item_title_2139666220	Королівство данів	true
advice_levels_advice_item_title_2139663222	Вірність	true
advice_levels_advice_item_title_2139664922	Східна Римська імперія	true
advice_levels_advice_item_title_2139666022	Королівство Мерсія	true
advice_levels_advice_item_title_4066993	Регіон без гарнізону	true
advice_levels_advice_item_title_1649185866	Місцевість і пересування	true
advice_levels_advice_item_title_2139666029	Королівство Ломбардія	true
advice_levels_advice_item_title_2139666129	Королівство Астурія	true
advice_levels_advice_item_title_2139666028	Королівство Мерсія	true
advice_levels_advice_item_title_2139666328	Гараманти	true
advice_levels_advice_item_title_2139658456	Поселення без гарнізону	true
advice_levels_advice_item_title_2139658556	Повідомлення про події	true
advice_levels_advice_item_title_2139665355	Підпал	true
advice_levels_advice_item_title_2139665654	Поповнення 1	true
advice_levels_advice_item_title_2139665857	Згуртованість	true
advice_levels_advice_item_title_2139666157	Вестфальці	true
advice_levels_advice_item_title_1913603768	Радник	true
advice_levels_advice_item_title_2139658052	Дерево умінь	true
advice_levels_advice_item_title_2139663351	Спадщина і традиції	true
advice_levels_advice_item_title_1475059206	Не дайте їм розслабитися	true
advice_levels_advice_item_title_2139658053	Особливості регіону	true
advice_levels_advice_item_title_2139658553	Атака на списоносців	true
advice_levels_advice_item_title_2139660150	Вплив	true
advice_levels_advice_item_title_2139664950	Вестготи	true
advice_levels_advice_item_title_2139665353	Бойовий дух	true
advice_levels_advice_item_title_2139666153	Вестфальці	true
advice_levels_advice_item_title_1759254827	Шкала завантаження	true
advice_levels_advice_item_title_2139657851	Зниження добробуту регіону	true
advice_levels_advice_item_title_2139660252	Об'єкти для розміщення	true
advice_levels_advice_item_title_2139665952	Вандальське царство	true
advice_levels_advice_item_title_2139666252	Анти	true
advice_levels_advice_item_title_1227695361	Укріплений табір	true
advice_levels_advice_item_title_1591689763	Кіннота проти списоносців	true
advice_levels_advice_item_title_2139665959	Вестготське царство	true
advice_levels_advice_item_title_2139666159	Вестфальці	true
advice_levels_advice_item_title_2139666259	Венеди	true
advice_levels_advice_item_title_1949671761	Поповнення сил	true
advice_levels_advice_item_title_2139666058	Королівство Ломбардія	true
advice_levels_advice_item_title_1273390037	Гірські перевали	true
advice_levels_advice_item_title_1953611164	Повстання!	true
advice_levels_advice_item_title_2139657746	Порти	true
advice_levels_advice_item_title_2139665745	Аллемани	true
advice_levels_advice_item_title_2139666145	Вестфальці	true
advice_levels_advice_item_title_2139665344	Баррикади	true
advice_levels_advice_item_title_2139660147	Політика марнославства	true
advice_levels_advice_item_title_2139665947	Остготське царство	true
advice_levels_advice_item_title_2139658045	Особливості персонажа	true
advice_levels_advice_item_title_2139660246	Знамениті битви	true
advice_levels_advice_item_title_2139663546	Найм агентів	true
advice_levels_advice_item_title_2139664946	Франки	true
advice_levels_advice_item_title_2139665646	Оборона стін	true
advice_levels_advice_item_title_2139665946	Франкське царство	true
advice_levels_advice_item_title_2139666246	Анти	true
advice_levels_advice_item_title_2139657942	Дилеми	true
advice_levels_advice_item_title_2139664941	Сакси	true
advice_levels_advice_item_title_2139658443	Очки досвіду корабля	true
advice_levels_advice_item_title_2139660140	Набір армії	true
advice_levels_advice_item_title_2139665940	Римська експедиція	true
advice_levels_advice_item_title_2139666140	Вестфальці	true
advice_levels_advice_item_title_1392703367	Збільшення швидкості руху	true
advice_levels_advice_item_title_2139658540	Захист від засідки	true
advice_levels_advice_item_title_1391140702	Блокування портів	true
advice_levels_advice_item_title_2139657841	Релігійні бунти	true
advice_levels_advice_item_title_2139658041	Оточення персонажа	true
advice_levels_advice_item_title_1119796260	Торгові стратегії	true
advice_levels_advice_item_title_1212482652	Кіннота в резерві	true
advice_levels_advice_item_title_1217921189	Утримання загону	true
advice_levels_advice_item_title_1242837398	Торгівля	true
advice_levels_advice_item_title_2139665749	Родючість	true
advice_levels_advice_item_title_2139666249	Анти	true
advice_levels_advice_item_title_2139665848	Грабіжники	true
advice_levels_advice_item_title_2139666048	Королівство Ломбардія	true
advice_levels_advice_item_title_1247479159	Порядок підходу підкріплення	true
advice_levels_advice_item_title_1882907085	Сходи	true
advice_levels_advice_item_title_2139664975	Юти	true
advice_levels_advice_item_title_2139665375	Мирні жителі	true
advice_levels_advice_item_title_2139657977	Енциклопедія	true
advice_levels_advice_item_title_2139660274	Шикування	true
advice_levels_advice_item_title_2139665274	Едикти	true
advice_levels_advice_item_title_2139665674	Поповнення 3	true
advice_levels_advice_item_title_2139666074	Королівство Карла Великого	true
advice_levels_advice_item_title_1217512772	Торговельна угода	true
advice_levels_advice_item_title_2139660176	Розвідники	true
advice_levels_advice_item_title_2139666276	Склавини	true
advice_levels_advice_item_title_1085557272	Вгору по схилу	true
advice_levels_advice_item_title_2139657673	Дипломатичні переговори	true
advice_levels_advice_item_title_2139665270	Сім'я	true
advice_levels_advice_item_title_2139665873	Каледонці	true
advice_levels_advice_item_title_2139666073	Королівство Карла Великого	true
advice_levels_advice_item_title_2139666173	Авари	true
advice_levels_advice_item_title_1431102331	Бій з кіннотою	true
advice_levels_advice_item_title_2139664972	Гети	true
advice_levels_advice_item_title_1217586072	Податки за фракціями	true
advice_levels_advice_item_title_2139663379	Провінції та регіони	true
advice_levels_advice_item_title_2139664979	Дани	true
advice_levels_advice_item_title_2139665879	Ебдани	true
advice_levels_advice_item_title_2139665979	Повстання танухідів	true
advice_levels_advice_item_title_2139666179	Авари	true
advice_levels_advice_item_title_2139665378	Вільне шикування	true
advice_levels_advice_item_title_2139665978	Лахміди	true
advice_levels_advice_item_title_2139666278	Склавини	true
advice_levels_advice_item_title_1308478569	Удар кіннотою у фланг	true
advice_levels_advice_item_title_2139657866	Грабіж	true
advice_levels_advice_item_title_2139665365	Точки захоплення	true
advice_levels_advice_item_title_2139665865	Бургунди	true
advice_levels_advice_item_title_2139666265	Венеди	true
advice_levels_advice_item_title_1590729744	Зведення	true
advice_levels_advice_item_title_2139665964	Аксумське царство	true
advice_levels_advice_item_title_2139658364	Вміння військ	true
advice_levels_advice_item_title_2139665867	Пікти	true
advice_levels_advice_item_title_2139660266	Шикування	true
advice_levels_advice_item_title_2139665666	Поповнення 2	true
advice_levels_advice_item_title_2139665866	Орди	true
advice_levels_advice_item_title_2139666066	Королівство Ломбардія	true
advice_levels_advice_item_title_2139666166	Авари	true
advice_levels_advice_item_title_2139666161	Авари	true
advice_levels_advice_item_title_2139658563	Дружній вогонь	true
advice_levels_advice_item_title_2139660260	Шикування	true
advice_levels_advice_item_title_2139664960	Остготи	true
advice_levels_advice_item_title_1412070137	Досвід загонів	true
advice_levels_advice_item_title_2139657960	Управління фракцією	true
advice_levels_advice_item_title_2139664963	Вандали	true
advice_levels_advice_item_title_2139665763	Технології	true
advice_levels_advice_item_title_2139666263	Венеди	true
advice_levels_advice_item_title_1424352004	Кнопка рукопашного бою	true
advice_levels_advice_item_title_2139666262	Венеди	true
advice_levels_advice_item_title_1020531268	Вплив полководця	true
advice_levels_advice_item_title_2139665969	Хім'яритське царство	true
advice_levels_advice_item_title_2139666069	Королівство Ломбардія	true
advice_levels_advice_item_title_2139666269	Склавини	true
advice_levels_advice_item_title_1224585565	Втомлюваність кінноти	true
advice_levels_advice_item_title_1259146729	Нова залежна держава	true
advice_levels_advice_item_title_1629386802	Небойові втрати	true
advice_levels_advice_item_title_2139658369	Вивчення мапи	true
advice_levels_advice_item_title_2139658569	Фінанси	true
advice_levels_advice_item_title_2139657696	Сім'я і політика	true
advice_levels_advice_item_title_2139665795	Покращення	true
advice_levels_advice_item_title_2139666195	Королівство данів	true
advice_levels_advice_item_title_2139665994	Кордовський емірат	true
advice_levels_advice_item_title_2105808871	Бунт!	true
advice_levels_advice_item_title_2139658394	Стихійні лиха	true
advice_levels_advice_item_title_2139665697	Поповнення 6	true
advice_levels_advice_item_title_2139665997	Кордовський емірат	true
advice_levels_advice_item_title_2139666096	Королівство Карла Великого	true
advice_levels_advice_item_title_2139666296	Гараманти	true
advice_levels_advice_item_title_1857473489	Немає очок дії	true
advice_levels_advice_item_title_2139660191	Воїни	true
advice_levels_advice_item_title_2139665291	Заклик до зброї	true
advice_levels_advice_item_title_2139665390	Наслідки облоги	true
advice_levels_advice_item_title_2139665990	Кордовський емірат	true
advice_levels_advice_item_title_2139660199	Договір про ненапад	true
advice_levels_advice_item_title_2139665299	Тактика випаленої землі	true
advice_levels_advice_item_title_2139665599	Контроль і панування	true
advice_levels_advice_item_title_2139665999	Королівство Мерсія	true
advice_levels_advice_item_title_1747583890	Завдання	true
advice_levels_advice_item_title_2139665598	Наслідки облоги	true
advice_levels_advice_item_title_2139665898	Свеби	true
advice_levels_advice_item_title_2139665998	Королівство Мерсія	true
advice_levels_advice_item_title_2139657998	Інтерфейс	true
advice_levels_advice_item_title_1220977758	Скарбниця порожня!	true
advice_levels_advice_item_title_2139657687	Міні-мапа та списки	true
advice_levels_advice_item_title_2139660184	Жерці	true
advice_levels_advice_item_title_2139665384	Застосування метальників	true
advice_levels_advice_item_title_2139657684	Дипломатія всередині фракції	true
advice_levels_advice_item_title_2139666087	Королівство Карла Великого	true
advice_levels_advice_item_title_2139665286	Характери лідерів	true
advice_levels_advice_item_title_2139665786	Едикти	true
advice_levels_advice_item_title_2139666186	Авари	true
advice_levels_advice_item_title_2139665581	Обмін загонами	true
advice_levels_advice_item_title_2139665981	Кордовський емірат	true
advice_levels_advice_item_title_1500507282	Провінції	true
advice_levels_advice_item_title_2139665780	Об'єднання	true
advice_levels_advice_item_title_2139666280	Склавини	true
advice_levels_advice_item_title_2139665283	Шлюб	true
advice_levels_advice_item_title_2139665682	Поповнення 4	true
advice_levels_advice_item_title_2139666082	Королівство Карла Великого	true
advice_levels_advice_item_title_1912850156	Битва з кіннотою	true
advice_levels_advice_item_title_2139666189	Авари	true
advice_levels_advice_item_title_2139666289	Склавини	true
advice_levels_advice_item_title_2139665588	Орди	true
advice_levels_advice_item_title_2139665688	Поповнення 5	true
advice_levels_advice_item_title_1093841867	Під прикриттям	true
advice_levels_advice_item_title_1232708197	Зони контролю	true
advice_levels_advice_item_title_1217604599	Закладки камери	true
advice_levels_advice_item_title_1218788185	Занадто великі витрати!	true
advice_levels_advice_item_title_1833752382	Висадка на берег	true
advice_levels_advice_item_title_1499695591	Вихід з поселення	true
advice_levels_advice_item_title_1291133193	Оточення піхоти	true
advice_levels_advice_item_title_1198010380	Обрано чужий персонаж	true
advice_levels_advice_item_title_1213169590	Вікно огляду	true
advice_levels_advice_item_title_1749194297	Уникайте добірних військ	true
advice_levels_advice_item_title_2126291480	Напад на торговий шлях	true
advice_levels_advice_item_title_1310965009	Кілля	true
advice_levels_advice_item_title_1877282481	Швидкість гри	true
advice_levels_advice_item_title_1782364698	Набір військ	true
advice_levels_advice_item_title_1219328082	Кнопка допомоги	true
advice_levels_advice_item_title_1599262495	Відстрочка	true
advice_levels_advice_item_title_1900236590	Тривалі торгові угоди	true
advice_levels_advice_item_title_1129360188	Утримання і знищення військ	true
advice_levels_advice_item_title_-595875202	Готуйтеся до бою!	true
advice_levels_advice_item_title_-393224185	Взяти за горло!	true
advice_levels_advice_item_title_-878278296	Небоєві втрати	true
advice_levels_advice_item_title_-152525085	Відставання	true
advice_levels_advice_item_title_-865899355	Ресурси	true
advice_levels_advice_item_title_-237447599	Право проходу	true
advice_levels_advice_item_title_-339955577	Згуртування військ	true
advice_levels_advice_item_title_-509629283	Відомості про технологію	true
advice_levels_advice_item_title_-245999870	Особливості регіону	true
advice_levels_advice_item_title_-825618887	Напад на торговий шлях	true
advice_levels_advice_item_title_-537894077	Кнопка групових шикувань	true
advice_levels_advice_item_title_-729505557	Співвідношення сил	true
advice_levels_advice_item_title_-388492343	Недостатнє оподаткування	true
advice_levels_advice_item_title_-109318922	Вбивство ворожого полководця	true
advice_levels_advice_item_title_-722605174	Кнопка групи	true
advice_levels_advice_item_title_-600261031	Непомітні дії розвідника	true
advice_levels_advice_item_title_-426685576	Засадні загони	true
advice_levels_advice_item_title_-855205336	Пересування військ	true
advice_levels_advice_item_title_-474106108	Відомості про персонажа	true
advice_levels_advice_item_title_-795357910	Швидше придушіть повстання!	true
advice_levels_advice_item_title_-519238000	Порядок розгортання військ	true
advice_levels_advice_item_title_-757350914	Міни	true
advice_levels_advice_item_title_-512693646	Вигідна позиція	true
advice_levels_advice_item_title_-939651342	Облога	true
advice_levels_advice_item_title_-550746044	Об'єднання загонів	true
advice_levels_advice_item_title_-737235711	Обмін загонами	true
advice_levels_advice_item_title_-758254518	Переважаючі сили	true
advice_levels_advice_item_title_-788769149	Удар кіннотою у фланг	true
advice_levels_advice_item_title_-245662021	Вигнуті бойові порядки	true
advice_levels_advice_item_title_-594453008	Кнопка режиму перестрілки	true
advice_levels_advice_item_title_-325593809	Скарбниця порожня!	true
advice_levels_advice_item_title_-895189344	Полководці та бойовий дух	true
advice_levels_advice_item_title_-234487411	Обхід з флангу	true
advice_levels_advice_item_title_-981340853	Контратака	true
advice_levels_advice_item_title_-925500629	Вимога військової підтримки	true
advice_levels_advice_item_title_-854614115	Оборона на пагорбі	true
advice_levels_advice_item_title_-97375295	Видимість в морі	true
advice_levels_advice_item_title_606296587	Порт в блокаді	true
advice_levels_advice_item_title_700219983	Полювання на стрільців	true
advice_levels_advice_item_title_646906330	Компас	true
advice_levels_advice_item_title_579859038	Провокація противника	true
advice_levels_advice_item_title_428071084	Шикування «клин» і «ромб»	true
advice_levels_advice_item_title_464946411	Відомості про побудову	true
advice_levels_advice_item_title_143874018	Резерви	true
advice_levels_advice_item_title_327923206	Напад на торговий шлях	true
advice_levels_advice_item_title_390129783	Штурм пагорба	true
advice_levels_advice_item_title_659772888	Найм у поході	true
advice_levels_advice_item_title_298768787	Бій між списоносцями	true
advice_levels_advice_item_title_632989552	Туман війни	true
advice_levels_advice_item_title_952924146	Кнопка абордажу	true
advice_levels_advice_item_title_843806652	Розміщення	true
advice_levels_advice_item_title_856417993	Вікно огляду	true
advice_levels_advice_item_title_313094221	Кнопка зупинки	true
advice_levels_advice_item_title_111349601	Оборона на пагорбі	true
advice_levels_advice_item_title_969317109	Недостатньо коштів	true
advice_levels_advice_item_title_336059036	Платежі	true
advice_levels_advice_item_title_309592755	Захист переправ	true
advice_levels_advice_item_title_124410149	Підготовка ворога	true
advice_levels_advice_item_title_593395637	Кнопка швидкості руху	true
advice_levels_advice_item_title_942566659	Перехопити ініціативу	true
advice_levels_advice_item_title_637136615	Небезпека повстання!	true
advice_levels_advice_item_title_297255339	Фракції	true
advice_levels_advice_item_title_405775560	Втеча	true
advice_levels_advice_item_title_113649401	Підкріплення	true
advice_levels_advice_item_title_667337653	Відомості про провінцію	true
advice_levels_advice_item_title_463216958	Вимога розірвати союз	true
advice_levels_advice_item_title_132393743	Гірські перевали	true
advice_levels_advice_item_title_737354545	Кнопка стрільби по готовності	true
advice_levels_advice_item_title_932121968	Оборона при облозі	true
advice_levels_advice_item_title_528599210	Скарбниця і дата	true
advice_levels_advice_item_title_886642523	Розвиток доріг	true
advice_levels_advice_item_title_259529015	Похитнутий стрій	true
advice_levels_advice_item_title_942378261	Згуртувати ряди	true
advice_levels_advice_item_title_131718024	Відволікання противника	true
advice_levels_advice_item_title_588232477	Управління поселенням	true
advice_levels_advice_item_title_44290589	Невідповідна ціль для обстрілу	true
advice_levels_advice_item_title_-1243953931	Військовий союз	true
advice_levels_advice_item_title_-1076388291	Режим перестрілки	true
advice_levels_advice_item_title_-1442955838	Бойовий дух	true
advice_levels_advice_item_title_164466	Порт в блокаді	true
advice_levels_advice_item_title_-1901858416	Оголошення війни	true
advice_levels_advice_item_title_68074087	Поселення	true
advice_levels_advice_item_title_-1030015586	Кнопка режиму оборони	true
advice_levels_advice_item_title_-1341063580	Тактика легкої кінноти	true
advice_levels_advice_item_title_-2039862233	Підсумки битви	true
advice_levels_advice_item_title_-1002927119	Нальоти на торгові шляхи	true
advice_levels_advice_item_title_-1875830202	Перевага в стрільцях	true
advice_levels_advice_item_title_-2017583094	Технології	true
advice_levels_advice_item_title_-1755835367	Міні-мапа	true
advice_levels_advice_item_title_-1567524386	Витратні сили	true
advice_levels_advice_item_title_-1394403499	Нерозвинений порт	true
advice_levels_advice_item_title_-1528505088	Будівництво	true
advice_levels_advice_item_title_-1395907252	Нестача їжі	true
advice_levels_advice_item_title_-1961998855	Перший удар по легким військам	true
advice_levels_advice_item_title_-2014914668	Захист флангів кіннотою	true
advice_levels_advice_item_title_-1906180227	Кавалерія в обороні	true
advice_levels_advice_item_title_-1666667854	Відволікання противника	true
advice_levels_advice_item_title_-1594313916	Межі переміщення противника	true
advice_levels_advice_item_title_-1581561178	Зрада союзників	true
advice_levels_advice_item_title_-2023390722	Кілля	true
advice_levels_advice_item_title_-1805368716	Управління камерою	true
advice_levels_advice_item_title_-1999396619	Відомості про персонажа	true
advice_levels_advice_item_title_-2004663178	Слабкі місця противника	true
advice_levels_advice_item_title_-1282356525	Тактика легкої кінноти	true
advice_levels_advice_item_title_-1060140303	Удаване відступлення	true
advice_levels_advice_item_title_-1890476358	Атака переправ	true
advice_levels_advice_item_title_-1871866990	Вдоволення	true
advice_levels_advice_item_title_-1516645363	Оточення	true
advice_levels_advice_item_title_-1062679364	Зупинка	true
advice_levels_advice_item_title_-1808504559	Виробництво їжі	true
advice_levels_advice_item_title_-1701749777	Натиск кінноти	true
advice_levels_advice_item_title_-1969897884	Кіннота проти списоносців	true
advice_levels_advice_item_title_-1995657968	Війська	true
advice_levels_advice_item_title_17591341	Тактика кінноти	true
advice_levels_advice_item_title_-1899489232	Битва на смерть	true
advice_levels_advice_item_title_-1467085177	Вивчення позицій ворога	true
advice_levels_advice_item_title_-1381776408	Управління камерою	true
advice_levels_advice_item_title_68241043	Засідка	true
advice_levels_advice_item_title_-1246754910	Стрілецька кіннота	true
advice_levels_advice_item_title_-1241185070	Відомості про загін	true
advice_levels_advice_item_title_-1961571108	Торговельна угода	true
advice_levels_advice_item_title_-1744509802	Захист від кінноти	true
advice_levels_advice_item_title_-1009457400	Удар кіннотою у фланг	true
advice_levels_advice_item_title_-2134517828	Провокація ворога	true
advice_levels_advice_item_title_97123942	Таймер битви	true
