key	text	tooltip
#Loc;1;text/db/building_chains.loc		
building_chains_encyclopedia_description_att_bch_nomad_noble	Урядові споруди об'єднують орду підвищуючи згуртованість її військ і забезпечуючи додатковий дохід від культури.	true
building_chains_encyclopedia_description_att_bch_eastern_sassanid_port_minor	Placeholder description	true
building_chains_chain_tooltip_att_bch_religion_other	Релігія	true
building_chains_chain_tooltip_att_bch_roman_west_port_minor	Порт	true
building_chains_encyclopedia_name_att_bch_all_industry_major	Виробництво: місто	true
building_chains_encyclopedia_name_att_bch_all_industry_minor	Виробництво: містечко	true
building_chains_encyclopedia_description_mk_bch_nommigs_settlement	Ланцюжок поселень слугує кочовикам осердям табору забезпечуючи багатство для прожитку й сприяючи зростанню орди.	true
building_chains_chain_tooltip_att_bch_slav_farming	Садиба	true
building_chains_chain_tooltip_att_bch_religion_zoroastrian_major_fire_faction	Релігія	true
building_chains_chain_tooltip_bel_bch_all_agriculture	Землеробство	true
building_chains_chain_tooltip_mk_bch_arakingdoms_water_major	Санітарія	true
building_chains_chain_tooltip_mk_bch_arakingdoms_water_minor	Санітарія	true
building_chains_encyclopedia_name_bel_bch_all_industry_major	Виробництво: місто	true
building_chains_encyclopedia_name_bel_bch_all_industry_minor	Виробництво: містечко	true
building_chains_encyclopedia_name_bel_bch_roman_city_major	Місто	true
building_chains_encyclopedia_name_bel_bch_roman_city_minor	Містечко	true
building_chains_chain_tooltip_mk_bch_ortkingdoms_water_major	Санітарія	true
building_chains_chain_tooltip_mk_bch_ortkingdoms_water_minor	Санітарія	true
building_chains_chain_tooltip_bel_bch_religion_other	Релігія	true
building_chains_encyclopedia_name_att_bch_barbmigs_community	Переселенці: суспільство	true
building_chains_chain_tooltip_att_slav_bch_zadruga	Задруга	true
building_chains_encyclopedia_name_mk_bch_nommigs_settlement	Поселення кочівників	true
building_chains_encyclopedia_name_att_bch_eastern_sassanid_military_infantry	Місто: найм піхоти	true
building_chains_encyclopedia_name_att_bch_eastmigs_community	Переселенці: суспільство	true
building_chains_chain_tooltip_mk_bch_itakingdoms_water_major	Санітарія	true
building_chains_chain_tooltip_mk_bch_itakingdoms_water_minor	Санітарія	true
building_chains_encyclopedia_description_att_bch_eastmigs_industry	Ланцюжок ремесел містить споруди які приносять дохід від виробництва і дають інші фінансові переваги.	true
building_chains_chain_tooltip_att_bch_roman_east_port_minor	Порт	true
building_chains_encyclopedia_name_cha_bch_monastery	Монастир	true
building_chains_encyclopedia_name_mk_bch_religion_bogomilism_major	Релігія	true
building_chains_encyclopedia_name_mk_bch_religion_bogomilism_minor	Релігія: місто	true
building_chains_chain_tooltip_mk_bch_mookingdoms_town	Місто	true
building_chains_encyclopedia_description_cha_bch_mill	Млини збільшують дохід від сільського господарства і комерції в своїй провінції.	true
building_chains_encyclopedia_description_cha_bch_gold	Ланцюжки ресурсів дозволяють використовувати цінні товари доступні в регіоні	true
building_chains_chain_tooltip_bel_bch_camp_sanitation	Санітарія	true
building_chains_encyclopedia_description_cha_bch_salt	Ланцюжки ресурсів дозволяють використовувати цінні товари доступні в регіоні	true
building_chains_encyclopedia_description_cha_bch_barracks_mus	Казарми можна зводити в будь-яких містах або містечках. Вони дозволяють наймати більшість видів піхоти кінноти і стрільців.	true
building_chains_encyclopedia_description_bel_bch_religion_catholic_legendary	Будівлі релігійного ланцюжка посилюють вплив вашої віри у володіннях фракції та чужих землях а також можуть підвищувати рівень санітарії в поселеннях. Склад цього ланцюжка різниться залежно від державної релігії фракції	true
building_chains_encyclopedia_name_bel_bch_religion_arian_legendary	Престол пентархії	true
building_chains_chain_tooltip_mk_bch_cenkingdoms_town	Місто	true
building_chains_chain_tooltip_mk_bch_religion_jewish_community_major	Єврейська громада	true
building_chains_chain_tooltip_mk_bch_religion_jewish_community_minor	Єврейська громада: місто	true
building_chains_encyclopedia_name_att_bch_eastmigs_industry	Переселенці: ремесла	true
building_chains_encyclopedia_name_cha_bch_race_track	Іподром	true
building_chains_encyclopedia_name_mk_bch_ortkingdoms_civic_major_cil	Громадський центр	true
building_chains_encyclopedia_description_att_bch_roman_east_military	Будівлі для найму військ можна зводити в будь-яких містах або містечках. Вони дозволяють наймати більшість видів піхоти кінноти і стрільців.	true
building_chains_encyclopedia_description_cha_bch_monastery	Будівлі релігійного ланцюжка посилюють вплив вашої віри у володіннях фракції та на чужих землях.	true
building_chains_encyclopedia_description_att_bch_roman_west_military	Будівлі для найму військ можна зводити в будь-яких містах або містечках. Вони дозволяють наймати більшість видів піхоти кінноти та стрільців.	true
building_chains_chain_tooltip_mk_bch_nomkingdoms_town	Місто	true
building_chains_encyclopedia_description_cha_bch_mine	Рудники приносять дохід від промисловості; їх можна будувати тільки в малих поселеннях.	true
building_chains_encyclopedia_description_cha_bch_wine	Ланцюжки ресурсів дозволяють використовувати цінні товари доступні в регіоні	true
building_chains_chain_tooltip_cha_bch_council	Зал ради	true
building_chains_encyclopedia_description_cha_bch_horse_shows	Виставки коней покращують громадський порядок дають переваги кінноті і підвищують імперію вашої фракції.	true
building_chains_chain_tooltip_att_bch_celtic_garrison	Нальоти	true
building_chains_encyclopedia_description_cha_bch_iron	Ланцюжки ресурсів дозволяють використовувати цінні товари доступні в регіоні	true
building_chains_encyclopedia_description_cha_bch_wood	Ланцюжки ресурсів дозволяють використовувати цінні товари доступні в регіоні	true
building_chains_encyclopedia_name_bel_bch_camp_food	Їжа	true
building_chains_encyclopedia_description_bel_bch_camp_camp	Будівлі ланцюжка табору забезпечують зростання населення і найм військ а також приносять необхідний для цього дохід.	true
building_chains_encyclopedia_name_mk_bch_religion_shia_major	Релігія	true
building_chains_encyclopedia_name_mk_bch_religion_shia_minor	Релігія: місто	true
building_chains_encyclopedia_name_att_bch_resources_orchards_dummy	Сади	true
building_chains_chain_tooltip_cha_bch_port	Порт	true
building_chains_chain_tooltip_mk_bch_nommigs_military	Найм військ	true
building_chains_encyclopedia_name_cha_bch_scriptorium	Скрипторій	true
building_chains_chain_tooltip_att_bch_all_military_upgrades	Військові поліпшення	true
building_chains_chain_tooltip_bel_bch_all_military_upgrades	Військові поліпшення	true
building_chains_encyclopedia_description_bel_bch_religion_orthodox_legendary	Будівлі релігійного ланцюжка посилюють вплив вашої віри у володіннях фракції і чужих землях а також можуть підвищувати рівень санітарії в поселеннях. Склад цього ланцюжка різниться залежно від державної релігії фракції	true
building_chains_encyclopedia_description_mk_bch_weskingdoms_castle	Ланцюжок міста дозволяє зміцнювати стіни столиці а також підвищувати стабільність і зростання провінції.	true
building_chains_encyclopedia_name_att_slav_bch_wonder	Диво	true
building_chains_encyclopedia_description_cha_bch_lead	Ланцюжки ресурсів дозволяють використовувати цінні товари доступні в регіоні	true
building_chains_chain_tooltip_mk_bch_arakingdoms_civic_major	Громадський центр	true
building_chains_chain_tooltip_mk_bch_arakingdoms_civic_minor	Центр міста	true
building_chains_chain_tooltip_mk_bch_crukingdoms_civic_major	Громадський центр	true
building_chains_chain_tooltip_mk_bch_crukingdoms_civic_minor	Центр міста	true
building_chains_chain_tooltip_mk_bch_ortkingdoms_civic_major	Громадський центр	true
building_chains_chain_tooltip_mk_bch_ortkingdoms_civic_minor	Центр міста	true
building_chains_encyclopedia_description_bel_bch_camp_food	Залежно від обраної гілки будівництва харчового ланцюжка вони можуть або виробляти їжу	true
building_chains_encyclopedia_name_bel_bch_camp_camp	Табір	true
building_chains_chain_tooltip_mk_bch_arakingdoms_town	Місто	true
building_chains_chain_tooltip_mk_bch_itakingdoms_town	Місто	true
building_chains_chain_tooltip_mk_bch_slakingdoms_town	Місто	true
building_chains_chain_tooltip_mk_bch_resources_sugar	Виробництво цукру	true
building_chains_encyclopedia_name_mk_bch_weskingdoms_castle	Поселення	true
building_chains_encyclopedia_name_cha_bch_wine_market	Винний ринок	true
building_chains_encyclopedia_description_att_bch_eastmigs_military	Військові споруди дозволяють наймати нові види загонів і розширюють можливості найму військ для мігруючих кочівників.	true
building_chains_chain_tooltip_mk_bch_itakingdoms_civic_major	Громадський центр	true
building_chains_chain_tooltip_mk_bch_itakingdoms_civic_minor	Центр міста	true
building_chains_encyclopedia_description_att_bch_eos_pleasure_major	Споруди ланцюжка задоволень приносять помітний дохід і підвищують рівень громадського порядку але послаблюють вплив державної релігії і знижують рівень санітарії в провінціях.	true
building_chains_chain_tooltip_mk_bch_cenmigs_barracks	Найм військ	true
building_chains_chain_tooltip_cha_bch_hospice	Притулок	true
building_chains_chain_tooltip_cha_bch_fighter	Обитель бійців	true
building_chains_encyclopedia_name_mk_bch_crukingdoms_order	Найм хрестоносців	true
building_chains_encyclopedia_description_mk_bch_slakingdoms_castle	Ланцюжок міста дозволяє зміцнювати стіни столиці а також підвищувати стабільність і зростання провінції.	true
building_chains_encyclopedia_name_cha_bch_food_market	Продуктовий ринок	true
building_chains_chain_tooltip_mk_bch_moomigs_barracks	Найм військ	true
building_chains_encyclopedia_description_mk_bch_religion_sunni_major	Будівлі релігійного ланцюжка посилюють вплив вашої віри у володіннях фракції та чужих землях а також можуть підвищувати рівень санітарії в поселеннях. Склад цього ланцюжка різниться залежно від державної релігії фракції	true
building_chains_encyclopedia_description_mk_bch_religion_sunni_minor	Будівлі релігійного ланцюжка посилюють вплив вашої віри у володіннях фракції та на чужих землях а також можуть підвищувати рівень санітарії в поселеннях. Склад цього ланцюжка різниться залежно від державної релігії фракції	true
building_chains_encyclopedia_name_att_bch_eastmigs_military	Кочова армія	true
building_chains_chain_tooltip_cha_bch_city	Місто	true
building_chains_chain_tooltip_mk_bch_ibekingdoms_town	Місто	true
building_chains_encyclopedia_name_bel_bch_camp_market	Ринок	true
building_chains_chain_tooltip_mk_bch_resources_silver	Виробництво срібла	true
building_chains_encyclopedia_name_mk_bch_slakingdoms_castle	Поселення	true
building_chains_chain_tooltip_att_bch_religion_zoroastrian_major_fire	Релігія	true
building_chains_encyclopedia_name_att_bch_barbmigs_settlement	Переселенці: поселення	true
building_chains_encyclopedia_description_cha_bch_cloth_market	Ланцюжок ринку тканин приносить дохід від комерції.	true
building_chains_encyclopedia_name_att_bch_barbmigs_industry	Переселенці: ремесла	true
building_chains_encyclopedia_description_mk_bch_nomkingdoms_castle	Ланцюжок міста дозволяє зміцнювати стіни столиці а також підвищувати стабільність і зростання провінції.	true
building_chains_encyclopedia_description_mk_bch_religion_zoroastrian_major	Будівлі релігійного ланцюжка посилюють вплив вашої віри у володіннях фракції та на чужих землях а також можуть підвищувати рівень санітарії в поселеннях. Склад цього ланцюжка різниться залежно від державної релігії фракції	true
building_chains_encyclopedia_description_mk_bch_religion_zoroastrian_minor	Будівлі релігійного ланцюжка посилюють вплив вашої віри у володіннях фракції та чужих землях а також можуть підвищувати рівень санітарії в поселеннях. Склад цього ланцюжка різниться залежно від державної релігії фракції	true
building_chains_chain_tooltip_att_abandoned	Руїни	true
building_chains_encyclopedia_name_cha_bch_bismaristan	Бімарістан	true
building_chains_chain_tooltip_att_bch_all_agriculture	Землеробство	true
building_chains_chain_tooltip_mk_bch_religion_jewish_synagogue_major	Релігія	true
building_chains_chain_tooltip_mk_bch_religion_jewish_synagogue_minor	Релігія	true
building_chains_chain_tooltip_mk_bch_easkingdoms_water_major	Санітарія	true
building_chains_chain_tooltip_mk_bch_easkingdoms_water_minor	Санітарія	true
building_chains_encyclopedia_name_att_bch_religion_zoroastrian_major_burial	Поховання: місто	true
building_chains_encyclopedia_description_att_bch_all_industry_major	Виробничі споруди можна зводити в будь-яких містах або містечках. Вони можуть приносити додатковий дохід або забезпечувати війська покращеним спорядженням.	true
building_chains_encyclopedia_description_att_bch_all_industry_minor	Виробничі споруди можна зводити в будь-яких містах або містечках. Вони можуть приносити додатковий дохід або забезпечувати війська покращеним спорядженням.	true
building_chains_encyclopedia_name_mk_bch_mookingdoms_castle	Поселення	true
building_chains_encyclopedia_description_mk_bch_ortkingdoms_castle	Ланцюжок міста дозволяє зміцнювати стіни столиці а також підвищувати стабільність і зростання провінції.	true
building_chains_encyclopedia_description_att_slav_bch_zadruga	Задруга - це місце де збирається плем'я. Вона підвищує громадський порядок.	true
building_chains_chain_tooltip_mk_bch_ibekingdoms_water_major	Санітарія	true
building_chains_chain_tooltip_mk_bch_ibekingdoms_water_minor	Санітарія	true
building_chains_encyclopedia_description_att_bch_barbmigs_industry	Ланцюжок ремесел містить споруди орди які приносять дохід від виробництва і дають інші фінансові переваги.	true
building_chains_encyclopedia_name_mk_bch_nomkingdoms_castle	Поселення	true
building_chains_encyclopedia_description_bel_bch_all_industry_major	Виробничі споруди можна зводити в будь-яких містах або містечках. Вони можуть приносити додатковий дохід або забезпечувати війська поліпшеним спорядженням.	true
building_chains_encyclopedia_description_bel_bch_all_industry_minor	Виробничі споруди можна зводити в будь-яких містах або містечках. Вони можуть приносити додатковий дохід або забезпечувати війська поліпшеним спорядженням.	true
building_chains_encyclopedia_name_mk_bch_religion_zoroastrian_major	Релігія	true
building_chains_encyclopedia_name_mk_bch_religion_zoroastrian_minor	Релігія: місто	true
building_chains_chain_tooltip_cha_bch_madrasa	Медресе	true
building_chains_encyclopedia_name_mk_bch_nommigs_community	Громадські землі	true
building_chains_encyclopedia_description_att_bch_eastern_sassanid_military_infantry	Піхотні споруди доступні тільки в столицях провінцій. Вони дозволяють наймати лучників і елітних піхотинців.	true
building_chains_encyclopedia_description_att_bch_eastern_sassanid_city_major	Placeholder description	true
building_chains_encyclopedia_description_att_bch_barbmigs_community	Ці громадські споруди можуть приносити кочівникам дохід від торгівлі або сприяти виробництву їжі та зростанню населення.	true
building_chains_encyclopedia_description_mk_bch_mookingdoms_castle	Ланцюжок міста дозволяє зміцнювати стіни столиці а також підвищувати стабільність і зростання провінції.	true
building_chains_encyclopedia_name_mk_bch_ortkingdoms_castle	Поселення	true
building_chains_chain_tooltip_att_bch_roman_west_city_major	Місто	true
building_chains_chain_tooltip_att_bch_eos_marib_dam	Марібська гребля	true
building_chains_encyclopedia_description_att_bch_religion_zoroastrian_major_burial	Будівлі релігійного ланцюжка посилюють вплив вашої віри у володіннях фракції та на чужих землях а також можуть підвищувати рівень санітарії в поселеннях. Склад цього ланцюжка різниться залежно від державної релігії фракції	true
building_chains_chain_tooltip_mk_bch_nomkingdoms_baba	Кам'яні баби	true
building_chains_encyclopedia_description_att_bch_slav_farming	Варварські поля можна розташовувати в будь-яких містах або містечках. Вони виробляють їжу і приносять дохід від сільського господарства а також дозволяють наймати основні види військ.	true
building_chains_chain_tooltip_mk_bch_slakingdoms_civic_major	Громадський центр	true
building_chains_chain_tooltip_mk_bch_slakingdoms_civic_minor	Центр міста	true
building_chains_encyclopedia_description_att_bch_religion_catholic_legendary	Будівлі релігійного ланцюжка посилюють вплив вашої віри у володіннях фракції та на чужих землях а також можуть підвищувати рівень санітарії в поселеннях. Склад цього ланцюжка різниться залежно від державної релігії фракції	true
building_chains_encyclopedia_description_att_slav_bch_religion_major	Будівлі релігійного ланцюжка посилюють вплив вашої віри у володіннях фракції та на чужих землях а також можуть підвищувати рівень санітарії в поселеннях. Склад цього ланцюжка різниться залежно від державної релігії фракції	true
building_chains_encyclopedia_description_att_slav_bch_religion_minor	Будівлі релігійного ланцюжка посилюють вплив вашої віри у володіннях фракції та на чужих землях а також можуть підвищувати рівень санітарії в поселеннях. Склад цього ланцюжка різниться залежно від державної релігії фракції	true
building_chains_encyclopedia_description_att_bch_eastmigs_community	Ці громадські споруди можуть приносити кочівникам дохід від торгівлі або сприяти виробництву їжі та зростанню населення.	true
building_chains_encyclopedia_name_cha_bch_craftsmen	Ремісники	true
building_chains_chain_tooltip_cha_bch_mine	Рудник	true
building_chains_chain_tooltip_cha_bch_wine	Виробництво вина	true
building_chains_encyclopedia_name_mk_bch_ortkingdoms_military_garrison_serbia	Гарнізон	true
building_chains_chain_tooltip_mk_bch_mookingdoms_bedouin_camp	Поселення племені	true
building_chains_chain_tooltip_mk_bch_cenkingdoms_water_major	Санітарія	true
building_chains_chain_tooltip_mk_bch_cenkingdoms_water_minor	Санітарія	true
building_chains_chain_tooltip_mk_bch_weskingdoms_water_major	Санітарія	true
building_chains_chain_tooltip_mk_bch_weskingdoms_water_minor	Санітарія	true
building_chains_encyclopedia_name_mk_bch_itakingdoms_castle	Поселення	true
building_chains_chain_tooltip_cha_bch_iron	Виробництво заліза	true
building_chains_chain_tooltip_cha_bch_wood	Виробництво дерева	true
building_chains_encyclopedia_name_mk_bch_ibekingdoms_castle	Поселення	true
building_chains_chain_tooltip_mk_bch_afrkingdoms_water_major	Санітарія	true
building_chains_chain_tooltip_mk_bch_afrkingdoms_water_minor	Санітарія	true
building_chains_encyclopedia_description_cha_bch_race_track	Іподроми покращують громадський порядок дають переваги кінноті і підвищують імперію вашої фракції.	true
building_chains_chain_tooltip_cha_bch_salt	Виробництво солі	true
building_chains_chain_tooltip_cha_bch_barracks_mus	Казарми	true
building_chains_chain_tooltip_cha_bch_mill	Млин	true
building_chains_chain_tooltip_att_bch_barbarian_water_major	Санітарія: місто	true
building_chains_chain_tooltip_att_bch_barbarian_water_minor	Санітарія: містечко	true
building_chains_encyclopedia_description_mk_bch_ortkingdoms_civic_major_cil	Ланцюжок міського центру містить ринки палаци	true
building_chains_chain_tooltip_cha_bch_gold	Виробництво золота	true
building_chains_encyclopedia_description_cha_bch_craftsmen	Ремісничий ланцюжок приносить дохід від промисловості; його споруди можуть бути зведені тільки в столиці провінції.	true
building_chains_encyclopedia_name_mk_bch_cenmigs_main	Табір	true
building_chains_chain_tooltip_mk_bch_nomkingdoms_civic_major	Громадський центр	true
building_chains_chain_tooltip_mk_bch_nomkingdoms_civic_minor	Центр міста	true
building_chains_chain_tooltip_mk_bch_mookingdoms_civic_major	Громадський центр	true
building_chains_chain_tooltip_mk_bch_mookingdoms_civic_minor	Центр міста	true
building_chains_encyclopedia_description_mk_bch_ibekingdoms_castle	Ланцюжок міста дозволяє зміцнювати стіни столиці а також підвищувати стабільність і зростання провінції.	true
building_chains_chain_tooltip_att_bch_roman_east_city_major	Місто	true
building_chains_encyclopedia_description_mk_bch_itakingdoms_castle	Ланцюжок міста дозволяє зміцнювати стіни столиці а також підвищувати стабільність і зростання провінції.	true
building_chains_encyclopedia_name_mk_bch_moomigs_main	Табір	true
building_chains_encyclopedia_description_att_bch_religion_orthodox_legendary	Будівлі релігійного ланцюжка посилюють вплив вашої віри у володіннях фракції та на чужих землях а також можуть підвищувати рівень санітарії в поселеннях. Склад цього ланцюжка різниться залежно від державної релігії фракції	true
building_chains_encyclopedia_name_att_bch_barbmigs_military	Переселенці: найм військ	true
building_chains_encyclopedia_description_mk_bch_religion_shia_major	Будівлі релігійного ланцюжка посилюють вплив вашої віри у володіннях фракції та на чужих землях а також можуть підвищувати рівень санітарії в поселеннях. Склад цього ланцюжка різниться залежно від державної релігії фракції	true
building_chains_encyclopedia_description_mk_bch_religion_shia_minor	Будівлі релігійного ланцюжка посилюють вплив вашої віри у володіннях фракції та чужих землях а також можуть підвищувати рівень санітарії в поселеннях. Склад цього ланцюжка різниться залежно від державної релігії фракції	true
building_chains_chain_tooltip_mk_bch_easkingdoms_town	Місто	true
building_chains_chain_tooltip_mk_bch_weskingdoms_town	Місто	true
building_chains_encyclopedia_description_mk_bch_religion_ibadi_major	Будівлі релігійного ланцюжка посилюють вплив вашої віри у володіннях фракції та на чужих землях а також можуть підвищувати рівень санітарії в поселеннях. Склад цього ланцюжка різниться залежно від державної релігії фракції	true
building_chains_encyclopedia_description_mk_bch_religion_ibadi_minor	Будівлі релігійного ланцюжка посилюють вплив вашої віри у володіннях фракції та на чужих землях а також можуть підвищувати рівень санітарії в поселеннях. Склад цього ланцюжка різниться залежно від державної релігії фракції	true
building_chains_chain_tooltip_mk_bch_easkingdoms_civic_major	Громадський центр	true
building_chains_chain_tooltip_mk_bch_easkingdoms_civic_minor	Центр міста	true
building_chains_chain_tooltip_att_bch_roman_east_civic_major	Управління	true
building_chains_chain_tooltip_att_bch_roman_west_civic_major	Управління	true
building_chains_chain_tooltip_att_bch_roman_west_civic_minor	Гарнізон	true
building_chains_encyclopedia_name_mk_bch_easkingdoms_castle	Поселення	true
building_chains_encyclopedia_description_att_bch_barbarian_farming	Варварські поля можна розташовувати в будь-яких містах або містечках. Вони виробляють їжу і приносять дохід від сільського господарства а також дозволяють наймати основні види військ.	true
building_chains_chain_tooltip_mk_bch_afrkingdoms_town	Місто	true
building_chains_encyclopedia_description_att_bch_barbmigs_military	Військові споруди дозволяють наймати нові види загонів і розширюють можливості найму військ для переселяючої орди.	true
building_chains_chain_tooltip_mk_bch_ibekingdoms_civic_major	Громадський центр	true
building_chains_chain_tooltip_mk_bch_ibekingdoms_civic_minor	Центр міста	true
building_chains_encyclopedia_description_cha_bch_port	Для ланцюжка порту передбачено три варіанти розвитку. Рибальський варіант приносить додаткову їжу торговий - дохід	true
building_chains_chain_tooltip_mk_bch_arakingdoms_bedouin_camp	Поселення племені	true
building_chains_chain_tooltip_att_bch_roman_east_city_minor_generic	Містечко	true
building_chains_encyclopedia_description_mk_bch_easkingdoms_castle	Ланцюжок міста дозволяє зміцнювати стіни столиці а також підвищувати стабільність і зростання провінції.	true
building_chains_encyclopedia_name_att_bch_barbarian_farming	Поля	true
building_chains_chain_tooltip_att_bch_resources_marble_dummy	Виробництво каменю	true
building_chains_chain_tooltip_cha_bch_lead	Виробництво свинцю	true
building_chains_chain_tooltip_cha_bch_library	Бібліотека	true
building_chains_encyclopedia_name_att_bch_eos_pleasure_major	Будинки розваг	true
building_chains_chain_tooltip_mk_bch_slakingdoms_water_major	Санітарія	true
building_chains_chain_tooltip_mk_bch_slakingdoms_water_minor	Санітарія	true
building_chains_encyclopedia_name_cha_bch_hall_elders	Зал старійшин	true
building_chains_encyclopedia_description_cha_bch_city	Ланцюжок міста дозволяє зміцнювати стіни столиці а також підвищувати стабільність і зростання провінції.	true
building_chains_chain_tooltip_mk_bch_cenkingdoms_civic_major	Громадський центр	true
building_chains_chain_tooltip_mk_bch_cenkingdoms_civic_minor	Центр міста	true
building_chains_chain_tooltip_att_bch_religion_tengri_major	Релігія	true
building_chains_chain_tooltip_att_bch_religion_tengri_minor	Релігія	true
building_chains_encyclopedia_name_att_bch_religion_arian_legendary	Престол пентархії	true
building_chains_chain_tooltip_att_bch_all_city_major	Місто	true
building_chains_chain_tooltip_att_bch_all_city_minor	Містечко	true
building_chains_chain_tooltip_mk_bch_weskingdoms_civic_major	Громадський центр	true
building_chains_chain_tooltip_mk_bch_weskingdoms_civic_minor	Центр міста	true
building_chains_encyclopedia_description_cha_bch_mead_hall	Медові зали можна зводити в будь-яких містах або містечках. Вони дозволяють наймати більшість видів піхоти кінноти і стрільців.	true
building_chains_chain_tooltip_att_bch_all_livestock	Домашня худоба	true
building_chains_encyclopedia_name_mk_bch_arakingdoms_castle	Поселення	true
building_chains_encyclopedia_description_mk_bch_cenkingdoms_castle	Ланцюжок міста дозволяє зміцнювати стіни столиці а також підвищувати стабільність і зростання провінції.	true
building_chains_encyclopedia_description_mk_bch_crukingdoms_castle	Ланцюжок міста дозволяє зміцнювати стіни столиці а також підвищувати стабільність і зростання провінції.	true
building_chains_chain_tooltip_cha_bch_cloth_market	Ринок тканин	true
building_chains_encyclopedia_name_mk_bch_afrkingdoms_castle	Поселення	true
building_chains_chain_tooltip_mk_bch_religion_eastern_orthodox_major	Релігія	true
building_chains_chain_tooltip_mk_bch_religion_eastern_orthodox_minor	Релігія	true
building_chains_chain_tooltip_mk_bch_afrkingdoms_civic_major	Громадський центр	true
building_chains_chain_tooltip_mk_bch_afrkingdoms_civic_minor	Центр міста	true
building_chains_chain_tooltip_att_bch_barbarian_civic_major	Громадські землі	true
building_chains_chain_tooltip_att_bch_barbarian_civic_minor	Царський двір (містечко)	true
building_chains_encyclopedia_name_att_bch_barbmigs_leadership	Переселенці: влада	true
building_chains_encyclopedia_name_att_bch_eastmigs_leadership	Переселенці: влада	true
building_chains_chain_tooltip_mk_bch_crukingdoms_town	Місто	true
building_chains_chain_tooltip_mk_bch_mookingdoms_water_major	Санітарія	true
building_chains_chain_tooltip_mk_bch_mookingdoms_water_minor	Санітарія	true
building_chains_chain_tooltip_mk_bch_nomkingdoms_water_major	Санітарія	true
building_chains_chain_tooltip_mk_bch_nomkingdoms_water_minor	Санітарія	true
building_chains_encyclopedia_name_cha_bch_mead_hall	Медовий зал	true
building_chains_chain_tooltip_att_bch_religion_celtic_major	Релігія	true
building_chains_chain_tooltip_att_bch_religion_celtic_minor	Релігія	true
building_chains_encyclopedia_description_att_bch_eastern_sassanid_city_minor_generic	Placeholder description	true
building_chains_chain_tooltip_att_bch_roman_west_city_minor_generic	Містечко	true
building_chains_encyclopedia_name_mk_bch_crukingdoms_castle	Поселення	true
building_chains_encyclopedia_description_mk_bch_afrkingdoms_castle	Ланцюжок міста дозволяє зміцнювати стіни столиці а також підвищувати стабільність і зростання провінції.	true
building_chains_encyclopedia_description_mk_bch_arakingdoms_castle	Ланцюжок міста дозволяє зміцнювати стіни столиці а також підвищувати стабільність і зростання провінції.	true
building_chains_encyclopedia_name_mk_bch_cenkingdoms_castle	Поселення	true
building_chains_chain_tooltip_mk_bch_ortkingdoms_town	Місто	true
building_chains_chain_tooltip_mk_bch_easkingdoms_agriculture	Землеробство	true
building_chains_chain_tooltip_bel_bch_camp_officers	Командири	true
building_chains_encyclopedia_description_mk_bch_nomkingdoms_military_armory	Ланцюжок військових поліпшень містить споруди що надають більш якісне спорядження для військ і дозволяють будувати облогові знаряддя.	true
building_chains_encyclopedia_description_mk_bch_mookingdoms_military_armory	Ланцюжок військових поліпшень містить споруди що надають більш якісне спорядження для військ і дозволяють будувати облогові знаряддя.	true
building_chains_chain_tooltip_att_bch_religion_orthodox_major	Релігія	true
building_chains_chain_tooltip_att_bch_religion_orthodox_minor	Релігія	true
building_chains_encyclopedia_description_att_bch_barbarian_industry	Ремісничі споруди варварів можна зводити в будь-яких містах або містечках. Вони можуть приносити додатковий дохід від виробництва або забезпечувати війська поліпшеним спорядженням.	true
building_chains_encyclopedia_description_cha_bch_wine_market	Ланцюжок винного ринку приносить дохід від комерції.	true
building_chains_chain_tooltip_mk_bch_moomigs_priest	Священник	true
building_chains_encyclopedia_description_cha_bch_scriptorium	Ланцюжок скрипторію приносить дохід від культури і підвищує імперії вашої фракції.	true
building_chains_encyclopedia_description_att_bch_eos_religion_semitic_major_faction	Будівлі релігійного ланцюжка посилюють вплив вашої віри у володіннях фракції і чужих землях а також можуть підвищувати рівень санітарії в поселеннях. Склад цього ланцюжка різниться залежно від державної релігії фракції	true
building_chains_encyclopedia_description_att_bch_eos_religion_semitic_minor_faction	Будівлі релігійного ланцюжка посилюють вплив вашої віри у володіннях фракції та на чужих землях а також можуть підвищувати рівень санітарії в поселеннях. Склад цього ланцюжка різниться залежно від державної релігії фракції	true
building_chains_encyclopedia_name_att_bch_religion_zoroastrian_minor_faction	Релігія: містечко	true
building_chains_encyclopedia_description_att_slav_bch_wonder	Будівлі ланцюжка чудес приносять додатковий дохід від податків і збільшують максимальну чисельність військ. Технології військової гілки відкривають доступ до нових здібностей загонів а культурна гілка знижує вартість перебудови будівель	true
building_chains_chain_tooltip_mk_bch_ibekingdoms_agriculture	Землеробство	true
building_chains_encyclopedia_description_mk_bch_slakingdoms_military_armory	Ланцюжок військових поліпшень містить споруди що надають більш якісне спорядження для військ і дозволяють будувати облогові знаряддя.	true
building_chains_encyclopedia_name_bel_bch_religion_orthodox_legendary	Престол пентархії	true
building_chains_encyclopedia_description_att_bch_eastern_sassanid_civic_major	Ланцюжок міського центру містить ринки палаци	true
building_chains_encyclopedia_description_att_bch_eastern_sassanid_civic_minor	Ланцюжок центру містечка містить споруди що покращують громадський порядок або збільшують дохід від комерції та торгівлі.	true
building_chains_encyclopedia_description_bel_bch_camp_market	Споруди ринкового ланцюжка приносять дохід вашій армії.	true
building_chains_chain_tooltip_mk_bch_weskingdoms_agriculture	Землеробство	true
building_chains_encyclopedia_description_att_bch_nomad_city	Ланцюжок поселення містить основні споруди табору кочівників що забезпечують мінімальний добробут і зростання орди.	true
building_chains_encyclopedia_description_att_bch_eastern_sassanid_military_cavalry	Ланцюжок азадана доступний тільки в столицях провінцій. Будівлі що входять до нього	true
building_chains_chain_tooltip_mk_bch_cenkingdoms_agriculture	Землеробство	true
building_chains_encyclopedia_description_cha_bch_goldsmiths	Ланцюжок золотокузнеца приносить дохід від промисловості. Його будівлі можна зводити тільки в столицях провінцій.	true
building_chains_chain_tooltip_att_bch_resources_iron_dummy	Виробництво заліза	true
building_chains_encyclopedia_description_att_bch_eos_religion_judaism_major	Будівлі релігійного ланцюжка посилюють вплив вашої віри у володіннях фракції та чужих землях а також можуть підвищувати рівень санітарії в поселеннях. Склад цього ланцюжка різниться залежно від державної релігії фракції	true
building_chains_encyclopedia_description_att_bch_eos_religion_judaism_minor	Будівлі релігійного ланцюжка посилюють вплив вашої віри у володіннях фракції та чужих землях а також можуть підвищувати рівень санітарії в поселеннях. Склад цього ланцюжка різниться залежно від державної релігії фракції	true
building_chains_encyclopedia_name_mk_bch_religion_sunni_major	Релігія	true
building_chains_encyclopedia_name_mk_bch_religion_sunni_minor	Релігія: місто	true
building_chains_encyclopedia_description_bel_bch_religion_arian_major	Будівлі релігійного ланцюжка посилюють вплив вашої віри у володіннях фракції та на чужих землях а також можуть підвищувати рівень санітарії в поселеннях. Склад цього ланцюжка різниться залежно від державної релігії фракції	true
building_chains_encyclopedia_description_bel_bch_religion_arian_minor	Будівлі релігійного ланцюжка посилюють вплив вашої віри у володіннях фракції та на чужих землях а також можуть підвищувати рівень санітарії в поселеннях. Склад цього ланцюжка різниться залежно від державної релігії фракції	true
building_chains_encyclopedia_name_cha_bch_paganism	Язичництво	true
building_chains_encyclopedia_description_att_bch_barbmigs_settlement	Ланцюжок поселення прискорює зростання орди і дозволяє наймати основні види військ.	true
building_chains_encyclopedia_name_mk_bch_cenmigs_agriculture	Їжа	true
building_chains_encyclopedia_description_cha_bch_blacksmith	Ланцюжок кузні забезпечує ваші війська поліпшеним спорядженням.	true
building_chains_chain_tooltip_att_bch_nomad_warriors	Найм військ	true
building_chains_encyclopedia_description_att_bch_roman_water_major	Ланцюжок водопостачання для міста містить акведуки клоаки та інші споруди	true
building_chains_encyclopedia_description_att_bch_roman_water_minor	Ланцюжок водопостачання для містечка дозволяє будувати лазні що підвищують рівень санітарії і зростання населення по всій провінції.	true
building_chains_encyclopedia_description_bel_bch_roman_water_major	Ланцюг зберігання продовольства містить споруди які дозволяють довше зберігати їжу	true
building_chains_encyclopedia_description_bel_bch_roman_water_minor	Ланцюг водопостачання для містечка дозволяє зводити споруди для зберігання і розподілу води що підвищують рівень санітарії і зростання населення у всіх регіонах провінції.	true
building_chains_encyclopedia_name_att_bch_eastern_sassanid_military_cavalry	Місто: найм азадана	true
building_chains_encyclopedia_name_cha_bch_treasury	Скарбниця	true
building_chains_encyclopedia_name_bel_bch_resources_olives	Оливки	true
building_chains_chain_tooltip_mk_bch_cenmigs_siege	Майстерня	true
building_chains_chain_tooltip_mk_bch_moomigs_siege	Майстерня	true
building_chains_chain_tooltip_cha_bch_siege_workshop	Майстерня облогових машин	true
building_chains_chain_tooltip_att_bch_religion_germanic_major	Релігія	true
building_chains_chain_tooltip_att_bch_religion_germanic_minor	Релігія	true
building_chains_encyclopedia_description_att_bch_barbarian_port_minor	Placeholder description	true
building_chains_encyclopedia_description_cha_bch_food_market	Продовольчі ринки збільшують поставки їжі і приносять дохід від комерції в столицях провінцій.	true
building_chains_chain_tooltip_mk_bch_afrkingdoms_agriculture	Землеробство	true
building_chains_encyclopedia_name_att_bch_roman_water_major	Водопостачання: місто	true
building_chains_encyclopedia_name_att_bch_roman_water_minor	Водопостачання: містечко	true
building_chains_encyclopedia_name_bel_bch_roman_water_major	Водопостачання: місто	true
building_chains_encyclopedia_name_bel_bch_roman_water_minor	Водопостачання: містечко	true
building_chains_chain_tooltip_att_bch_barbarian_city_major	Велике поселення	true
building_chains_encyclopedia_description_mk_bch_moomigs_smith	Ланцюжок набору військ дозволяє наймати загони безпосередньо в армії що знаходиться в поході.	true
building_chains_encyclopedia_description_mk_bch_cenmigs_smith	Ланцюжок набору військ дозволяє наймати загони безпосередньо в армії що знаходиться в поході.	true
building_chains_encyclopedia_name_cha_bch_barracks	Казарми	true
building_chains_encyclopedia_description_att_bch_religion_grecoroman_major	Будівлі релігійного ланцюжка посилюють вплив вашої віри у володіннях фракції і чужих землях а також можуть підвищувати рівень санітарії в поселеннях. Склад цього ланцюжка різниться залежно від державної релігії фракції	true
building_chains_encyclopedia_description_att_bch_religion_grecoroman_minor	Будівлі релігійного ланцюжка посилюють вплив вашої віри у володіннях фракції та чужих землях а також можуть підвищувати рівень санітарії в поселеннях. Склад цього ланцюжка різниться залежно від державної релігії фракції	true
building_chains_encyclopedia_description_bel_bch_religion_grecoroman_major	Будівлі релігійного ланцюжка посилюють вплив вашої віри у володіннях фракції та на чужих землях а також можуть підвищувати рівень санітарії в поселеннях. Склад цього ланцюжка різниться залежно від державної релігії фракції	true
building_chains_encyclopedia_description_bel_bch_religion_grecoroman_minor	Будівлі релігійного ланцюжка посилюють вплив вашої віри у володіннях фракції та на чужих землях а також можуть підвищувати рівень санітарії в поселеннях. Склад цього ланцюжка різниться залежно від державної релігії фракції	true
building_chains_chain_tooltip_mk_bch_religion_baltic_major	Релігія	true
building_chains_chain_tooltip_mk_bch_religion_baltic_minor	Релігія	true
building_chains_encyclopedia_description_mk_bch_slakingdoms_industry_major	Виробничі споруди можна зводити в будь-яких містах або містечках. Вони можуть приносити додатковий дохід або забезпечувати війська покращеним спорядженням.	true
building_chains_encyclopedia_description_mk_bch_slakingdoms_industry_minor	Виробничі споруди можна зводити в будь-яких містах або містечках. Вони можуть приносити додатковий дохід або забезпечувати війська покращеним спорядженням.	true
building_chains_chain_tooltip_mk_bch_cenmigs_civic	Ринок	true
building_chains_chain_tooltip_mk_bch_moomigs_civic	Ринок	true
building_chains_chain_tooltip_mk_bch_religion_catharism_major	Релігія	true
building_chains_chain_tooltip_mk_bch_religion_catharism_minor	Релігія	true
building_chains_chain_tooltip_bel_bch_camp_workshop	Майстерня	true
building_chains_encyclopedia_description_att_bch_resources_orchards	Ланцюжки ресурсів дозволяють використовувати цінні товари доступні в регіоні	true
building_chains_encyclopedia_description_mk_bch_afrkingdoms_military_armory	Ланцюжок військових поліпшень містить споруди що надають більш якісне спорядження для військ і дозволяють будувати облогові знаряддя.	true
building_chains_chain_tooltip_att_bch_resources_furs	Виробництво хутра	true
building_chains_chain_tooltip_att_bch_eastern_sassanid_military_minor	Найм військ	true
building_chains_encyclopedia_description_bel_bch_resources_orchards	Ланцюжки ресурсів дозволяють використовувати цінні товари доступні в регіоні	true
building_chains_chain_tooltip_mk_bch_weskingdoms_military_barracks	Найм військ	true
building_chains_encyclopedia_name_att_bch_religion_grecoroman_major	Релігія: місто	true
building_chains_encyclopedia_name_att_bch_religion_grecoroman_minor	Релігія: містечко	true
building_chains_encyclopedia_name_bel_bch_religion_grecoroman_major	Релігія: місто	true
building_chains_encyclopedia_name_bel_bch_religion_grecoroman_minor	Релігія: містечко	true
building_chains_chain_tooltip_mk_bch_religion_tengri_major	Релігія	true
building_chains_chain_tooltip_mk_bch_religion_tengri_minor	Релігія	true
building_chains_chain_tooltip_mk_bch_slakingdoms_military_barracks	Найм військ	true
building_chains_chain_tooltip_mk_bch_ortkingdoms_military_barracks	Найм військ	true
building_chains_chain_tooltip_mk_bch_nomkingdoms_military_barracks	Найм військ	true
building_chains_chain_tooltip_mk_bch_mookingdoms_military_barracks	Найм військ	true
building_chains_chain_tooltip_mk_bch_ibekingdoms_military_barracks	Найм військ	true
building_chains_chain_tooltip_mk_bch_itakingdoms_military_barracks	Найм військ	true
building_chains_chain_tooltip_att_bch_celtic_farming	Садиба	true
building_chains_chain_tooltip_bel_bch_camp_military	Найм військ	true
building_chains_chain_tooltip_mk_bch_easkingdoms_military_barracks	Найм військ	true
building_chains_chain_tooltip_mk_bch_cenkingdoms_military_barracks	Найм військ	true
building_chains_chain_tooltip_mk_bch_afrkingdoms_military_barracks	Найм військ	true
building_chains_chain_tooltip_mk_bch_arakingdoms_military_barracks	Найм військ	true
building_chains_encyclopedia_description_mk_bch_weskingdoms_military_armory	Ланцюжок військових поліпшень містить споруди що надають більш якісне спорядження для військ і дозволяють будувати облогові знаряддя.	true
building_chains_chain_tooltip_att_bch_resources_gold_dummy	Золоті копальні	true
building_chains_chain_tooltip_bel_bch_resources_furs	Виробництво хутра	true
building_chains_encyclopedia_name_mk_bch_slakingdoms_industry_major	Виробництво	true
building_chains_encyclopedia_name_mk_bch_slakingdoms_industry_minor	Виробництво: місто	true
building_chains_encyclopedia_description_att_bch_eos_religion_judaism_major_faction	Будівлі релігійного ланцюжка посилюють вплив вашої віри у володіннях фракції та на чужих землях а також можуть підвищувати рівень санітарії в поселеннях. Склад цього ланцюжка різниться залежно від державної релігії фракції	true
building_chains_encyclopedia_description_att_bch_eos_religion_judaism_minor_faction	Будівлі релігійного ланцюжка посилюють вплив вашої віри у володіннях фракції та на чужих землях а також можуть підвищувати рівень санітарії в поселеннях. Склад цього ланцюжка різниться залежно від державної релігії фракції	true
building_chains_chain_tooltip_cha_bch_church_school	Церковна школа	true
building_chains_encyclopedia_description_mk_bch_cenkingdoms_military_armory	Ланцюжок військових поліпшень містить споруди що надають більш якісне спорядження для військ і дозволяють будувати облогові знаряддя.	true
building_chains_encyclopedia_name_att_bch_eastern_sassanid_port_minor	Порт	true
building_chains_encyclopedia_name_att_bch_nomad_noble	Лідерство	true
building_chains_chain_tooltip_cha_bch_copper	Виробництво міді	true
building_chains_chain_tooltip_cha_bch_tavern	Таверна	true
building_chains_encyclopedia_name_mk_bch_itakingdoms_military_armory	Військові поліпшення	true
building_chains_chain_tooltip_att_bch_barbarian_city_minor_generic	Мале поселення	true
building_chains_chain_tooltip_cha_bch_minor	Містечко	true
building_chains_encyclopedia_description_att_bch_eastern_sassanid_water_major	Ланцюжок водопостачання для міста містить споруди для зберігання і розподілу води що збільшують запаси їжі	true
building_chains_encyclopedia_description_att_bch_eastern_sassanid_water_minor	Ланцюжок водопостачання для містечка дозволяє зводити споруди для зберігання і розподілу води що поліпшують громадський порядок	true
building_chains_encyclopedia_name_cha_bch_trader_mus	Торговець	true
building_chains_encyclopedia_name_cha_bch_tengrism	Культ Тенгрі	true
building_chains_encyclopedia_name_cha_bch_garrison	Гарнізон	true
building_chains_chain_tooltip_cha_bch_marble	Виробництво мармуру	true
building_chains_encyclopedia_description_mk_bch_weskingdoms_industry_major	Виробничі споруди можна зводити в будь-яких містах або містечках. Вони можуть приносити додатковий дохід або забезпечувати війська покращеним спорядженням.	true
building_chains_encyclopedia_description_mk_bch_weskingdoms_industry_minor	Виробничі споруди можна зводити в будь-яких містах або містечках. Вони можуть приносити додатковий дохід або забезпечувати війська покращеним спорядженням.	true
building_chains_encyclopedia_description_att_bch_religion_manichaeist_major	Споруди релігійного ланцюжка посилюють вплив вашої віри у володіннях фракції та чужих землях а також можуть підвищувати рівень санітарії в поселеннях. Склад цього ланцюжка різниться залежно від державної релігії фракції	true
building_chains_encyclopedia_description_att_bch_religion_manichaeist_minor	Будівлі релігійного ланцюжка посилюють вплив вашої віри у володіннях фракції та на чужих землях а також можуть підвищувати рівень санітарії в поселеннях. Склад цього ланцюжка різниться залежно від державної релігії фракції	true
building_chains_encyclopedia_description_mk_bch_religion_jewish_community_pol_major	Ланцюжок міського центру містить ринки палаци	true
building_chains_encyclopedia_description_mk_bch_religion_jewish_community_pol_minor	Ланцюжок центру містечка містить споруди що поліпшують громадський порядок або збільшують дохід від комерції та торгівлі.	true
building_chains_encyclopedia_description_att_bch_eos_religion_semitic_major	Будівлі релігійного ланцюжка посилюють вплив вашої віри у володіннях фракції та чужих землях а також можуть підвищувати рівень санітарії в поселеннях. Склад цього ланцюжка різниться залежно від державної релігії фракції	true
building_chains_encyclopedia_description_att_bch_eos_religion_semitic_minor	Будівлі релігійного ланцюжка посилюють вплив вашої віри у володіннях фракції та на чужих землях а також можуть підвищувати рівень санітарії в поселеннях. Склад цього ланцюжка різниться залежно від державної релігії фракції	true
building_chains_chain_tooltip_att_bch_religion_catholic_major	Релігія	true
building_chains_chain_tooltip_att_bch_religion_catholic_minor	Релігія	true
building_chains_encyclopedia_name_att_bch_roman_west_military	Найм військ	true
building_chains_encyclopedia_name_att_bch_roman_east_military	Найм військ	true
building_chains_encyclopedia_name_bel_bch_resources_marble	Мармур	true
building_chains_encyclopedia_name_mk_bch_crukingdoms_military_armory	Релігія	true
building_chains_encyclopedia_name_att_bch_religion_zoroastrian_minor	Релігія: містечко	true
building_chains_encyclopedia_name_mk_bch_ortkingdoms_military_armory	Військові поліпшення	true
building_chains_encyclopedia_name_mk_bch_arakingdoms_military_armory	Військові поліпшення	true
building_chains_chain_tooltip_mk_bch_slakingdoms_agriculture	Землеробство	true
building_chains_chain_tooltip_att_bch_resources_port_regular	Порт	true
building_chains_encyclopedia_description_bel_bch_roman_civic_major	Ланцюжок міського центру містить ринки розважальні заклади	true
building_chains_encyclopedia_description_mk_bch_ibekingdoms_military_armory	Ланцюжок військових поліпшень містить споруди що надають більш якісне спорядження для військ і дозволяють будувати облогові знаряддя.	true
building_chains_encyclopedia_description_att_bch_roman_civic_major	Ланцюжок міського центру містить ринки розважальні заклади	true
building_chains_chain_tooltip_bel_bch_roman_garrison	Гарнізон	true
building_chains_encyclopedia_name_cha_bch_horse_shows	Виставки коней	true
building_chains_chain_tooltip_mk_bch_cenkingdoms_military_garrison	Гарнізон	true
building_chains_chain_tooltip_mk_bch_afrkingdoms_military_garrison	Гарнізон	true
building_chains_chain_tooltip_mk_bch_arakingdoms_military_garrison	Гарнізон	true
building_chains_chain_tooltip_mk_bch_easkingdoms_military_garrison	Гарнізон	true
building_chains_chain_tooltip_mk_bch_ibekingdoms_military_garrison	Гарнізон	true
building_chains_chain_tooltip_mk_bch_itakingdoms_military_garrison	Гарнізон	true
building_chains_chain_tooltip_mk_bch_nomkingdoms_military_garrison	Гарнізон	true
building_chains_chain_tooltip_mk_bch_ortkingdoms_military_garrison	Гарнізон	true
building_chains_chain_tooltip_mk_bch_mookingdoms_military_garrison	Гарнізон	true
building_chains_chain_tooltip_mk_bch_mookingdoms_agriculture	Землеробство	true
building_chains_chain_tooltip_mk_bch_slakingdoms_military_garrison	Гарнізон	true
building_chains_chain_tooltip_mk_bch_nomkingdoms_agriculture	Землеробство	true
building_chains_chain_tooltip_mk_bch_weskingdoms_military_garrison	Гарнізон	true
building_chains_encyclopedia_description_mk_bch_easkingdoms_military_armory	Ланцюжок військових поліпшень містить споруди що надають більш якісне спорядження для військ і дозволяють будувати облогові знаряддя.	true
building_chains_chain_tooltip_att_bch_religion_arian_major	Релігія	true
building_chains_chain_tooltip_att_bch_religion_arian_minor	Релігія	true
building_chains_chain_tooltip_bel_bch_roman_military	Найм військ	true
building_chains_encyclopedia_name_mk_bch_weskingdoms_industry_major	Виробництво	true
building_chains_encyclopedia_name_mk_bch_weskingdoms_industry_minor	Виробництво: місто	true
building_chains_chain_tooltip_bel_bch_resources_port_regular	Порт	true
building_chains_chain_tooltip_cha_bch_fields	Поля	true
building_chains_chain_tooltip_mk_bch_nomkingdoms_yam	Пересильні пункти	true
building_chains_encyclopedia_name_mk_bch_easkingdoms_grazing_grounds	Поселення племені	true
building_chains_chain_tooltip_att_bch_easmigs_weapon_upgrade	Спорядження	true
building_chains_encyclopedia_name_mk_bch_moomigs_agriculture	Їжа	true
building_chains_encyclopedia_name_mk_bch_nommigs_agriculture	Скотарство	true
building_chains_encyclopedia_name_bel_bch_roman_civic_major	Центр міста	true
building_chains_encyclopedia_name_att_bch_roman_civic_major	Центр міста	true
building_chains_chain_tooltip_mk_bch_cenmigs_priest	Священнослужитель	true
building_chains_encyclopedia_name_bel_bch_religion_catholic_legendary	Престол пентархії	true
building_chains_chain_tooltip_cha_bch_spring	Джерело	true
building_chains_encyclopedia_name_mk_bch_mookingdoms_military_armory	Військові поліпшення	true
building_chains_encyclopedia_name_mk_bch_nomkingdoms_military_armory	Військові поліпшення	true
building_chains_encyclopedia_name_mk_bch_itakingdoms_industry_major	Виробництво	true
building_chains_encyclopedia_name_mk_bch_itakingdoms_industry_minor	Виробництво: місто	true
building_chains_encyclopedia_name_mk_bch_ibekingdoms_industry_major	Виробництво	true
building_chains_encyclopedia_name_mk_bch_ibekingdoms_industry_minor	Виробництво: місто	true
building_chains_chain_tooltip_cha_bch_court_council	Суд справедливості	true
building_chains_chain_tooltip_cha_bch_cloth	Виробництво тканин	true
building_chains_chain_tooltip_att_bch_eastern_sassanid_civic_major	Центр міста	true
building_chains_chain_tooltip_att_bch_eastern_sassanid_civic_minor	Центр містечка	true
building_chains_encyclopedia_name_att_bch_barbarian_industry	Ремесла	true
building_chains_chain_tooltip_att_bch_eos_religion_east_church_major	Сх. християнство	true
building_chains_chain_tooltip_att_bch_eos_religion_east_church_minor	Сх. християнство	true
building_chains_chain_tooltip_bel_bch_religion_orthodox_major	Релігія	true
building_chains_chain_tooltip_bel_bch_religion_orthodox_minor	Релігія	true
building_chains_encyclopedia_name_att_bch_eos_religion_semitic_major_faction	Семітське язичництво: місто	true
building_chains_encyclopedia_name_att_bch_eos_religion_semitic_minor_faction	Семітське язичництво: містечко	true
building_chains_encyclopedia_description_mk_bch_ibekingdoms_industry_major	Виробничі споруди можна будувати в будь-яких містах або містечках. Вони можуть приносити додатковий дохід або забезпечувати війська покращеним спорядженням.	true
building_chains_encyclopedia_description_mk_bch_ibekingdoms_industry_minor	Виробничі споруди можна будувати в будь-яких містах або містечках. Вони можуть приносити додатковий дохід або забезпечувати війська покращеним спорядженням.	true
building_chains_chain_tooltip_att_bch_nomad_herders	Скотарство	true
building_chains_encyclopedia_description_mk_bch_itakingdoms_industry_major	Виробничі споруди можна будувати в будь-яких містах або містечках. Вони можуть приносити додатковий дохід або забезпечувати війська покращеним спорядженням.	true
building_chains_encyclopedia_description_mk_bch_itakingdoms_industry_minor	Виробничі споруди можна будувати в будь-яких містах або містечках. Вони можуть приносити додатковий дохід або забезпечувати війська покращеним спорядженням.	true
building_chains_chain_tooltip_cha_bch_olive	Виробництво оливок	true
building_chains_encyclopedia_name_att_bch_religion_orthodox_legendary	Престол пентархії	true
building_chains_chain_tooltip_mk_bch_crukingdoms_agriculture	Землеробство	true
building_chains_chain_tooltip_mk_bch_ortkingdoms_agriculture	Землеробство	true
building_chains_encyclopedia_name_mk_bch_slakingdoms_military_armory	Військові поліпшення	true
building_chains_chain_tooltip_mk_bch_arakingdoms_agriculture	Землеробство	true
building_chains_encyclopedia_description_att_bch_religion_zoroastrian_minor_faction	Будівлі релігійного ланцюжка посилюють вплив вашої віри у володіннях фракції та на чужих землях а також можуть підвищувати рівень санітарії в поселеннях. Склад цього ланцюжка різниться залежно від державної релігії фракції	true
building_chains_encyclopedia_name_mk_bch_religion_ibadi_major	Релігія	true
building_chains_encyclopedia_name_mk_bch_religion_ibadi_minor	Релігія: місто	true
building_chains_encyclopedia_name_cha_bch_goldsmiths	Дім золотаря	true
building_chains_encyclopedia_name_att_bch_eos_religion_judaism_major	Іудаїзм: місто	true
building_chains_encyclopedia_name_att_bch_eos_religion_judaism_minor	Іудаїзм: містечко	true
building_chains_encyclopedia_description_att_bch_eastmigs_leadership	Урядові споруди об'єднують кочівників підвищуючи згуртованість їх військ і забезпечуючи додатковий дохід від культури.	true
building_chains_encyclopedia_description_att_bch_barbmigs_leadership	Урядові споруди об'єднують орду підвищуючи згуртованість її військ і забезпечуючи додатковий дохід від культури.	true
building_chains_chain_tooltip_att_bch_resources_iron	Виробництво заліза	true
building_chains_encyclopedia_name_att_bch_nomad_city	Поселення кочівників	true
building_chains_chain_tooltip_att_bch_resources_wood	Виробництво дерева	true
building_chains_chain_tooltip_bel_bch_resources_salt	Виробництво солі	true
building_chains_chain_tooltip_att_bch_barbarian_port_minor	Порт	true
building_chains_encyclopedia_name_mk_bch_mookingdoms_industry_major	Виробництво	true
building_chains_encyclopedia_name_mk_bch_mookingdoms_industry_minor	Виробництво: місто	true
building_chains_chain_tooltip_bel_bch_resources_gold	Золоті копальні	true
building_chains_encyclopedia_description_mk_bch_ortkingdoms_industry_major	Виробничі споруди можна зводити в будь-яких містах або містечках. Вони можуть приносити додатковий дохід або забезпечувати війська покращеним спорядженням.	true
building_chains_encyclopedia_description_mk_bch_ortkingdoms_industry_minor	Виробничі споруди можна зводити в будь-яких містах або містечках. Вони можуть приносити додатковий дохід або забезпечувати війська покращеним спорядженням.	true
building_chains_encyclopedia_description_mk_bch_cenmigs_siege	Будівлі ремісничого ланцюжка дозволяють покращувати загони що входять до складу армії	true
building_chains_encyclopedia_description_mk_bch_moomigs_siege	Будівлі ремісничого ланцюжка дозволяють покращувати загони що входять до складу армії	true
building_chains_encyclopedia_name_att_bch_resources_marble	Мармур	true
building_chains_encyclopedia_name_cha_bch_blacksmith	Кузня	true
building_chains_chain_tooltip_cha_bch_mosque	Мечеть	true
building_chains_chain_tooltip_mk_bch_itakingdoms_agriculture	Землеробство	true
building_chains_chain_tooltip_mk_bch_moomigs_smith	Військові поліпшення	true
building_chains_chain_tooltip_bel_bch_resources_gems	Виробництво самоцвітів	true
building_chains_chain_tooltip_mk_bch_cenmigs_smith	Військові поліпшення	true
building_chains_encyclopedia_description_mk_bch_cenmigs_agriculture	Залежно від обраної гілки будівлі харчового ланцюжка можуть або виробляти їжу або приносити дохід вашій армії.	true
building_chains_encyclopedia_name_att_bch_eastern_sassanid_city_minor_generic	Містечко	true
building_chains_chain_tooltip_att_bch_nomad_community	Суспільство	true
building_chains_encyclopedia_description_att_bch_barbarian_city_major	Placeholder description	true
building_chains_encyclopedia_description_cha_bch_hall_elders	Ланцюжок зали старійшин підвищує швидкість досліджень.	true
building_chains_encyclopedia_description_mk_bch_mookingdoms_industry_major	Виробничі споруди можна зводити в будь-яких містах або містечках. Вони можуть приносити додатковий дохід або забезпечувати війська покращеним спорядженням.	true
building_chains_encyclopedia_description_mk_bch_mookingdoms_industry_minor	Виробничі споруди можна зводити в будь-яких містах або містечках. Вони можуть приносити додатковий дохід або забезпечувати війська покращеним спорядженням.	true
building_chains_chain_tooltip_att_bch_nomad_artisan	Ремесла	true
building_chains_encyclopedia_name_mk_bch_ortkingdoms_industry_major	Виробництво	true
building_chains_encyclopedia_name_mk_bch_ortkingdoms_industry_minor	Виробництво: місто	true
building_chains_chain_tooltip_bel_bch_religion_arian_major	Релігія	true
building_chains_chain_tooltip_bel_bch_religion_arian_minor	Релігія	true
building_chains_chain_tooltip_att_bch_resources_gems	Виробництво самоцвітів	true
building_chains_encyclopedia_description_att_bch_resources_iron_dummy	Ланцюжки ресурсів дозволяють використовувати цінні товари доступні в регіоні	true
building_chains_chain_tooltip_att_bch_eastmigs_city	Переселенці: поселення	true
building_chains_chain_tooltip_att_bch_resources_silk	Шовковий шлях	true
building_chains_chain_tooltip_att_bch_resources_gold	Золоті копальні	true
building_chains_chain_tooltip_att_bch_resources_port_spices	Порт для торгівлі прянощами	true
building_chains_chain_tooltip_bel_bch_resources_iron	Виробництво заліза	true
building_chains_chain_tooltip_att_bch_resources_salt	Виробництво солі	true
building_chains_chain_tooltip_bel_bch_resources_wood	Виробництво дерева	true
building_chains_chain_tooltip_att_bch_resources_pitch	Виробництво дьогтю	true
building_chains_encyclopedia_name_mk_bch_arakingdoms_industry_major	Виробництво	true
building_chains_encyclopedia_name_mk_bch_arakingdoms_industry_minor	Виробництво: місто	true
building_chains_encyclopedia_description_mk_bch_cenkingdoms_industry_major	Виробничі споруди можна зводити в будь-яких містах або містечках. Вони можуть приносити додатковий дохід або забезпечувати війська покращеним спорядженням.	true
building_chains_encyclopedia_description_mk_bch_cenkingdoms_industry_minor	Виробничі споруди можна зводити в будь-яких містах або містечках. Вони можуть приносити додатковий дохід або забезпечувати війська покращеним спорядженням.	true
building_chains_encyclopedia_description_mk_bch_crukingdoms_industry_major	Виробничі споруди можна зводити в будь-яких містах або містечках. Вони можуть приносити додатковий дохід або забезпечувати війська покращеним спорядженням.	true
building_chains_encyclopedia_description_mk_bch_crukingdoms_industry_minor	Виробничі споруди можна зводити в будь-яких містах або містечках. Вони можуть приносити додатковий дохід або забезпечувати війська покращеним спорядженням.	true
building_chains_encyclopedia_name_mk_bch_afrkingdoms_industry_major	Виробництво	true
building_chains_encyclopedia_name_mk_bch_afrkingdoms_industry_minor	Виробництво: місто	true
building_chains_encyclopedia_description_mk_bch_nomkingdoms_military_barracks	Будівлі для найму військ можна зводити в будь-яких містах або містечках. Вони дозволяють наймати більшість видів піхоти кінноти і стрільців.	true
building_chains_encyclopedia_description_mk_bch_ortkingdoms_military_barracks	Будівлі для найму військ можна зводити в будь-яких містах або містечках. Вони дозволяють наймати більшість видів піхоти кінноти і стрільців.	true
building_chains_encyclopedia_description_mk_bch_mookingdoms_military_barracks	Будівлі для найму військ можна зводити в будь-яких містах або містечках. Вони дозволяють наймати більшість видів піхоти кінноти і застрільників.	true
building_chains_encyclopedia_description_mk_bch_ibekingdoms_military_barracks	Будівлі для найму військ можна зводити в будь-яких містах або містечках. Вони дозволяють наймати більшість видів піхоти кінноти і застрільників.	true
building_chains_encyclopedia_description_mk_bch_itakingdoms_military_barracks	Будівлі для найму військ можна зводити в будь-яких містах або містечках. Вони дозволяють наймати більшість видів піхоти кінноти і стрільців.	true
building_chains_encyclopedia_description_mk_bch_easkingdoms_military_barracks	Будівлі для найму військ можна зводити в будь-яких містах або містечках. Вони дозволяють наймати більшість видів піхоти кінноти і стрільців.	true
building_chains_encyclopedia_description_mk_bch_cenkingdoms_military_barracks	Будівлі для найму військ можна зводити в будь-яких містах або містечках. Вони дозволяють наймати більшість видів піхоти кінноти і стрільців.	true
building_chains_encyclopedia_description_mk_bch_afrkingdoms_military_barracks	Будівлі для найму військ можна зводити в будь-яких містах або містечках. Вони дозволяють наймати більшість видів піхоти кінноти і стрільців.	true
building_chains_encyclopedia_description_mk_bch_arakingdoms_military_barracks	Будівлі для найму військ можна зводити в будь-яких містах або містечках. Вони дозволяють наймати більшість видів піхоти кінноти і стрільців.	true
building_chains_encyclopedia_description_mk_bch_weskingdoms_military_barracks	Будівлі для найму військ можна зводити в будь-яких містах або містечках. Вони дозволяють наймати більшість видів піхоти кінноти і стрільців.	true
building_chains_encyclopedia_description_mk_bch_religion_tengri_major	Будівлі релігійного ланцюжка посилюють вплив вашої віри у володіннях фракції та чужих землях а також можуть підвищувати рівень санітарії в поселеннях. Склад цього ланцюжка різниться залежно від державної релігії фракції	true
building_chains_encyclopedia_description_mk_bch_religion_tengri_minor	Будівлі релігійного ланцюжка посилюють вплив вашої віри у володіннях фракції та на чужих землях а також можуть підвищувати рівень санітарії в поселеннях. Склад цього ланцюжка різниться залежно від державної релігії фракції	true
building_chains_encyclopedia_description_mk_bch_slakingdoms_military_barracks	Будівлі для найму військ можна зводити в будь-яких містах або містечках. Вони дозволяють наймати більшість видів піхоти кінноти і стрільців.	true
building_chains_encyclopedia_description_att_bch_resources_gold_dummy	Ланцюжки ресурсів дозволяють використовувати цінні товари доступні в регіоні	true
building_chains_encyclopedia_name_mk_bch_afrkingdoms_military_armory	Військові поліпшення	true
building_chains_chain_tooltip_att_bch_eastern_sassanid_water_major	Санітарія	true
building_chains_chain_tooltip_att_bch_eastern_sassanid_water_minor	Санітарія	true
building_chains_chain_tooltip_bel_bch_resources_lead	Виробництво свинцю	true
building_chains_encyclopedia_name_att_Slum	Нетрі	true
building_chains_encyclopedia_name_att_bch_resources_orchards	Сади	true
building_chains_encyclopedia_name_att_bch_eastern_sassanid_city_major	Місто	true
building_chains_encyclopedia_description_att_bch_barbarian_city_minor_generic	Placeholder description	true
building_chains_encyclopedia_description_cha_bch_bismaristan	Ланцюжок бімарістану підвищує рівень санітарії у своїй та сусідніх провінціях.	true
building_chains_encyclopedia_name_mk_bch_weskingdoms_military_armory	Військові поліпшення	true
building_chains_encyclopedia_name_att_bch_barbmigs_herding	Переселенці: стада	true
building_chains_encyclopedia_name_mk_bch_cenkingdoms_military_armory	Військові поліпшення	true
building_chains_encyclopedia_name_att_bch_eos_religion_judaism_major_faction	Іудаїзм: місто	true
building_chains_encyclopedia_name_att_bch_eos_religion_judaism_minor_faction	Іудаїзм: містечко	true
building_chains_chain_tooltip_att_bch_resources_lead	Виробництво свинцю	true
building_chains_encyclopedia_name_mk_bch_crukingdoms_industry_major	Виробництво	true
building_chains_encyclopedia_name_mk_bch_crukingdoms_industry_minor	Виробництво: місто	true
building_chains_encyclopedia_name_bel_bch_resources_orchards	Сади	true
building_chains_encyclopedia_description_mk_bch_afrkingdoms_industry_major	Виробничі споруди можна зводити в будь-яких містах або містечках. Вони можуть приносити додатковий дохід або забезпечувати війська покращеним спорядженням.	true
building_chains_encyclopedia_description_mk_bch_afrkingdoms_industry_minor	Виробничі споруди можна зводити в будь-яких містах або містечках. Вони можуть приносити додатковий дохід або забезпечувати війська покращеним спорядженням.	true
building_chains_encyclopedia_description_mk_bch_arakingdoms_industry_major	Виробничі споруди можна зводити в будь-яких містах або містечках. Вони можуть приносити додатковий дохід або забезпечувати війська покращеним спорядженням.	true
building_chains_encyclopedia_description_mk_bch_arakingdoms_industry_minor	Виробничі споруди можна зводити в будь-яких містах або містечках. Вони можуть приносити додатковий дохід або забезпечувати війська покращеним спорядженням.	true
building_chains_encyclopedia_name_mk_bch_cenkingdoms_industry_major	Виробництво	true
building_chains_encyclopedia_name_mk_bch_cenkingdoms_industry_minor	Виробництво: місто	true
building_chains_encyclopedia_description_mk_bch_religion_baltic_major	Будівлі релігійного ланцюжка посилюють вплив вашої віри у володіннях фракції та на чужих землях а також можуть підвищувати рівень санітарії в поселеннях. Склад цього ланцюжка різниться залежно від державної релігії фракції	true
building_chains_encyclopedia_description_mk_bch_religion_baltic_minor	Будівлі релігійного ланцюжка посилюють вплив вашої віри у володіннях фракції та чужих землях а також можуть підвищувати рівень санітарії в поселеннях. Склад цього ланцюжка різниться залежно від державної релігії фракції	true
building_chains_encyclopedia_description_mk_bch_cenmigs_civic	Будівлі ринкового ланцюжка приносять дохід вашій армії.	true
building_chains_encyclopedia_description_mk_bch_moomigs_civic	Будівлі ринкового ланцюжка приносять дохід вашій армії.	true
building_chains_encyclopedia_description_mk_bch_itakingdoms_military_armory	Ланцюжок військових поліпшень містить будівлі що надають більш якісне спорядження для військ і дозволяють будувати облогові знаряддя.	true
building_chains_encyclopedia_name_att_bch_eos_religion_semitic_major	Семітське язичництво: місто	true
building_chains_encyclopedia_name_att_bch_eos_religion_semitic_minor	Семітське язичництво: містечко	true
building_chains_chain_tooltip_cha_bch_trader	Торговець	true
building_chains_encyclopedia_name_att_bch_religion_manichaeist_major	Релігія: місто	true
building_chains_encyclopedia_name_att_bch_religion_manichaeist_minor	Релігія: містечко	true
building_chains_encyclopedia_name_mk_bch_religion_jewish_community_pol_major	Єврейська громада	true
building_chains_encyclopedia_name_mk_bch_religion_jewish_community_pol_minor	Єврейська громада: місто	true
building_chains_encyclopedia_description_mk_bch_cenmigs_main	Будівлі ланцюжка табору забезпечують зростання населення і найм військ а також приносять необхідний для цього дохід.	true
building_chains_encyclopedia_description_cha_bch_trader_mus	Торговці приносять дохід від комерції в малих поселеннях.	true
building_chains_encyclopedia_name_mk_bch_easkingdoms_industry_major	Виробництво	true
building_chains_encyclopedia_name_mk_bch_easkingdoms_industry_minor	Виробництво: місто	true
building_chains_encyclopedia_description_mk_bch_slakingdoms_military_garrison	Гарнізонні споруди можна будувати тільки в столицях регіонів. Вони підвищують рівень громадського порядку і надають додаткові війська для оборони поселень.	true
building_chains_encyclopedia_description_mk_bch_weskingdoms_military_garrison	Гарнізонні споруди можна будувати тільки в столицях регіонів. Вони підвищують рівень громадського порядку і надають додаткові війська для оборони поселень.	true
building_chains_encyclopedia_description_mk_bch_cenkingdoms_military_garrison	Гарнізонні споруди можна будувати тільки в столицях регіонів. Вони підвищують рівень громадського порядку і надають додаткові війська для оборони поселень.	true
building_chains_encyclopedia_description_mk_bch_afrkingdoms_military_garrison	Гарнізонні споруди можна будувати тільки в столицях регіонів. Вони підвищують рівень громадського порядку і надають додаткові війська для оборони поселень.	true
building_chains_encyclopedia_description_mk_bch_arakingdoms_military_garrison	Гарнізонні споруди можна зводити тільки в столицях регіонів. Вони підвищують рівень громадського порядку і надають додаткові війська для оборони поселень.	true
building_chains_encyclopedia_description_mk_bch_easkingdoms_military_garrison	Гарнізонні споруди можна зводити тільки в столицях регіонів. Вони підвищують рівень громадського порядку і надають додаткові війська для оборони поселень.	true
building_chains_encyclopedia_description_mk_bch_ibekingdoms_military_garrison	Гарнізонні споруди можна зводити тільки в столицях регіонів. Вони підвищують рівень громадського порядку і надають додаткові війська для оборони поселень.	true
building_chains_encyclopedia_description_mk_bch_itakingdoms_military_garrison	Гарнізонні споруди можна зводити тільки в столицях регіонів. Вони підвищують рівень громадського порядку і надають додаткові війська для оборони поселень.	true
building_chains_encyclopedia_description_mk_bch_ortkingdoms_military_garrison	Гарнізонні споруди можна зводити тільки в столицях регіонів. Вони підвищують рівень громадського порядку і надають додаткові війська для оборони поселень.	true
building_chains_encyclopedia_description_mk_bch_nomkingdoms_military_garrison	Гарнізонні споруди можна зводити тільки в столицях регіонів. Вони підвищують рівень громадського порядку і надають додаткові війська для оборони поселень.	true
building_chains_encyclopedia_description_mk_bch_mookingdoms_military_garrison	Гарнізонні споруди можна будувати тільки в столицях регіонів. Вони підвищують рівень громадського порядку і надають додаткові війська для оборони поселень.	true
building_chains_encyclopedia_description_att_bch_religion_arian_major	Споруди релігійного ланцюжка посилюють вплив вашої віри у володіннях фракції і чужих землях а також можуть підвищувати рівень санітарії в поселеннях. Склад цього ланцюжка різниться залежно від державної релігії фракції	true
building_chains_encyclopedia_description_att_bch_religion_arian_minor	Будівлі релігійного ланцюжка посилюють вплив вашої віри у володіннях фракції та на чужих землях а також можуть підвищувати рівень санітарії в поселеннях. Склад цього ланцюжка різниться залежно від державної релігії фракції	true
building_chains_encyclopedia_name_mk_bch_ibekingdoms_military_armory	Військові поліпшення	true
building_chains_encyclopedia_description_mk_bch_crukingdoms_military_armory	Ланцюжок військових поліпшень містить споруди що надають більш якісне спорядження для військ і дозволяють будувати облогові знаряддя.	true
building_chains_encyclopedia_description_att_bch_religion_zoroastrian_minor	Споруди релігійного ланцюжка посилюють вплив вашої віри у володіннях фракції та на чужих землях а також можуть підвищувати рівень санітарії в поселеннях. Склад цього ланцюжка різниться залежно від державної релігії фракції	true
building_chains_encyclopedia_description_mk_bch_moomigs_main	Будівлі ланцюжка табору забезпечують зростання населення і наймання військ а також приносять необхідний для цього дохід.	true
building_chains_encyclopedia_description_mk_bch_ortkingdoms_military_armory	Ланцюжок військових поліпшень містить будівлі що надають більш якісне спорядження для військ і дозволяють будувати облогові знаряддя.	true
building_chains_encyclopedia_description_mk_bch_arakingdoms_military_armory	Ланцюжок військових поліпшень містить споруди що надають більш якісне спорядження для військ і дозволяють будувати облогові знаряддя.	true
building_chains_chain_tooltip_cha_bch_munya	Мунья	true
building_chains_chain_tooltip_bel_bch_religion_catholic_major	Релігія	true
building_chains_chain_tooltip_bel_bch_religion_catholic_minor	Релігія	true
building_chains_encyclopedia_name_mk_bch_easkingdoms_military_armory	Військові поліпшення	true
building_chains_encyclopedia_name_att_bch_resources_olives	Оливки	true
building_chains_encyclopedia_description_mk_bch_ortkingdoms_military_garrison_serbia	Гарнізонні споруди можна зводити тільки в столицях регіонів. Вони підвищують рівень громадського порядку і надають додаткові війська для оборони поселень.	true
building_chains_encyclopedia_description_mk_bch_easkingdoms_industry_major	Виробничі споруди можна зводити в будь-яких містах або містечках. Вони можуть приносити додатковий дохід або забезпечувати війська покращеним спорядженням.	true
building_chains_encyclopedia_description_mk_bch_easkingdoms_industry_minor	Виробничі споруди можна зводити в будь-яких містах або містечках. Вони можуть приносити додатковий дохід або забезпечувати війська покращеним спорядженням.	true
building_chains_chain_tooltip_att_bch_resources_dyes	Виробництво фарб	true
building_chains_encyclopedia_name_att_slav_bch_religion_major	Релігія: місто	true
building_chains_encyclopedia_name_att_slav_bch_religion_minor	Релігія: містечко	true
building_chains_encyclopedia_name_att_bch_religion_catholic_legendary	Престол пентархії	true
building_chains_encyclopedia_description_mk_bch_easkingdoms_grazing_grounds	Placeholder description	true
building_chains_encyclopedia_description_mk_bch_nommigs_agriculture	Стада служать основним джерелом їжі для кочівників а також приносять дохід від скотарства.	true
building_chains_encyclopedia_description_mk_bch_moomigs_agriculture	Залежно від обраної гілки будівлі харчового ланцюжка можуть або виробляти їжу або приносити дохід вашій армії.	true
building_chains_chain_tooltip_att_bch_eos_religion_east_church_major_faction	Сх. християнство	true
building_chains_chain_tooltip_att_bch_eos_religion_east_church_minor_faction	Сх. християнство	true
building_chains_chain_tooltip_att_bch_eastern_sassanid_port_minor	Порт	true
building_chains_chain_tooltip_att_bch_nomad_noble	Суспільство	true
building_chains_encyclopedia_name_att_bch_roman_west_city_major	Місто	true
building_chains_chain_tooltip_mk_bch_ortkingdoms_castle	Поселення	true
building_chains_encyclopedia_description_cha_bch_mosque	Будівлі релігійного ланцюжка посилюють вплив вашої віри у володіннях фракції та на чужих землях.	true
building_chains_encyclopedia_name_att_bch_eos_marib_dam	Марібська гребля	true
building_chains_encyclopedia_description_mk_bch_itakingdoms_agriculture	Сільськогосподарський ланцюжок містить споруди для землеробства і скотарства що збільшують виробництво їжі і дохід від сільського господарства.	true
building_chains_encyclopedia_name_att_bch_nomad_warriors	Найм військ	true
building_chains_encyclopedia_description_bel_bch_resources_gems	Ланцюжки ресурсів дозволяють використовувати цінні товари доступні в регіоні	true
building_chains_chain_tooltip_mk_bch_cenmigs_agriculture	Їжа	true
building_chains_encyclopedia_description_att_abandoned	Placeholder description	true
building_chains_encyclopedia_description_att_bch_religion_zoroastrian_major_fire_faction	Будівлі релігійного ланцюжка посилюють вплив вашої віри у володіннях фракції та на чужих землях а також можуть підвищувати рівень санітарії в поселеннях. Склад цього ланцюжка різниться залежно від державної релігії фракції	true
building_chains_chain_tooltip_mk_bch_nomkingdoms_castle	Поселення	true
building_chains_chain_tooltip_mk_bch_religion_zoroastrian_major	Релігія	true
building_chains_chain_tooltip_mk_bch_religion_zoroastrian_minor	Релігія	true
building_chains_encyclopedia_description_att_bch_resources_iron	Ланцюжки ресурсів дозволяють використовувати цінні товари доступні в регіоні	true
building_chains_encyclopedia_name_mk_bch_weskingdoms_agriculture	Землеробство	true
building_chains_encyclopedia_description_att_bch_resources_wood	Ланцюжки ресурсів дозволяють використовувати цінні товари доступні в регіоні	true
building_chains_encyclopedia_description_bel_bch_resources_salt	Ланцюжки ресурсів дозволяють використовувати цінні товари доступні в регіоні	true
building_chains_encyclopedia_description_bel_bch_all_agriculture	Сільськогосподарський ланцюжок містить споруди для землеробства і скотарства що збільшують виробництво їжі і дохід від сільського господарства.	true
building_chains_encyclopedia_description_bel_bch_resources_gold	Ланцюжки ресурсів дозволяють використовувати цінні товари доступні в регіоні	true
building_chains_encyclopedia_name_mk_bch_cenkingdoms_agriculture	Землеробство	true
building_chains_encyclopedia_name_mk_bch_religion_catharism_major	Релігія	true
building_chains_encyclopedia_name_mk_bch_religion_catharism_minor	Релігія: місто	true
building_chains_encyclopedia_description_att_bch_eos_marib_dam	Марібська гребля	true
building_chains_chain_tooltip_att_bch_religion_zoroastrian_major_burial	Релігія	true
building_chains_chain_tooltip_mk_bch_mookingdoms_castle	Поселення	true
building_chains_encyclopedia_description_att_bch_roman_west_city_major	Placeholder description	true
building_chains_encyclopedia_name_mk_bch_afrkingdoms_agriculture	Землеробство	true
building_chains_encyclopedia_description_att_bch_resources_silk	Ланцюжки ресурсів дозволяють використовувати цінні товари доступні в регіоні	true
building_chains_encyclopedia_description_att_bch_resources_gold	Ланцюжки ресурсів дозволяють використовувати цінні товари доступні в регіоні	true
building_chains_encyclopedia_description_bel_bch_resources_iron	Ланцюжки ресурсів дозволяють використовувати цінні товари доступні в регіоні	true
building_chains_encyclopedia_description_att_bch_resources_salt	Ланцюжки ресурсів дозволяють використовувати цінні товари доступні в регіоні	true
building_chains_encyclopedia_description_bel_bch_resources_wood	Ланцюжки ресурсів дозволяють використовувати цінні товари доступні в регіоні	true
building_chains_encyclopedia_name_att_bch_eastern_sassanid_military_minor	Містечко: найм новобранців	true
building_chains_chain_tooltip_att_bch_resources_orchards_dummy	Виробництво вина	true
building_chains_encyclopedia_name_att_abandoned	placeholder	true
building_chains_encyclopedia_name_cha_bch_siege_workshop	Майстерня облогових машин	true
building_chains_chain_tooltip_att_bch_barbmigs_industry	Виробництво	true
building_chains_encyclopedia_name_cha_bch_port	Порт	true
building_chains_encyclopedia_description_att_bch_resources_gems	Ланцюжки ресурсів дозволяють використовувати цінні товари доступні в регіоні	true
building_chains_encyclopedia_description_att_bch_religion_arian_legendary	Будівлі релігійного ланцюжка посилюють вплив вашої віри у володіннях фракції та на чужих землях а також можуть підвищувати рівень санітарії в поселеннях. Склад цього ланцюжка різниться залежно від державної релігії фракції	true
building_chains_encyclopedia_description_mk_bch_mookingdoms_town	Ланцюжок містечка дозволяє зміцнювати оборонні споруди поселення а також підвищувати стабільність і зростання провінції.	true
building_chains_encyclopedia_name_att_bch_roman_east_city_major	Місто	true
building_chains_encyclopedia_description_att_bch_eos_religion_east_church_major	Будівлі релігійного ланцюжка посилюють вплив вашої віри у володіннях фракції та на чужих землях а також можуть підвищувати рівень санітарії в поселеннях. Склад цього ланцюжка різниться залежно від державної релігії фракції	true
building_chains_encyclopedia_description_att_bch_eos_religion_east_church_minor	Будівлі релігійного ланцюжка посилюють вплив вашої віри у володіннях фракції та на чужих землях а також можуть підвищувати рівень санітарії в поселеннях. Склад цього ланцюжка різниться залежно від державної релігії фракції	true
building_chains_encyclopedia_description_bel_bch_camp_sanitation	Будівлі санітарного ланцюжка сприяють зростанню населення і забезпечують армію їжею.	true
building_chains_chain_tooltip_bel_bch_religion_catholic_legendary	Релігія	true
building_chains_encyclopedia_description_mk_bch_cenkingdoms_town	Ланцюжок містечка дозволяє зміцнювати оборонні споруди поселення а також підвищувати стабільність і зростання провінції.	true
building_chains_encyclopedia_description_cha_bch_spring	Джерела підвищують рівень санітарії але доступні тільки в малих поселеннях.	true
building_chains_encyclopedia_name_att_bch_barbarian_water_major	Міські запаси їжі	true
building_chains_encyclopedia_name_att_bch_barbarian_water_minor	Водопостачання: містечко	true
building_chains_encyclopedia_name_mk_bch_easkingdoms_agriculture	Землеробство	true
building_chains_encyclopedia_name_cha_bch_city	Місто	true
building_chains_chain_tooltip_att_bch_roman_west_military	Найм військ	true
building_chains_encyclopedia_name_att_bch_religion_catholic_major	Релігія: місто	true
building_chains_encyclopedia_name_att_bch_religion_catholic_minor	Релігія: містечко	true
building_chains_chain_tooltip_att_bch_roman_east_military	Найм військ	true
building_chains_chain_tooltip_mk_bch_crukingdoms_order	Найм військ	true
building_chains_encyclopedia_description_mk_bch_nomkingdoms_town	Ланцюжок містечка дозволяє зміцнювати оборонні споруди поселення а також підвищувати стабільність і зростання провінції.	true
building_chains_chain_tooltip_mk_bch_itakingdoms_castle	Поселення	true
building_chains_encyclopedia_description_mk_bch_crukingdoms_agriculture	Сільськогосподарський ланцюжок містить споруди для землеробства і скотарства що збільшують виробництво їжі і дохід від сільського господарства.	true
building_chains_encyclopedia_description_mk_bch_ortkingdoms_agriculture	Сільськогосподарський ланцюжок містить споруди для землеробства і скотарства що збільшують виробництво їжі і дохід від сільського господарства.	true
building_chains_encyclopedia_description_att_bch_roman_east_city_major	Placeholder	true
building_chains_encyclopedia_description_mk_bch_arakingdoms_agriculture	Сільськогосподарський ланцюг містить споруди для землеробства і скотарства що збільшують виробництво їжі і дохід від сільського господарства.	true
building_chains_chain_tooltip_mk_bch_ibekingdoms_castle	Поселення	true
building_chains_chain_tooltip_att_bch_religion_zoroastrian_minor_faction	Релігія	true
building_chains_encyclopedia_description_cha_bch_council	Ланцюг зали ради зменшує рівень корупції в своїй і сусідніх провінціях.	true
building_chains_encyclopedia_name_mk_bch_ibekingdoms_agriculture	Землеробство	true
building_chains_chain_tooltip_cha_bch_horse_shows	Виставки коней	true
building_chains_encyclopedia_description_att_bch_barbarian_water_major	Ланцюжок зберігання продовольства містить споруди які дозволяють довше зберігати їжу	true
building_chains_encyclopedia_description_att_bch_barbarian_water_minor	Ланцюжок водопостачання для містечка дозволяє зводити споруди для зберігання і розподілу води що підвищують рівень санітарії і зростання населення у всіх регіонах провінції.	true
building_chains_encyclopedia_description_att_bch_celtic_garrison	Споруди ланцюжка нальотів можна зводити тільки в столицях регіонів. Вони підвищують рівень громадського порядку і надають додаткові війська для оборони поселень.	true
building_chains_chain_tooltip_cha_bch_craftsmen	Ремісники	true
building_chains_encyclopedia_name_att_bch_roman_east_city_minor_generic	Містечко	true
building_chains_encyclopedia_name_att_bch_resources_port_regular	Порт	true
building_chains_encyclopedia_name_att_slav_bch_zadruga	Задруга	true
building_chains_chain_tooltip_att_bch_barbarian_farming	Садиба	true
building_chains_encyclopedia_name_bel_bch_roman_garrison	Гарнізон	true
building_chains_encyclopedia_description_mk_bch_nommigs_military	Військові споруди кочівників дозволяють наймати більшість видів військ доступних орду.	true
building_chains_chain_tooltip_mk_bch_crukingdoms_military_armory	Військові поліпшення	true
building_chains_chain_tooltip_att_bch_religion_zoroastrian_minor	Релігія	true
building_chains_chain_tooltip_mk_bch_ortkingdoms_military_armory	Військові поліпшення	true
building_chains_chain_tooltip_mk_bch_arakingdoms_military_armory	Військові поліпшення	true
building_chains_encyclopedia_name_mk_bch_slakingdoms_agriculture	Землеробство	true
building_chains_chain_tooltip_bel_bch_religion_orthodox_legendary	Релігія	true
building_chains_chain_tooltip_bel_bch_roman_city_major	Місто	true
building_chains_chain_tooltip_bel_bch_roman_city_minor	Містечко	true
building_chains_encyclopedia_description_cha_bch_trader	Торговці приносять дохід від комерції в малих поселеннях.	true
building_chains_chain_tooltip_cha_bch_trader_mus	Торговець	true
building_chains_encyclopedia_name_cha_bch_marble	Виробництво мармуру	true
building_chains_encyclopedia_description_mk_bch_nommigs_community	Громадські землі приносять кочівникам дохід від комерції а також можуть сприяти виробництву їжі	true
building_chains_encyclopedia_name_att_bch_religion_orthodox_major	Релігія: місто	true
building_chains_encyclopedia_name_att_bch_religion_orthodox_minor	Релігія: містечко	true
building_chains_encyclopedia_description_mk_bch_arakingdoms_town	Ланцюжок містечка дозволяє зміцнювати оборонні споруди поселення а також підвищувати стабільність і зростання провінції.	true
building_chains_encyclopedia_description_mk_bch_itakingdoms_town	Ланцюжок містечка дозволяє зміцнювати оборонні споруди поселення а також підвищувати стабільність і зростання провінції.	true
building_chains_encyclopedia_description_mk_bch_slakingdoms_town	Ланцюжок містечка дозволяє зміцнювати оборонні споруди поселення а також підвищувати стабільність і зростання провінції.	true
building_chains_encyclopedia_description_att_bch_roman_east_city_minor_generic	Placeholder description	true
building_chains_chain_tooltip_mk_bch_easkingdoms_castle	Поселення	true
building_chains_encyclopedia_name_att_bch_easmigs_weapon_upgrade	Спорядження	true
building_chains_encyclopedia_name_cha_bch_fields	Поля	true
building_chains_encyclopedia_name_att_bch_slav_farming	Поля	true
building_chains_chain_tooltip_mk_bch_easkingdoms_grazing_grounds	Поселення племені	true
building_chains_encyclopedia_name_mk_bch_nomkingdoms_yam	Пересильні пункти	true
building_chains_chain_tooltip_mk_bch_nommigs_agriculture	Скотарство	true
building_chains_chain_tooltip_mk_bch_moomigs_agriculture	Їжа	true
building_chains_encyclopedia_description_att_bch_eos_religion_east_church_major_faction	Будівлі релігійного ланцюжка посилюють вплив вашої віри у володіннях фракції та на чужих землях а також можуть підвищувати рівень санітарії в поселеннях. Склад цього ланцюжка різниться залежно від державної релігії фракції	true
building_chains_encyclopedia_description_att_bch_eos_religion_east_church_minor_faction	Будівлі релігійного ланцюжка посилюють вплив вашої віри у володіннях фракції та на чужих землях а також можуть підвищувати рівень санітарії в поселеннях. Склад цього ланцюжка різниться залежно від державної релігії фракції	true
building_chains_encyclopedia_name_bel_bch_resources_port_regular	Порт	true
building_chains_encyclopedia_name_bel_bch_roman_military	Найм військ	true
building_chains_chain_tooltip_att_bch_barbmigs_military	Найм військ	true
building_chains_encyclopedia_name_mk_bch_nomkingdoms_agriculture	Землеробство	true
building_chains_encyclopedia_name_mk_bch_mookingdoms_agriculture	Землеробство	true
building_chains_encyclopedia_description_att_bch_resources_dyes	Ланцюжки ресурсів дозволяють використовувати цінні товари доступні в регіоні	true
building_chains_encyclopedia_name_att_bch_religion_germanic_major	Релігія: місто	true
building_chains_encyclopedia_name_att_bch_religion_germanic_minor	Релігія: містечко	true
building_chains_encyclopedia_name_att_bch_roman_west_city_minor_generic	Містечко	true
building_chains_encyclopedia_description_mk_bch_cenmigs_barracks	Військові споруди кочівників дозволяють наймати більшість видів військ доступних орду.	true
building_chains_chain_tooltip_mk_bch_crukingdoms_castle	Поселення	true
building_chains_encyclopedia_name_att_bch_resources_furs	Хутра	true
building_chains_encyclopedia_description_att_bch_all_livestock	Placeholder description	true
building_chains_chain_tooltip_mk_bch_cenkingdoms_castle	Поселення	true
building_chains_encyclopedia_description_cha_bch_fighter	Бойовий ланцюжок покращує громадський порядок дає переваги піхоті і підвищує імперію вашої фракції.	true
building_chains_encyclopedia_description_cha_bch_hospice	Ланцюжок притулку підвищує рівень санітарії у своїй та сусідніх провінціях.	true
building_chains_chain_tooltip_cha_bch_mead_hall	Медовий зал	true
building_chains_encyclopedia_description_att_bch_religion_tengri_major	Будівлі релігійного ланцюжка посилюють вплив вашої віри у володіннях фракції та на чужих землях а також можуть підвищувати рівень санітарії в поселеннях. Склад цього ланцюжка різниться залежно від державної релігії фракції	true
building_chains_encyclopedia_description_att_bch_religion_tengri_minor	Будівлі релігійного ланцюжка посилюють вплив вашої віри у володіннях фракції та на чужих землях а також можуть підвищувати рівень санітарії в поселеннях. Склад цього ланцюжка різниться залежно від державної релігії фракції	true
building_chains_encyclopedia_name_att_bch_religion_celtic_major	Релігія: місто	true
building_chains_encyclopedia_name_att_bch_religion_celtic_minor	Релігія: містечко	true
building_chains_encyclopedia_description_bel_bch_resources_lead	Ланцюжки ресурсів дозволяють використовувати цінні товари доступні в регіоні	true
building_chains_encyclopedia_description_mk_bch_moomigs_barracks	Військові споруди кочівників дозволяють наймати більшість видів військ доступних орду.	true
building_chains_encyclopedia_name_att_bch_barbarian_civic_major	Міські громадські землі	true
building_chains_encyclopedia_name_att_bch_barbarian_civic_minor	Громадські землі: містечко	true
building_chains_chain_tooltip_mk_bch_religion_sunni_major	Релігія	true
building_chains_chain_tooltip_mk_bch_religion_sunni_minor	Релігія	true
building_chains_encyclopedia_name_att_bch_all_livestock	Домашня худоба	true
building_chains_encyclopedia_description_mk_bch_ibekingdoms_town	Ланцюжок містечка дозволяє зміцнювати оборонні споруди поселення а також підвищувати стабільність і зростання провінції.	true
building_chains_chain_tooltip_bel_bch_religion_arian_legendary	Релігія	true
building_chains_chain_tooltip_mk_bch_arakingdoms_castle	Поселення	true
building_chains_encyclopedia_description_att_bch_roman_west_city_minor_generic	Placeholder description	true
building_chains_chain_tooltip_mk_bch_afrkingdoms_castle	Поселення	true
building_chains_encyclopedia_name_att_bch_religion_tengri_major	Релігія: місто	true
building_chains_encyclopedia_name_att_bch_religion_tengri_minor	Релігія: містечко	true
building_chains_encyclopedia_description_att_bch_religion_celtic_major	Будівлі релігійного ланцюжка посилюють вплив вашої віри у володіннях фракції та на чужих землях а також можуть підвищувати рівень санітарії в поселеннях. Склад цього ланцюжка різниться залежно від державної релігії фракції	true
building_chains_encyclopedia_description_att_bch_religion_celtic_minor	Будівлі релігійного ланцюжка посилюють вплив вашої віри у володіннях фракції та на чужих землях а також можуть підвищувати рівень санітарії в поселеннях. Склад цього ланцюжка різниться залежно від державної релігії фракції	true
building_chains_encyclopedia_description_mk_bch_resources_silver	Ланцюжки ресурсів дозволяють використовувати цінні товари доступні в регіоні	true
building_chains_encyclopedia_name_cha_bch_copper	Виробництво міді	true
building_chains_chain_tooltip_mk_bch_itakingdoms_military_armory	Військові поліпшення	true
building_chains_encyclopedia_name_cha_bch_tavern	Таверна	true
building_chains_encyclopedia_description_att_bch_religion_zoroastrian_major_fire	Будівлі релігійного ланцюжка посилюють вплив вашої віри у володіннях фракції та на чужих землях а також можуть підвищувати рівень санітарії в поселеннях. Склад цього ланцюжка різниться залежно від державної релігії фракції	true
building_chains_encyclopedia_name_bel_bch_resources_furs	Хутра	true
building_chains_encyclopedia_description_att_bch_barbarian_civic_major	Міські громадські землі можуть приносити додатковий дохід від культури або комерції а також давати такі переваги	true
building_chains_encyclopedia_description_att_bch_barbarian_civic_minor	Громадські землі містечка приносять дохід від культури і підвищують стабільність суспільства завдяки наявності житла вождя або воєначальника.	true
building_chains_encyclopedia_description_att_bch_resources_lead	Ланцюжки ресурсів дозволяють використовувати цінні товари доступні в регіоні	true
building_chains_chain_tooltip_mk_bch_religion_bogomilism_major	Релігія	true
building_chains_chain_tooltip_mk_bch_religion_bogomilism_minor	Релігія	true
building_chains_encyclopedia_name_att_bch_celtic_farming	Поля	true
building_chains_encyclopedia_name_bel_bch_resources_gems	Самоцвіти	true
building_chains_chain_tooltip_mk_bch_nommigs_settlement	Поселення кочівників	true
building_chains_encyclopedia_name_cha_bch_lead	Виробництво свинцю	true
building_chains_chain_tooltip_cha_bch_blacksmith	Кузня	true
building_chains_encyclopedia_description_att_bch_all_agriculture	Сільськогосподарський ланцюжок містить споруди для землеробства і скотарства що збільшують виробництво їжі і дохід від сільського господарства.	true
building_chains_encyclopedia_name_mk_bch_itakingdoms_agriculture	Землеробство	true
building_chains_encyclopedia_description_att_bch_nomad_warriors	Військові споруди кочівників дозволяють наймати більшість видів військ доступних орду.	true
building_chains_encyclopedia_name_cha_bch_mosque	Мечеть	true
building_chains_encyclopedia_description_att_bch_resources_orchards_dummy	Ланцюжки ресурсів дозволяють використовувати цінні товари доступні в регіоні	true
building_chains_encyclopedia_name_att_bch_resources_wood	Дерево	true
building_chains_encyclopedia_name_bel_bch_resources_salt	Сіль	true
building_chains_encyclopedia_name_att_bch_resources_iron	Залізо	true
building_chains_encyclopedia_description_mk_bch_weskingdoms_agriculture	Сільськогосподарський ланцюжок містить споруди для землеробства і скотарства що збільшують виробництво їжі і дохід від сільського господарства.	true
building_chains_chain_tooltip_att_bch_nomad_city	Поселення кочівників	true
building_chains_encyclopedia_description_mk_bch_cenkingdoms_agriculture	Сільськогосподарський ланцюжок містить споруди для землеробства і скотарства що збільшують виробництво їжі і дохід від сільського господарства.	true
building_chains_encyclopedia_name_bel_bch_resources_gold	Золото	true
building_chains_encyclopedia_description_att_bch_roman_west_port_minor	Placeholder	true
building_chains_chain_tooltip_cha_bch_goldsmiths	Дім золотаря	true
building_chains_chain_tooltip_att_bch_eos_religion_judaism_major	Іудаїзм	true
building_chains_chain_tooltip_att_bch_eos_religion_judaism_minor	Іудаїзм	true
building_chains_encyclopedia_name_att_bch_resources_gold	Золото	true
building_chains_encyclopedia_name_att_bch_resources_silk	Шовк	true
building_chains_encyclopedia_description_mk_bch_afrkingdoms_agriculture	Сільськогосподарський ланцюжок містить споруди для землеробства і скотарства що збільшують виробництво їжі і дохід від сільського господарства.	true
building_chains_encyclopedia_name_att_bch_resources_salt	Сіль	true
building_chains_encyclopedia_name_bel_bch_resources_wood	Дерево	true
building_chains_encyclopedia_name_bel_bch_resources_iron	Залізо	true
building_chains_encyclopedia_description_cha_bch_madrasa	Медресе підвищують швидкість досліджень.	true
building_chains_chain_tooltip_att_bch_eastern_sassanid_city_major	Велике поселення	true
building_chains_encyclopedia_description_mk_bch_nomkingdoms_baba	Ланцюжок міського центру містить ринки палаци	true
building_chains_encyclopedia_name_att_bch_roman_west_port_minor	Порт	true
building_chains_encyclopedia_name_att_bch_resources_gems	Самоцвіти	true
building_chains_encyclopedia_description_cha_bch_siege_workshop	Ланцюжок майстерні облогових машин дозволяє будувати більш потужну техніку для штурму укріплень.	true
building_chains_chain_tooltip_att_bch_religion_catholic_legendary	Релігія	true
building_chains_chain_tooltip_att_slav_bch_religion_major	Релігія	true
building_chains_chain_tooltip_att_slav_bch_religion_minor	Релігія	true
building_chains_encyclopedia_description_mk_bch_crukingdoms_order	Будівлі для найму військ можна зводити в будь-яких містах або містечках. Вони дозволяють наймати більшість видів піхоти кінноти і стрільців.	true
building_chains_chain_tooltip_att_bch_barbarian_industry	Виробництво	true
building_chains_encyclopedia_name_att_bch_eos_religion_east_church_major	Східне християнство: місто	true
building_chains_encyclopedia_name_att_bch_eos_religion_east_church_minor	Східне християнство: містечко	true
building_chains_encyclopedia_description_mk_bch_mookingdoms_bedouin_camp	Placeholder description	true
building_chains_encyclopedia_description_mk_bch_easkingdoms_agriculture	Сільськогосподарський ланцюжок містить споруди для землеробства і скотарства що збільшують виробництво їжі і дохід від сільського господарства.	true
building_chains_encyclopedia_description_att_bch_roman_east_port_minor	Placeholder description	true
building_chains_encyclopedia_name_cha_bch_spring	Джерело	true
building_chains_chain_tooltip_att_bch_eastmigs_industry	Переселенці: ремесла	true
building_chains_chain_tooltip_mk_bch_nomkingdoms_military_armory	Військові поліпшення	true
building_chains_chain_tooltip_mk_bch_mookingdoms_military_armory	Військові поліпшення	true
building_chains_chain_tooltip_att_bch_religion_arian_legendary	Релігія	true
building_chains_encyclopedia_description_mk_bch_ibekingdoms_agriculture	Сільськогосподарський ланцюг містить споруди для землеробства і скотарства що збільшують виробництво їжі і дохід від сільського господарства.	true
building_chains_encyclopedia_name_mk_bch_crukingdoms_agriculture	Землеробство	true
building_chains_encyclopedia_name_mk_bch_ortkingdoms_agriculture	Землеробство	true
building_chains_encyclopedia_name_cha_bch_cloth_market	Ринок тканин	true
building_chains_chain_tooltip_mk_bch_slakingdoms_military_armory	Військові поліпшення	true
building_chains_encyclopedia_name_mk_bch_arakingdoms_agriculture	Землеробство	true
building_chains_encyclopedia_name_bel_bch_religion_catholic_major	Релігія: місто	true
building_chains_encyclopedia_name_bel_bch_religion_catholic_minor	Релігія: містечко	true
building_chains_encyclopedia_name_att_bch_roman_east_port_minor	Порт	true
building_chains_chain_tooltip_cha_bch_monastery	Монастир	true
building_chains_chain_tooltip_att_bch_eos_religion_semitic_major_faction	Семітське язичництво	true
building_chains_chain_tooltip_att_bch_eos_religion_semitic_minor_faction	Семітське язичництво	true
building_chains_chain_tooltip_att_bch_religion_orthodox_legendary	Релігія	true
building_chains_encyclopedia_description_mk_bch_easkingdoms_town	Ланцюжок містечка дозволяє зміцнювати оборонні споруди поселення а також підвищувати стабільність і зростання провінції.	true
building_chains_encyclopedia_description_mk_bch_weskingdoms_town	Ланцюжок містечка дозволяє зміцнювати оборонні споруди поселення а також підвищувати стабільність і зростання провінції.	true
building_chains_chain_tooltip_mk_bch_nommigs_community	Суспільство	true
building_chains_chain_tooltip_mk_bch_weskingdoms_castle	Поселення	true
building_chains_encyclopedia_description_mk_bch_slakingdoms_agriculture	Сільськогосподарський ланцюжок містить споруди для землеробства і скотарства що збільшують виробництво їжі і дохід від сільського господарства.	true
building_chains_encyclopedia_description_att_bch_all_military_upgrades	Ланцюжок військових поліпшень містить споруди що надають більш якісне спорядження для військ і дозволяють будувати облогові знаряддя.	true
building_chains_encyclopedia_description_bel_bch_all_military_upgrades	Ланцюжок військових поліпшень містить споруди що надають більш якісне спорядження для військ і дозволяють будувати облогові знаряддя.	true
building_chains_encyclopedia_description_att_bch_resources_port_regular	Для ланцюжка порту передбачено три варіанти розвитку. Рибальський варіант приносить додаткову їжу торговий - дохід	true
building_chains_chain_tooltip_mk_bch_ibekingdoms_military_armory	Військові поліпшення	true
building_chains_encyclopedia_description_bel_bch_roman_garrison	Гарнізонні споруди можна зводити тільки в столицях регіонів. Вони підвищують рівень громадського порядку і надають додаткові війська для оборони поселень.	true
building_chains_chain_tooltip_mk_bch_religion_ibadi_major	Релігія	true
building_chains_chain_tooltip_mk_bch_religion_ibadi_minor	Релігія	true
building_chains_encyclopedia_description_mk_bch_afrkingdoms_town	Ланцюжок містечка дозволяє зміцнювати оборонні споруди поселення а також підвищувати стабільність і зростання провінції.	true
building_chains_encyclopedia_description_cha_bch_marble	Ланцюжки ресурсів дозволяють використовувати цінні товари доступні в регіоні	true
building_chains_chain_tooltip_att_bch_religion_manichaeist_major	Релігія	true
building_chains_chain_tooltip_att_bch_religion_manichaeist_minor	Релігія	true
building_chains_encyclopedia_name_cha_bch_trader	Торговець	true
building_chains_chain_tooltip_mk_bch_religion_jewish_community_pol_major	Єврейська громада	true
building_chains_chain_tooltip_mk_bch_religion_jewish_community_pol_minor	Єврейська громада: місто	true
building_chains_chain_tooltip_bel_bch_camp_camp	Табір	true
building_chains_chain_tooltip_att_bch_eos_religion_semitic_major	Семітське язичництво	true
building_chains_chain_tooltip_att_bch_eos_religion_semitic_minor	Семітське язичництво	true
building_chains_encyclopedia_description_cha_bch_fields	Ланцюжок полів збільшує поставки їжі та дохід від сільського господарства залежно від родючості провінції.	true
building_chains_encyclopedia_description_mk_bch_nomkingdoms_yam	Задруга - це місце де збирається плем'я. Вона підвищує громадський порядок.	true
building_chains_encyclopedia_description_att_bch_easmigs_weapon_upgrade	Ланцюжок військових поліпшень містить споруди що надають більш якісне спорядження для військ і дозволяють будувати облогові знаряддя.	true
building_chains_encyclopedia_name_att_bch_eos_religion_east_church_major_faction	Східне християнство: місто	true
building_chains_encyclopedia_name_att_bch_eos_religion_east_church_minor_faction	Східне християнство: містечко	true
building_chains_encyclopedia_description_mk_bch_arakingdoms_bedouin_camp	Placeholder description	true
building_chains_encyclopedia_name_att_bch_all_military_upgrades	Військові поліпшення	true
building_chains_encyclopedia_name_bel_bch_all_military_upgrades	Військові поліпшення	true
building_chains_encyclopedia_description_bel_bch_roman_city_major	Ланцюжок міста дозволяє зміцнювати стіни столиці а також підвищувати стабільність і зростання провінції.	true
building_chains_encyclopedia_description_bel_bch_roman_city_minor	Ланцюжок містечка дозволяє зміцнювати оборонні споруди поселення а також підвищувати стабільність і зростання провінції.	true
building_chains_encyclopedia_name_bel_bch_religion_orthodox_major	Релігія: місто	true
building_chains_encyclopedia_name_bel_bch_religion_orthodox_minor	Релігія: містечко	true
building_chains_encyclopedia_description_mk_bch_mookingdoms_agriculture	Сільськогосподарський ланцюжок містить споруди для землеробства і скотарства що збільшують виробництво їжі і дохід від сільського господарства.	true
building_chains_encyclopedia_description_mk_bch_nomkingdoms_agriculture	Сільськогосподарський ланцюжок містить споруди для землеробства і скотарства що збільшують виробництво їжі і дохід від сільського господарства.	true
building_chains_encyclopedia_name_att_bch_resources_dyes	Фарби	true
building_chains_chain_tooltip_mk_bch_easkingdoms_military_armory	Військові поліпшення	true
building_chains_encyclopedia_description_cha_bch_library	Ланцюжок бібліотеки приносить дохід від культури і підвищує імперії вашої фракції.	true
building_chains_chain_tooltip_bel_bch_camp_food	Їжа	true
building_chains_encyclopedia_description_bel_bch_roman_military	Будівлі для найму військ можна зводити в будь-яких містах або містечках. Вони дозволяють наймати більшість видів піхоти кінноти і стрільців.	true
building_chains_encyclopedia_description_bel_bch_resources_port_regular	Для ланцюжка порту передбачено три варіанти розвитку. Рибальський варіант приносить додаткову їжу торговий - дохід	true
building_chains_encyclopedia_description_bel_bch_religion_arian_legendary	Будівлі релігійного ланцюжка посилюють вплив вашої віри у володіннях фракції та чужих землях а також можуть підвищувати рівень санітарії в поселеннях. Склад цього ланцюжка різниться залежно від державної релігії фракції	true
building_chains_chain_tooltip_mk_bch_slakingdoms_castle	Поселення	true
building_chains_encyclopedia_name_bel_bch_resources_lead	Свинець	true
building_chains_chain_tooltip_att_bch_resources_orchards	Виробництво вина	true
building_chains_chain_tooltip_mk_bch_afrkingdoms_military_armory	Військові поліпшення	true
building_chains_encyclopedia_description_att_bch_resources_furs	Ланцюжки ресурсів дозволяють використовувати цінні товари доступні в регіоні	true
building_chains_encyclopedia_name_att_bch_resources_pitch	Дьоготь	true
building_chains_encyclopedia_description_mk_bch_religion_bogomilism_major	Будівлі релігійного ланцюжка посилюють вплив вашої віри у володіннях фракції та чужих землях а також можуть підвищувати рівень санітарії в поселеннях. Склад цього ланцюжка різниться залежно від державної релігії фракції	true
building_chains_encyclopedia_description_mk_bch_religion_bogomilism_minor	Будівлі релігійного ланцюжка посилюють вплив вашої віри у володіннях фракції та на чужих землях а також можуть підвищувати рівень санітарії в поселеннях. Склад цього ланцюжка різниться залежно від державної релігії фракції	true
building_chains_encyclopedia_name_cha_bch_mill	Млин	true
building_chains_encyclopedia_name_cha_bch_gold	Виробництво золота	true
building_chains_chain_tooltip_att_bch_eastmigs_military	Кочова армія	true
building_chains_encyclopedia_name_cha_bch_salt	Виробництво солі	true
building_chains_encyclopedia_name_cha_bch_barracks_mus	Казарми	true
building_chains_encyclopedia_description_cha_bch_copper	Ланцюжки ресурсів дозволяють використовувати цінні товари доступні в регіоні	true
building_chains_encyclopedia_description_mk_bch_crukingdoms_town	Ланцюжок містечка дозволяє зміцнювати оборонні споруди поселення а також підвищувати стабільність і зростання провінції.	true
building_chains_encyclopedia_description_cha_bch_tavern	Ланцюжок таверни дозволяє наймати підглядників і асасинів.	true
building_chains_encyclopedia_name_cha_bch_iron	Виробництво заліза	true
building_chains_encyclopedia_name_cha_bch_wood	Виробництво дерева	true
building_chains_chain_tooltip_att_bch_eastern_sassanid_city_minor_generic	Мале поселення	true
building_chains_encyclopedia_name_att_bch_nomad_community	Громадські землі	true
building_chains_encyclopedia_name_att_bch_resources_lead	Свинець	true
building_chains_chain_tooltip_bel_bch_resources_orchards	Виробництво вина	true
building_chains_encyclopedia_description_mk_bch_ortkingdoms_town	Ланцюжок містечка дозволяє зміцнювати оборонні споруди поселення а також підвищувати стабільність і зростання провінції.	true
building_chains_encyclopedia_description_att_bch_celtic_farming	Варварські поля можна розташовувати в будь-яких містах або містечках. Вони виробляють їжу і приносять дохід від сільського господарства а також дозволяють наймати основні види військ.	true
building_chains_chain_tooltip_mk_bch_weskingdoms_military_armory	Військові поліпшення	true
building_chains_encyclopedia_name_cha_bch_mine	Рудник	true
building_chains_encyclopedia_name_cha_bch_wine	Виробництво вина	true
building_chains_encyclopedia_description_bel_bch_resources_furs	Ланцюжки ресурсів дозволяють використовувати цінні товари доступні в регіоні	true
building_chains_chain_tooltip_att_bch_eos_religion_judaism_major_faction	Іудаїзм	true
building_chains_chain_tooltip_att_bch_eos_religion_judaism_minor_faction	Іудаїзм	true
building_chains_chain_tooltip_mk_bch_cenkingdoms_military_armory	Військові поліпшення	true
building_chains_encyclopedia_name_mk_bch_arakingdoms_town	Місто	true
building_chains_encyclopedia_name_mk_bch_itakingdoms_town	Місто	true
building_chains_encyclopedia_name_mk_bch_slakingdoms_town	Місто	true
building_chains_encyclopedia_description_att_Slum	Placeholder description	true
building_chains_encyclopedia_description_mk_bch_cenkingdoms_water_major	Ланцюжок водопостачання для міста містить споруди для зберігання і розподілу води що збільшують запаси їжі	true
building_chains_encyclopedia_description_mk_bch_cenkingdoms_water_minor	Ланцюжок водопостачання для містечка дозволяє зводити споруди для зберігання і розподілу води що покращують громадський порядок	true
building_chains_encyclopedia_description_mk_bch_weskingdoms_water_major	Ланцюжок водопостачання для міста містить споруди для зберігання та розподілу води що збільшують запаси їжі	true
building_chains_encyclopedia_description_mk_bch_weskingdoms_water_minor	Ланцюжок водопостачання для містечка дозволяє зводити споруди для зберігання і розподілу води що поліпшують громадський порядок	true
building_chains_encyclopedia_description_att_bch_religion_orthodox_major	Будівлі релігійного ланцюжка посилюють вплив вашої віри у володіннях фракції та на чужих землях а також можуть підвищувати рівень санітарії в поселеннях. Склад цього ланцюжка різниться залежно від державної релігії фракції	true
building_chains_encyclopedia_description_att_bch_religion_orthodox_minor	Будівлі релігійного ланцюжка посилюють вплив вашої віри у володіннях фракції і чужих землях а також можуть підвищувати рівень санітарії в поселеннях. Склад цього ланцюжка різниться залежно від державної релігії фракції	true
building_chains_encyclopedia_name_att_bch_barbarian_city_minor_generic	Містечко	true
building_chains_chain_tooltip_cha_bch_wine_market	Винний ринок	true
building_chains_encyclopedia_name_mk_bch_mookingdoms_military_barracks	Найм військ	true
building_chains_encyclopedia_name_mk_bch_nomkingdoms_military_barracks	Найм військ	true
building_chains_encyclopedia_name_mk_bch_ortkingdoms_military_barracks	Найм військ	true
building_chains_encyclopedia_name_mk_bch_ibekingdoms_military_barracks	Найм військ	true
building_chains_encyclopedia_name_mk_bch_itakingdoms_military_barracks	Найм військ	true
building_chains_encyclopedia_name_mk_bch_easkingdoms_military_barracks	Найм військ	true
building_chains_encyclopedia_description_cha_bch_cloth	Ланцюжки ресурсів дозволяють використовувати цінні товари доступні в регіоні	true
building_chains_encyclopedia_description_mk_bch_slakingdoms_civic_major	Ланцюжок міського центру містить ринки палаци	true
building_chains_encyclopedia_description_mk_bch_slakingdoms_civic_minor	Ланцюжок центру містечка містить споруди що поліпшують громадський порядок або збільшують дохід від комерції та торгівлі.	true
building_chains_encyclopedia_name_mk_bch_afrkingdoms_military_barracks	Найм військ	true
building_chains_encyclopedia_name_mk_bch_arakingdoms_military_barracks	Найм військ	true
building_chains_encyclopedia_description_cha_bch_court_council	Ланцюжок суду справедливості зменшує рівень корупції у своїй та сусідніх провінціях.	true
building_chains_encyclopedia_name_mk_bch_cenkingdoms_military_barracks	Найм військ	true
building_chains_encyclopedia_name_att_bch_nomad_herders	Скотарство	true
building_chains_encyclopedia_name_cha_bch_olive	Виробництво оливок	true
building_chains_encyclopedia_name_mk_bch_weskingdoms_military_barracks	Найм військ	true
building_chains_encyclopedia_name_mk_bch_religion_tengri_major	Релігія	true
building_chains_encyclopedia_name_mk_bch_religion_tengri_minor	Релігія: місто	true
building_chains_encyclopedia_name_mk_bch_slakingdoms_military_barracks	Найм військ	true
building_chains_chain_tooltip_att_bch_eastmigs_community	Переселенці: суспільство	true
building_chains_encyclopedia_name_mk_bch_itakingdoms_water_major	Санітарія	true
building_chains_encyclopedia_name_mk_bch_itakingdoms_water_minor	Санітарія: місто	true
building_chains_encyclopedia_name_att_bch_resources_gold_dummy	Золото	true
building_chains_encyclopedia_name_mk_bch_nommigs_military	Найм військ	true
building_chains_chain_tooltip_cha_bch_scriptorium	Скрипторій	true
building_chains_encyclopedia_description_mk_bch_nomkingdoms_civic_major	Ланцюжок міського центру містить ринки палаци	true
building_chains_encyclopedia_description_mk_bch_nomkingdoms_civic_minor	Ланцюжок центру містечка містить споруди що покращують громадський порядок або збільшують дохід від комерції та торгівлі.	true
building_chains_encyclopedia_description_mk_bch_mookingdoms_civic_major	Ланцюжок міського центру містить ринки палаци	true
building_chains_encyclopedia_description_mk_bch_mookingdoms_civic_minor	Ланцюжок центру містечка містить споруди що поліпшують громадський порядок або збільшують дохід від комерції та торгівлі.	true
building_chains_chain_tooltip_att_slav_bch_wonder	Диво	true
building_chains_encyclopedia_description_att_bch_barbmigs_herding	Стада служать основним джерелом їжі для переселенців-варварів а також приносять дохід від скотарства.	true
building_chains_chain_tooltip_mk_bch_itakingdoms_industry_major	Виробництво	true
building_chains_chain_tooltip_mk_bch_itakingdoms_industry_minor	Виробництво: місто	true
building_chains_encyclopedia_description_att_bch_nomad_herders	Стада служать основним джерелом їжі для кочівників а також приносять дохід від скотарства.	true
building_chains_encyclopedia_description_cha_bch_olive	Ланцюжки ресурсів дозволяють використовувати цінні товари доступні в регіоні	true
building_chains_encyclopedia_name_mk_bch_religion_baltic_major	Релігія	true
building_chains_encyclopedia_name_mk_bch_religion_baltic_minor	Релігія: місто	true
building_chains_encyclopedia_name_cha_bch_cloth	Виробництво тканин	true
building_chains_chain_tooltip_cha_bch_barracks	Казарми	true
building_chains_encyclopedia_description_mk_bch_afrkingdoms_water_major	Ланцюжок водопостачання для міста містить споруди для зберігання і розподілу води що збільшують запаси їжі	true
building_chains_encyclopedia_description_mk_bch_afrkingdoms_water_minor	Ланцюг водопостачання для містечка дозволяє зводити споруди для зберігання і розподілу води що покращують громадський порядок	true
building_chains_encyclopedia_name_cha_bch_court_council	Суд справедливості	true
building_chains_chain_tooltip_mk_bch_ibekingdoms_industry_major	Виробництво	true
building_chains_chain_tooltip_mk_bch_ibekingdoms_industry_minor	Виробництво: місто	true
building_chains_chain_tooltip_cha_bch_race_track	Іподром	true
building_chains_encyclopedia_name_mk_bch_cenmigs_civic	Ринок	true
building_chains_encyclopedia_name_mk_bch_moomigs_civic	Ринок	true
building_chains_encyclopedia_name_mk_bch_religion_jewish_community_major	Єврейська громада	true
building_chains_encyclopedia_name_mk_bch_religion_jewish_community_minor	Єврейська громада: місто	true
building_chains_chain_tooltip_mk_bch_ortkingdoms_civic_major_cil	Громадський центр	true
building_chains_chain_tooltip_bel_bch_camp_market	Ринок	true
building_chains_encyclopedia_name_mk_bch_ibekingdoms_town	Місто	true
building_chains_encyclopedia_name_mk_bch_resources_silver	Срібло	true
building_chains_encyclopedia_description_mk_bch_religion_jewish_synagogue_major	Будівлі релігійного ланцюжка посилюють вплив вашої віри у володіннях фракції та на чужих землях а також можуть підвищувати рівень санітарії в поселеннях. Склад цього ланцюжка різниться залежно від державної релігії фракції	true
building_chains_encyclopedia_description_mk_bch_religion_jewish_synagogue_minor	Будівлі релігійного ланцюжка посилюють вплив вашої віри у володіннях фракції та на чужих землях а також можуть підвищувати рівень санітарії в поселеннях. Склад цього ланцюжка різниться залежно від державної релігії фракції	true
building_chains_encyclopedia_name_att_bch_resources_port_spices	Імпорт прянощів	true
building_chains_encyclopedia_description_mk_bch_easkingdoms_water_major	Ланцюжок водопостачання для міста містить споруди для зберігання і розподілу води що збільшують запаси їжі	true
building_chains_encyclopedia_description_mk_bch_easkingdoms_water_minor	Ланцюжок водопостачання для містечка дозволяє зводити споруди для зберігання і розподілу води що поліпшують громадський порядок	true
building_chains_chain_tooltip_att_bch_all_industry_major	Виробництво: місто	true
building_chains_chain_tooltip_att_bch_all_industry_minor	Виробництво: містечко	true
building_chains_encyclopedia_name_att_bch_eastmigs_city	Переселенці: поселення	true
building_chains_chain_tooltip_att_bch_barbmigs_settlement	Поселення кочівників	true
building_chains_encyclopedia_name_att_bch_religion_zoroastrian_major_fire	Релігія: місто	true
building_chains_encyclopedia_name_att_bch_nomad_artisan	Ремесла	true
building_chains_encyclopedia_name_mk_bch_slakingdoms_military_garrison	Гарнізон	true
building_chains_encyclopedia_name_mk_bch_weskingdoms_military_garrison	Гарнізон	true
building_chains_chain_tooltip_mk_bch_ortkingdoms_industry_major	Виробництво	true
building_chains_chain_tooltip_mk_bch_ortkingdoms_industry_minor	Виробництво: місто	true
building_chains_encyclopedia_name_mk_bch_afrkingdoms_military_garrison	Гарнізон	true
building_chains_encyclopedia_name_mk_bch_arakingdoms_military_garrison	Гарнізон	true
building_chains_encyclopedia_name_mk_bch_cenkingdoms_military_garrison	Гарнізон	true
building_chains_encyclopedia_name_mk_bch_easkingdoms_military_garrison	Гарнізон	true
building_chains_encyclopedia_name_mk_bch_ibekingdoms_military_garrison	Гарнізон	true
building_chains_encyclopedia_name_mk_bch_itakingdoms_military_garrison	Гарнізон	true
building_chains_encyclopedia_name_mk_bch_mookingdoms_military_garrison	Гарнізон	true
building_chains_encyclopedia_name_mk_bch_ortkingdoms_military_garrison	Гарнізон	true
building_chains_encyclopedia_name_mk_bch_nomkingdoms_military_garrison	Гарнізон	true
building_chains_encyclopedia_name_att_bch_religion_arian_major	Релігія: місто	true
building_chains_encyclopedia_name_att_bch_religion_arian_minor	Релігія: містечко	true
building_chains_encyclopedia_name_att_bch_religion_other	Релігія: містечко	true
building_chains_encyclopedia_name_mk_bch_cenmigs_barracks	Найм військ	true
building_chains_encyclopedia_name_cha_bch_fighter	Обитель бійців	true
building_chains_encyclopedia_name_cha_bch_hospice	Притулок	true
building_chains_chain_tooltip_att_bch_eastern_sassanid_military_infantry	Найм військ	true
building_chains_encyclopedia_description_att_bch_resources_port_spices	Ланцюжки ресурсів дозволяють використовувати цінні товари доступні в регіоні	true
building_chains_chain_tooltip_bel_bch_resources_marble	Виробництво мармуру	true
building_chains_chain_tooltip_att_bch_barbmigs_community	Суспільство	true
building_chains_encyclopedia_description_att_bch_eastmigs_city	Ланцюжок поселення містить основні споруди табору кочівників що забезпечують мінімальний добробут і зростання племені.	true
building_chains_encyclopedia_name_bel_bch_religion_other	Релігія: містечко	true
building_chains_encyclopedia_description_att_bch_religion_germanic_major	Споруди релігійного ланцюжка посилюють вплив вашої віри у володіннях фракції та на чужих землях а також можуть підвищувати рівень санітарії в поселеннях. Склад цього ланцюжка різниться залежно від державної релігії фракції	true
building_chains_encyclopedia_description_att_bch_religion_germanic_minor	Будівлі релігійного ланцюжка посилюють вплив вашої віри у володіннях фракції та на чужих землях а також можуть підвищувати рівень санітарії в поселеннях. Склад цього ланцюжка різниться залежно від державної релігії фракції	true
building_chains_encyclopedia_name_mk_bch_moomigs_barracks	Найм військ	true
building_chains_chain_tooltip_cha_bch_food_market	Продуктовий ринок	true
building_chains_encyclopedia_description_att_bch_resources_olives	Ланцюжки ресурсів дозволяють використовувати цінні товари доступні в регіоні	true
building_chains_chain_tooltip_cha_bch_garrison	Гарнізон	true
building_chains_encyclopedia_description_mk_bch_ibekingdoms_water_major	Ланцюжок водопостачання для міста містить споруди для зберігання і розподілу води що збільшують запаси їжі	true
building_chains_encyclopedia_description_mk_bch_ibekingdoms_water_minor	Ланцюжок водопостачання для містечка дозволяє зводити споруди для зберігання і розподілу води що поліпшують громадський порядок	true
building_chains_encyclopedia_description_att_bch_nomad_artisan	Ремісничі споруди кочівників приносять дохід від виробництва а також можуть сприяти зростанню населення або надавати покращене спорядження для військ.	true
building_chains_chain_tooltip_mk_bch_mookingdoms_industry_major	Виробництво	true
building_chains_chain_tooltip_mk_bch_mookingdoms_industry_minor	Виробництво: місто	true
building_chains_chain_tooltip_cha_bch_tengrism	Культ Тенгрі	true
building_chains_encyclopedia_name_mk_bch_arakingdoms_water_major	Санітарія: столиця	true
building_chains_encyclopedia_name_mk_bch_arakingdoms_water_minor	Санітарія: місто	true
building_chains_encyclopedia_name_mk_bch_ortkingdoms_water_major	Санітарія	true
building_chains_encyclopedia_name_mk_bch_ortkingdoms_water_minor	Санітарія: місто	true
building_chains_chain_tooltip_bel_bch_all_industry_major	Виробництво: місто	true
building_chains_chain_tooltip_bel_bch_all_industry_minor	Виробництво: містечко	true
building_chains_encyclopedia_description_mk_bch_cenkingdoms_civic_major	Ланцюжок міського центру містить ринки палаци	true
building_chains_encyclopedia_description_mk_bch_cenkingdoms_civic_minor	Ланцюжок центру містечка містить споруди що поліпшують громадський порядок або збільшують дохід від комерції та торгівлі.	true
building_chains_encyclopedia_description_att_bch_all_city_major	Ланцюжок міста дозволяє зміцнювати стіни столиці а також підвищувати стабільність і зростання провінції.	true
building_chains_encyclopedia_description_att_bch_all_city_minor	Ланцюжок містечка дозволяє зміцнювати оборонні споруди поселення а також підвищувати стабільність і зростання провінції.	true
building_chains_encyclopedia_description_mk_bch_weskingdoms_civic_major	Ланцюжок міського центру містить ринки палаци	true
building_chains_encyclopedia_description_mk_bch_weskingdoms_civic_minor	Ланцюжок центру містечка містить споруди що поліпшують громадський порядок або збільшують дохід від комерції та торгівлі.	true
building_chains_encyclopedia_description_mk_bch_religion_catharism_major	Будівлі релігійного ланцюжка посилюють вплив вашої віри у володіннях фракції та на чужих землях а також можуть підвищувати рівень санітарії в поселеннях. Склад цього ланцюжка різниться залежно від державної релігії фракції	true
building_chains_encyclopedia_description_mk_bch_religion_catharism_minor	Будівлі релігійного ланцюжка посилюють вплив вашої віри у володіннях фракції та на чужих землях а також можуть підвищувати рівень санітарії в поселеннях. Склад цього ланцюжка різниться залежно від державної релігії фракції	true
building_chains_chain_tooltip_mk_bch_crukingdoms_industry_major	Виробництво	true
building_chains_chain_tooltip_mk_bch_crukingdoms_industry_minor	Виробництво: місто	true
building_chains_encyclopedia_description_mk_bch_slakingdoms_water_major	Ланцюжок водопостачання для міста містить споруди для зберігання і розподілу води що збільшують запаси їжі	true
building_chains_encyclopedia_description_mk_bch_slakingdoms_water_minor	Ланцюжок водопостачання для містечка дозволяє зводити споруди для зберігання і розподілу води що покращують громадський порядок	true
building_chains_chain_tooltip_mk_bch_cenkingdoms_industry_major	Виробництво	true
building_chains_chain_tooltip_mk_bch_cenkingdoms_industry_minor	Виробництво: місто	true
building_chains_encyclopedia_name_mk_bch_itakingdoms_civic_major	Громадський центр	true
building_chains_encyclopedia_name_mk_bch_itakingdoms_civic_minor	Центр міста	true
building_chains_encyclopedia_description_att_bch_eastern_sassanid_military_minor	Будівлі для призову новобранців доступні тільки в столицях регіонів. Вони дозволяють наймати дешеві загони новобранців.	true
building_chains_encyclopedia_description_mk_bch_mookingdoms_water_major	Ланцюжок водопостачання для міста містить будівлі для зберігання і розподілу води що збільшують запаси їжі	true
building_chains_encyclopedia_description_mk_bch_mookingdoms_water_minor	Ланцюжок водопостачання для містечка дозволяє зводити споруди для зберігання і розподілу води що поліпшують громадський порядок	true
building_chains_encyclopedia_description_mk_bch_nomkingdoms_water_major	Ланцюжок водопостачання для міста містить споруди для зберігання та розподілу води що збільшують запаси їжі	true
building_chains_encyclopedia_description_mk_bch_nomkingdoms_water_minor	Ланцюжок водопостачання для містечка дозволяє зводити споруди для зберігання і розподілу води що поліпшують громадський порядок	true
building_chains_encyclopedia_name_att_bch_religion_zoroastrian_major_fire_faction	Релігія: місто	true
building_chains_encyclopedia_name_bel_bch_all_agriculture	Поля	true
building_chains_encyclopedia_description_mk_bch_religion_eastern_orthodox_major	Будівлі релігійного ланцюжка посилюють вплив вашої віри у володіннях фракції та на чужих землях а також можуть підвищувати рівень санітарії в поселеннях. Склад цього ланцюжка різниться залежно від державної релігії фракції	true
building_chains_encyclopedia_description_mk_bch_religion_eastern_orthodox_minor	Будівлі релігійного ланцюжка посилюють вплив вашої віри у володіннях фракції та на чужих землях а також можуть підвищувати рівень санітарії в поселеннях. Склад цього ланцюжка різниться залежно від державної релігії фракції	true
building_chains_chain_tooltip_mk_bch_arakingdoms_industry_major	Виробництво	true
building_chains_chain_tooltip_mk_bch_arakingdoms_industry_minor	Виробництво: місто	true
building_chains_chain_tooltip_mk_bch_afrkingdoms_industry_major	Виробництво	true
building_chains_chain_tooltip_mk_bch_afrkingdoms_industry_minor	Виробництво: місто	true
building_chains_encyclopedia_description_mk_bch_afrkingdoms_civic_major	Ланцюжок міського центру містить ринки палаци	true
building_chains_encyclopedia_description_mk_bch_afrkingdoms_civic_minor	Ланцюжок центру містечка містить споруди що поліпшують громадський порядок або збільшують дохід від комерції та торгівлі.	true
building_chains_encyclopedia_description_att_bch_resources_marble	Ланцюжки ресурсів дозволяють використовувати цінні товари доступні в регіоні	true
building_chains_encyclopedia_name_mk_bch_nomkingdoms_town	Місто	true
building_chains_encyclopedia_name_cha_bch_council	Зал ради	true
building_chains_encyclopedia_description_cha_bch_munya	Ланцюжок мунії дозволяє наймати підглядників і асасинів.	true
building_chains_encyclopedia_description_mk_bch_easkingdoms_civic_major	Ланцюжок міського центру містить ринки палаци	true
building_chains_encyclopedia_description_mk_bch_easkingdoms_civic_minor	Ланцюжок центру містечка містить споруди що поліпшують громадський порядок або збільшують дохід від комерції та торгівлі.	true
building_chains_encyclopedia_description_att_bch_roman_east_civic_major	Побудувавши в столиці фракції фінансову установу або резиденцію губернатора ви підвищите рівень громадського порядку. Крім того	true
building_chains_encyclopedia_description_att_bch_roman_west_civic_major	Побудувавши в столиці фракції монумент або резиденцію губернатора ви підвищите рівень громадського порядку. Крім того	true
building_chains_encyclopedia_description_att_bch_roman_west_civic_minor	Гарнізонні споруди можна зводити тільки в столицях регіонів. Вони підвищують рівень громадського порядку і надають додаткові війська для оборони поселень.	true
building_chains_encyclopedia_description_att_bch_religion_catholic_major	Будівлі релігійного ланцюжка посилюють вплив вашої віри у володіннях фракції та чужих землях а також можуть підвищувати рівень санітарії в поселеннях. Склад цього ланцюжка різниться залежно від державної релігії фракції	true
building_chains_encyclopedia_description_att_bch_religion_catholic_minor	Будівлі релігійного ланцюжка посилюють вплив вашої віри у володіннях фракції та на чужих землях а також можуть підвищувати рівень санітарії в поселеннях. Склад цього ланцюжка різниться залежно від державної релігії фракції	true
building_chains_encyclopedia_name_att_bch_barbarian_city_major	Місто	true
building_chains_encyclopedia_name_att_bch_celtic_garrison	Нальоти	true
building_chains_chain_tooltip_cha_bch_treasury	Скарб	true
building_chains_chain_tooltip_bel_bch_resources_olives	Виробництво оливок	true
building_chains_chain_tooltip_mk_bch_religion_shia_major	Релігія	true
building_chains_chain_tooltip_mk_bch_religion_shia_minor	Релігія	true
building_chains_encyclopedia_name_mk_bch_cenmigs_siege	Майстерня	true
building_chains_encyclopedia_name_mk_bch_moomigs_siege	Майстерня	true
building_chains_encyclopedia_name_mk_bch_mookingdoms_town	Місто	true
building_chains_encyclopedia_name_bel_bch_camp_sanitation	Санітарія	true
building_chains_chain_tooltip_cha_bch_paganism	Язичництво	true
building_chains_encyclopedia_name_cha_bch_munya	Мунья	true
building_chains_encyclopedia_name_mk_bch_resources_sugar	Цукрова тростина	true
building_chains_encyclopedia_description_att_bch_resources_marble_dummy	Ланцюжки ресурсів дозволяють використовувати цінні товари доступні в регіоні	true
building_chains_encyclopedia_name_mk_bch_cenkingdoms_town	Місто	true
building_chains_encyclopedia_description_mk_bch_ibekingdoms_civic_major	Ланцюжок міського центру містить ринки палаци	true
building_chains_encyclopedia_description_mk_bch_ibekingdoms_civic_minor	Ланцюжок центру містечка містить споруди що поліпшують громадський порядок або збільшують дохід від комерції та торгівлі.	true
building_chains_chain_tooltip_mk_bch_easkingdoms_industry_major	Виробництво	true
building_chains_chain_tooltip_mk_bch_easkingdoms_industry_minor	Виробництво: місто	true
building_chains_encyclopedia_name_mk_bch_arakingdoms_civic_major	Громадський центр	true
building_chains_encyclopedia_name_mk_bch_arakingdoms_civic_minor	Центр міста	true
building_chains_encyclopedia_name_att_bch_resources_iron_dummy	Залізо	true
building_chains_encyclopedia_name_mk_bch_crukingdoms_civic_major	Громадський центр	true
building_chains_encyclopedia_name_mk_bch_crukingdoms_civic_minor	Центр міста	true
building_chains_encyclopedia_name_mk_bch_ortkingdoms_civic_major	Громадський центр	true
building_chains_encyclopedia_name_mk_bch_ortkingdoms_civic_minor	Центр міста	true
building_chains_encyclopedia_name_mk_bch_arakingdoms_bedouin_camp	Поселення племені	true
building_chains_encyclopedia_description_mk_bch_moomigs_priest	Будівлі командирського ланцюжка дозволяють наймати агентів і приносять дохід вашій армії. Одна з її гілок також дозволяє прискорити дослідження.	true
building_chains_encyclopedia_name_mk_bch_cenkingdoms_water_major	Санітарія: столиця	true
building_chains_encyclopedia_name_mk_bch_cenkingdoms_water_minor	Санітарія: місто	true
building_chains_encyclopedia_name_mk_bch_weskingdoms_water_major	Санітарія	true
building_chains_encyclopedia_name_mk_bch_weskingdoms_water_minor	Санітарія: місто	true
building_chains_encyclopedia_description_cha_bch_barracks	Казарми можна будувати в будь-яких містах або містечках. Вони дозволяють наймати більшість видів піхоти кінноти і стрільців.	true
building_chains_encyclopedia_name_cha_bch_library	Бібліотека	true
building_chains_encyclopedia_description_mk_bch_itakingdoms_water_major	Ланцюжок водопостачання для міста містить споруди для зберігання і розподілу води що збільшують запаси їжі	true
building_chains_encyclopedia_description_mk_bch_itakingdoms_water_minor	Ланцюг водопостачання для містечка дозволяє зводити споруди для зберігання і розподілу води що покращують громадський порядок	true
building_chains_chain_tooltip_att_bch_barbmigs_herding	Скотарство	true
building_chains_encyclopedia_name_mk_bch_slakingdoms_civic_major	Громадський центр	true
building_chains_encyclopedia_name_mk_bch_slakingdoms_civic_minor	Центр міста	true
building_chains_encyclopedia_description_bel_bch_camp_officers	Будівлі командирського ланцюга дозволяють наймати агентів і приносять дохід вашій армії. Одна з її гілок також дозволяє прискорити дослідження.	true
building_chains_encyclopedia_description_bel_bch_religion_orthodox_major	Будівлі релігійного ланцюжка посилюють вплив вашої віри у володіннях фракції та чужих землях а також можуть підвищувати рівень санітарії в поселеннях. Склад цього ланцюжка різниться залежно від державної релігії фракції	true
building_chains_encyclopedia_description_bel_bch_religion_orthodox_minor	Будівлі релігійного ланцюжка посилюють вплив вашої віри у володіннях фракції та чужих землях а також можуть підвищувати рівень санітарії в поселеннях. Склад цього ланцюжка різниться залежно від державної релігії фракції	true
building_chains_encyclopedia_name_mk_bch_easkingdoms_town	Місто	true
building_chains_encyclopedia_name_mk_bch_weskingdoms_town	Місто	true
building_chains_encyclopedia_name_mk_bch_moomigs_priest	Священник	true
building_chains_encyclopedia_name_att_bch_eastern_sassanid_water_major	Водопостачання: місто	true
building_chains_encyclopedia_name_att_bch_eastern_sassanid_water_minor	Водопостачання: містечко	true
building_chains_encyclopedia_name_mk_bch_mookingdoms_civic_major	Громадський центр	true
building_chains_encyclopedia_name_mk_bch_mookingdoms_civic_minor	Центр міста	true
building_chains_encyclopedia_name_mk_bch_nomkingdoms_civic_major	Громадський центр	true
building_chains_encyclopedia_name_mk_bch_nomkingdoms_civic_minor	Центр міста	true
building_chains_chain_tooltip_att_Slum	Нетрі	true
building_chains_encyclopedia_name_mk_bch_afrkingdoms_town	Місто	true
building_chains_encyclopedia_description_mk_bch_religion_jewish_community_major	Ланцюжок міського центру містить ринки палаци	true
building_chains_encyclopedia_description_mk_bch_religion_jewish_community_minor	Ланцюжок центру містечка містить споруди що покращують громадський порядок або збільшують дохід від комерції та торгівлі.	true
building_chains_encyclopedia_name_bel_bch_camp_officers	Командири	true
building_chains_encyclopedia_name_mk_bch_afrkingdoms_water_major	Санітарія: столиця	true
building_chains_encyclopedia_name_mk_bch_afrkingdoms_water_minor	Санітарія: місто	true
building_chains_encyclopedia_description_bel_bch_resources_marble	Ланцюжки ресурсів дозволяють використовувати цінні товари доступні в регіоні	true
building_chains_chain_tooltip_att_bch_eastmigs_leadership	Переселенці: влада	true
building_chains_chain_tooltip_att_bch_barbmigs_leadership	Суспільство	true
building_chains_encyclopedia_name_mk_bch_crukingdoms_town	Місто	true
building_chains_chain_tooltip_att_bch_roman_water_major	Водопостачання: місто	true
building_chains_chain_tooltip_att_bch_roman_water_minor	Водопостачання: містечко	true
building_chains_chain_tooltip_bel_bch_roman_water_major	Санітарія: місто	true
building_chains_chain_tooltip_bel_bch_roman_water_minor	Санітарія: містечко	true
building_chains_encyclopedia_name_mk_bch_religion_jewish_synagogue_major	Релігія	true
building_chains_encyclopedia_name_mk_bch_religion_jewish_synagogue_minor	Релігія: місто	true
building_chains_encyclopedia_name_mk_bch_easkingdoms_water_major	Санітарія: столиця	true
building_chains_encyclopedia_name_mk_bch_easkingdoms_water_minor	Санітарія: місто	true
building_chains_encyclopedia_description_cha_bch_tengrism	Будівлі релігійного ланцюжка посилюють вплив вашої віри у володіннях фракції та на чужих землях.	true
building_chains_encyclopedia_description_cha_bch_garrison	Гарнізонні будівлі покращують громадський порядок і збільшують чисельність гарнізону що захищає поселення.	true
building_chains_encyclopedia_name_mk_bch_ortkingdoms_town	Місто	true
building_chains_chain_tooltip_att_bch_resources_olives	Виробництво оливок	true
building_chains_encyclopedia_description_att_bch_religion_other	Будівлі релігійного ланцюжка посилюють вплив вашої віри у володіннях фракції та на чужих землях а також можуть підвищувати рівень санітарії в поселеннях. Склад цього ланцюжка різниться залежно від державної релігії фракції	true
building_chains_chain_tooltip_att_bch_eastern_sassanid_military_cavalry	Найм військ	true
building_chains_encyclopedia_description_att_bch_nomad_community	Громадські землі приносять кочівникам дохід від комерції а також можуть сприяти виробництву їжі	true
building_chains_chain_tooltip_cha_bch_hall_elders	Зал старійшин	true
building_chains_encyclopedia_description_bel_bch_religion_other	Будівлі релігійного ланцюжка посилюють вплив вашої віри у володіннях фракції та на чужих землях а також можуть підвищувати рівень санітарії в поселеннях. Склад цього ланцюжка різниться залежно від державної релігії фракції	true
building_chains_encyclopedia_description_mk_bch_arakingdoms_water_major	Ланцюжок водопостачання для міста містить споруди для зберігання та розподілу води що збільшують запаси їжі	true
building_chains_encyclopedia_description_mk_bch_arakingdoms_water_minor	Ланцюжок водопостачання для містечка дозволяє зводити споруди для зберігання і розподілу води що поліпшують громадський порядок	true
building_chains_encyclopedia_description_mk_bch_ortkingdoms_water_major	Ланцюжок водопостачання для міста містить споруди для зберігання та розподілу води що збільшують запаси їжі	true
building_chains_encyclopedia_description_mk_bch_ortkingdoms_water_minor	Ланцюжок водопостачання для містечка дозволяє зводити споруди для зберігання і розподілу води що поліпшують громадський порядок	true
building_chains_encyclopedia_name_mk_bch_ibekingdoms_water_major	Санітарія: столиця	true
building_chains_encyclopedia_name_mk_bch_ibekingdoms_water_minor	Санітарія: місто	true
building_chains_encyclopedia_description_att_bch_resources_pitch	Ланцюжки ресурсів дозволяють використовувати цінні товари доступні в регіоні	true
building_chains_encyclopedia_name_cha_bch_madrasa	Медресе	true
building_chains_encyclopedia_name_cha_bch_minor	Містечко	true
building_chains_encyclopedia_description_bel_bch_camp_workshop	Будівлі ремісничого ланцюжка дозволяють покращувати загони що входять до складу армії	true
building_chains_encyclopedia_name_mk_bch_cenkingdoms_civic_major	Громадський центр	true
building_chains_encyclopedia_name_mk_bch_cenkingdoms_civic_minor	Центр міста	true
building_chains_encyclopedia_name_att_bch_all_city_major	Місто	true
building_chains_encyclopedia_name_att_bch_all_city_minor	Містечко	true
building_chains_encyclopedia_name_mk_bch_weskingdoms_civic_major	Громадський центр	true
building_chains_encyclopedia_name_mk_bch_weskingdoms_civic_minor	Центр міста	true
building_chains_encyclopedia_name_mk_bch_nomkingdoms_baba	Кам'яні баби	true
building_chains_encyclopedia_description_mk_bch_itakingdoms_civic_major	Ланцюжок міського центру містить ринки палаци	true
building_chains_encyclopedia_description_mk_bch_itakingdoms_civic_minor	Ланцюжок центру містечка містить споруди що покращують громадський порядок або збільшують дохід від комерції та торгівлі.	true
building_chains_chain_tooltip_mk_bch_slakingdoms_industry_major	Виробництво	true
building_chains_chain_tooltip_mk_bch_slakingdoms_industry_minor	Виробництво: місто	true
building_chains_encyclopedia_name_cha_bch_church_school	Церковна школа	true
building_chains_encyclopedia_name_mk_bch_slakingdoms_water_major	Санітарія	true
building_chains_encyclopedia_name_mk_bch_slakingdoms_water_minor	Санітарія: місто	true
building_chains_chain_tooltip_att_bch_religion_grecoroman_major	Релігія	true
building_chains_chain_tooltip_att_bch_religion_grecoroman_minor	Релігія	true
building_chains_chain_tooltip_att_bch_eos_pleasure_major	Будинки розваг	true
building_chains_chain_tooltip_bel_bch_religion_grecoroman_major	Релігія	true
building_chains_chain_tooltip_bel_bch_religion_grecoroman_minor	Релігія	true
building_chains_encyclopedia_name_bel_bch_camp_military	Набір військ	true
building_chains_chain_tooltip_cha_bch_bismaristan	Бімарістан	true
building_chains_encyclopedia_name_att_bch_all_agriculture	Поля	true
building_chains_encyclopedia_name_att_bch_eastern_sassanid_civic_major	Центр міста	true
building_chains_encyclopedia_name_att_bch_eastern_sassanid_civic_minor	Центр містечка	true
building_chains_encyclopedia_description_cha_bch_minor	Ланцюжок містечка дозволяє зміцнювати оборонні споруди поселення а також підвищувати стабільність і зростання провінції.	true
building_chains_encyclopedia_name_mk_bch_nomkingdoms_water_major	Санітарія	true
building_chains_encyclopedia_name_mk_bch_nomkingdoms_water_minor	Санітарія: місто	true
building_chains_encyclopedia_name_mk_bch_mookingdoms_water_major	Санітарія	true
building_chains_encyclopedia_name_mk_bch_mookingdoms_water_minor	Санітарія: місто	true
building_chains_encyclopedia_name_bel_bch_camp_workshop	Майстерня	true
building_chains_encyclopedia_description_cha_bch_church_school	Церковні школи підвищують швидкість досліджень.	true
building_chains_encyclopedia_name_mk_bch_religion_eastern_orthodox_major	Релігія	true
building_chains_encyclopedia_name_mk_bch_religion_eastern_orthodox_minor	Релігія: місто	true
building_chains_encyclopedia_description_bel_bch_camp_military	Ланцюжок набору військ дозволяє наймати загони безпосередньо в армії що знаходиться в поході.	true
building_chains_encyclopedia_name_mk_bch_afrkingdoms_civic_major	Громадський центр	true
building_chains_encyclopedia_name_mk_bch_afrkingdoms_civic_minor	Центр міста	true
building_chains_encyclopedia_description_cha_bch_paganism	Будівлі релігійного ланцюжка посилюють вплив вашої віри у володіннях фракції та на чужих землях.	true
building_chains_chain_tooltip_mk_bch_cenmigs_main	Табір	true
building_chains_chain_tooltip_bel_bch_roman_civic_major	Центр міста	true
building_chains_chain_tooltip_att_bch_roman_civic_major	Центр міста	true
building_chains_encyclopedia_name_att_bch_roman_east_civic_major	Управління	true
building_chains_encyclopedia_name_att_bch_roman_west_civic_major	Управління	true
building_chains_encyclopedia_name_att_bch_roman_west_civic_minor	Гарнізон	true
building_chains_encyclopedia_name_mk_bch_cenmigs_priest	Священник	true
building_chains_encyclopedia_name_mk_bch_easkingdoms_civic_major	Громадський центр	true
building_chains_encyclopedia_name_mk_bch_easkingdoms_civic_minor	Центр міста	true
building_chains_chain_tooltip_mk_bch_moomigs_main	Табір	true
building_chains_chain_tooltip_mk_bch_weskingdoms_industry_major	Виробництво	true
building_chains_chain_tooltip_mk_bch_weskingdoms_industry_minor	Виробництво: місто	true
building_chains_encyclopedia_description_bel_bch_religion_catholic_major	Будівлі релігійного ланцюжка посилюють вплив вашої віри у володіннях фракції та на чужих землях а також можуть підвищувати рівень санітарії в поселеннях. Склад цього ланцюжка різниться залежно від державної релігії фракції	true
building_chains_encyclopedia_description_bel_bch_religion_catholic_minor	Будівлі релігійного ланцюжка посилюють вплив вашої віри у володіннях фракції та на чужих землях а також можуть підвищувати рівень санітарії в поселеннях. Склад цього ланцюжка різниться залежно від державної релігії фракції	true
building_chains_encyclopedia_name_bel_bch_religion_arian_major	Релігія: місто	true
building_chains_encyclopedia_name_bel_bch_religion_arian_minor	Релігія: містечко	true
building_chains_encyclopedia_name_mk_bch_mookingdoms_bedouin_camp	Поселення племені	true
building_chains_chain_tooltip_mk_bch_ortkingdoms_military_garrison_serbia	Гарнізон	true
building_chains_encyclopedia_description_mk_bch_resources_sugar	Ланцюжки ресурсів дозволяють використовувати цінні товари доступні в регіоні	true
building_chains_encyclopedia_description_mk_bch_cenmigs_priest	Будівлі командирського ланцюжка дозволяють наймати агентів і приносять дохід вашій армії. Одна з її гілок також дозволяє прискорити дослідження.	true
building_chains_chain_tooltip_att_bch_resources_marble	Виробництво мармуру	true
building_chains_encyclopedia_name_att_bch_resources_marble_dummy	Камінь	true
building_chains_encyclopedia_name_mk_bch_moomigs_smith	Військові поліпшення	true
building_chains_encyclopedia_name_mk_bch_cenmigs_smith	Військові поліпшення	true
building_chains_encyclopedia_description_cha_bch_treasury	Скарбниця збільшує дохід у своїй та сусідніх провінціях.	true
building_chains_encyclopedia_description_bel_bch_resources_olives	Ланцюжки ресурсів дозволяють використовувати цінні товари доступні в регіоні	true
building_chains_encyclopedia_description_mk_bch_arakingdoms_civic_major	Ланцюжок міського центру містить ринки палаци	true
building_chains_encyclopedia_description_mk_bch_arakingdoms_civic_minor	Ланцюжок центру містечка містить споруди що поліпшують громадський порядок або збільшують дохід від комерції та торгівлі.	true
building_chains_encyclopedia_description_mk_bch_crukingdoms_civic_major	Ланцюжок міського центру містить ринки палаци	true
building_chains_encyclopedia_description_mk_bch_crukingdoms_civic_minor	Ланцюжок центру містечка містить споруди що поліпшують громадський порядок або збільшують дохід від комерції та торгівлі.	true
building_chains_encyclopedia_description_mk_bch_ortkingdoms_civic_major	Ланцюжок міського центру містить ринки палаци	true
building_chains_encyclopedia_description_mk_bch_ortkingdoms_civic_minor	Ланцюжок центру містечка містить споруди що поліпшують громадський порядок або збільшують дохід від комерції та торгівлі.	true
building_chains_encyclopedia_name_mk_bch_ibekingdoms_civic_major	Громадський центр	true
building_chains_encyclopedia_name_mk_bch_ibekingdoms_civic_minor	Центр міста	true
building_chains_encyclopedia_name_att_bch_barbarian_port_minor	Порт	true
