key	text	tooltip
#Loc;1;text/db/campaign_localised_strings.loc		
campaign_localised_strings_string_unit_exchange_commanders_invalid	Армії не обмінюються командирами.	true
campaign_localised_strings_string_public_order_rebellion_next_turn	За поточного стану справ повстання почнеться наступного ходу!	true
campaign_localised_strings_string_cha_faction_wales	Уельс	true
campaign_localised_strings_string_military_force_morale_bonus_value_politics	Політика	true
campaign_localised_strings_string_force_not_in_correct_stance_not_enough_ap	Ця армія не є осілою і не має достатнього запасу очок дій для переходу в цей стан.	true
campaign_localised_strings_string_military_force_growth_tax	Податок	true
campaign_localised_strings_string_politics_character_cannot_become_governor_wounded	Цей персонаж не зможе стати губернатором, поки не залікує рани.	true
campaign_localised_strings_string_events_attrition_summary_location	Провінція:	true
campaign_localised_strings_string_MPC_cannot_construct_not_your_turn	[[col:red]]Ви не можете зводити споруди під час ходу іншої фракції.[[/col]]	true
campaign_localised_strings_string_politics_character_regent	Регент	true
campaign_localised_strings_string_end_turn_warning_public_order_low	Рівень громадського порядку в цій провінції небезпечно низький:	true
campaign_localised_strings_string_province_fertility_factor_buildings	Фракція або споруди	true
campaign_localised_strings_string_military_history_battles_victory_decisive	Рішуча перемога над:	true
campaign_localised_strings_string_politics_assign_governor	Клацніть ЛКМ, щоб призначити персонажа на цю посаду.	true
campaign_localised_strings_string_cha_mission_pope_attacked_1	Направте персонажа, в оточення якого входить папа римський, в регіон Рим.	true
campaign_localised_strings_string_recruit_assassin_tooltip	Найняти таємного вбивцю||Таємні вбивці спеціалізуються на усуненні ворожих полководців і агентів. Крім того, вони можуть навчати воїнів своєму мистецтву і виснажувати ворожі армії.	true
campaign_localised_strings_string_details_panel_skills_cannot_select	Цей персонаж не може освоїти цю навичку:	true
campaign_localised_strings_string_raise_navy_capped	Неможливо створити флот.||У вас недостатньо імперіуму.	true
campaign_localised_strings_string_raise_legacy_capped	Неможливо відновити спадщину.||У вас недостатньо імперіуму.	true
campaign_localised_strings_string_end_turn_warning_not_researching	Зараз ви не досліджуєте жодних технологій.	true
campaign_localised_strings_string_military_force_growth_technologies	Технології	true
campaign_localised_strings_string_development_points_tooltip_hordes_insufficent_development_points_number_expedition	Необхідний надлишок населення: %n.||Ваша експедиція зросте з часом. Щоб прискорити її зростання, здійснюйте набіги, розбивайте табори і зводите певні споруди.	true
campaign_localised_strings_string_province_fertility_factor_climate	Клімат	true
campaign_localised_strings_string_development_points_tooltip_hordes_growth	Населення орди поступово зростає. Його надлишок можна використовувати для посилення існуючої орди або створення нової.	true
campaign_localised_strings_string_imperium_01_description	Ви поки що не впливаєте майже ні на що... але це поки що!	true
campaign_localised_strings_string_military_force_morale_bonus_value_foreign_territory	Ворожа територія	true
campaign_localised_strings_string_imperium_02_description	Ви зайняли гідне місце в світі.	true
campaign_localised_strings_string_character_type_wife	Дружина	true
campaign_localised_strings_string_imperium_03_description	Слава про ваші успіхи розноситься по всьому світу.	true
campaign_localised_strings_string_imperium_04_description	Ваші досягнення увійшли в легенди.	true
campaign_localised_strings_string_imperium_05_description	Ваша могутність вселяє заздрість і страх.	true
campaign_localised_strings_string_imperium_06_description	Світ тремтить перед вами.	true
campaign_localised_strings_string_imperium_07_description	Ви досягли найвищої могутності.	true
campaign_localised_strings_string_public_order_food_tooltip	Їжа	true
campaign_localised_strings_string_military_history_battles	Всі битви:	true
campaign_localised_strings_string_building_restriction_bel_bld_all_resources_olives_4	Для доступу до цієї споруди вам потрібно контролювати всі 4 регіони, в яких є оливки, і звести в кожному з них по споруді з ланцюжка відповідного ресурсу.	true
campaign_localised_strings_string_politics_power_support_popular_description	Панування - це міра вашого впливу на свою фракцію і свій народ. Ця характеристика залежить від того, наскільки впливові члени вашої родини в порівнянні з іншими політичними силами фракції.\\n\\nПоєднання панування і контролю визначає загальний рівень влади вашої родини.	true
campaign_localised_strings_string_politics_cannot_assign_age	Цей персонаж ще не досяг віку, в якому можна стати губернатором.	true
campaign_localised_strings_string_military_force_morale_unit_transfer	Переведення загонів	true
campaign_localised_strings_string_recruitment_hire_from_horde	Найняти з орди	true
campaign_localised_strings_string_public_order_taxes_tooltip	Люди радіють низьким податкам, а не високим.	true
campaign_localised_strings_string_public_order_other_tooltip	Від вашої реакції на дилеми та події залежить ставлення ваших підданих.	true
campaign_localised_strings_string_province_contested	Спірна провінція	true
campaign_localised_strings_string_politics_ministerial_position_required_rank	Необхідний ранг:	true
campaign_localised_strings_string_details_panel_skills_cannot_no_skill_points	Немає очок навичок.	true
campaign_localised_strings_string_unit_upgrade_multiple_units	Клацніть ЛКМ, щоб поліпшити всі вибрані загони.	true
campaign_localised_strings_string_raise_force_reinstate_cannot_no_legacies	[[col:red]]У вас немає військової спадщини, яку можна було б відновити.[[/col]]	true
campaign_localised_strings_string_politics_power_support_political_current	Поточний контроль:	true
campaign_localised_strings_string_att_eos_religious_mission_build_att_rel_semitic_paganism	Зведіть 4 споруди семітського язичництва, не будуючи інших релігійних будівель.	true
campaign_localised_strings_string_public_order_other	Інше	true
campaign_localised_strings_string_public_order_taxes	Податки	true
campaign_localised_strings_string_politics_action_impossible_target_retainer_rank_too_high	[[col:red]]Слугою може стати тільки персонаж з нижчим рангом.[[/col]]	true
campaign_localised_strings_string_cha_faction_saxon_kingdom	Королівство саксів	true
campaign_localised_strings_string_unit_details_rank	Ранг:	true
campaign_localised_strings_string_military_history_battles_defeat_decisive	Важка поразка від:	true
campaign_localised_strings_string_raise_force_navy_no_surplus	Не вдалося створити флот.||У вас немає достатнього надлишку населення.	true
campaign_localised_strings_string_zeal_desc	Захист від дій агента, що знижують завзяття.	true
campaign_localised_strings_string_military_force_morale_faction_leader_died	Занепокоєння	true
campaign_localised_strings_string_raise_army_besieged	Неможливо створити армію.||Це поселення в облозі.	true
campaign_localised_strings_string_public_order_food	Їжа	true
campaign_localised_strings_string_politics_action_impossible_target_underage	[[col:red]]Неповнолітні персонажі не можуть брати участь у політичних діях.[[/col]]	true
campaign_localised_strings_string_cannot_migrate_no_armies	Ваш народ не може переселятися без армії.	true
campaign_localised_strings_string_politics_character_status_scheming	Плете інтриги	true
campaign_localised_strings_string_politics_character_status_deceased	Покійн.	true
campaign_localised_strings_string_events_attrition_summary_men_lost	Втрачено людей:	true
campaign_localised_strings_string_military_force_growth_core	Будівлі та їжа	true
campaign_localised_strings_string_public_order_deteriorating	Рівень громадського порядку знижується.	true
campaign_localised_strings_string_unit_upgrade_single_unit	ЛКМ - поліпшити обраний загін. Результат:	true
campaign_localised_strings_string_character_mentor_of	Цей персонаж є наставником:	true
campaign_localised_strings_string_politics_action_impossible_target_candidate	[[col:red]]Ви не можете вживати політичних дій проти кандидатів.[[/col]]	true
campaign_localised_strings_string_building_restriction_bel_bld_all_resources_marble_4	Для доступу до цієї споруди вам потрібно контролювати всі 4 регіони, в яких є мармур, і звести в кожному з них по споруді з ланцюжка відповідного ресурсу.	true
campaign_localised_strings_string_details_panel_ancillary_wife_empty	У цього персонажа немає дружини. Ваші персонажі можуть отримувати пропозиції про шлюб від інших партій, а ви самі можете влаштовувати шлюби між вашими персонажами і персонажами з інших фракцій. Все це вплине на політичну ситуацію.	true
campaign_localised_strings_string_politics_character_status_wounded	Поранення	true
campaign_localised_strings_string_public_order_breakdown_rebellion	Бунтівники виступили	true
campaign_localised_strings_string_military_history_battles_victory_phyrric	Піррова перемога над:	true
campaign_localised_strings_string_military_force_morale_lost_battle	Битва програна	true
campaign_localised_strings_string_politics_event_assassination_wife_success	Замах на його дружину пройшов успішно!	true
campaign_localised_strings_string_religion_factor_province	Місцеві традиції	true
campaign_localised_strings_string_end_turn_warning_siege_no_equipment	Ви намагаєтеся брати в облогу поселення без облогових знарядь.	true
campaign_localised_strings_string_other_nobles_candidates_description	Кандидатами називаються персонажі, які поки не беруть активної участі в справах вашої фракції.||При необхідності ви можете довірити одному з них командування армією або губернаторський пост.\\n\\n[[col:yellow]]Їхній вплив не враховується в політиці фракції, а вірність може змінюватися тільки після отримання посади.[[/col]]	true
campaign_localised_strings_string_details_panel_skills_select	Цей персонаж може вивчити додаткову навичку.\\nКлацніть ЛКМ на навичку, щоб освоїти її.	true
campaign_localised_strings_string_politics_character_not_politician	[[col:red]]Тільки державні діячі можуть ставати губернаторами.[[/col]]	true
campaign_localised_strings_string_info_panel_effect_summary_general	Вплив полководця	true
campaign_localised_strings_string_recruitment_unavailable_incorrect_stance	У цьому режимі найм військ неможливий.	true
campaign_localised_strings_string_public_order_breakdown_rebellion_tooltip	Повстання	true
campaign_localised_strings_string_politics_action_possible	Ця політична дія дасть результат на початку наступного ходу.	true
campaign_localised_strings_string_politics_event_assassination_wife	Замах на дружину!	true
campaign_localised_strings_string_unit_upgrade_description	Покращує зброю або обладунки загону.	true
campaign_localised_strings_string_end_turn_warning_legacy_skill_to_be_picked	У цього війська є не присвоєна традиція:	true
campaign_localised_strings_string_growth_characters	Персонажі	true
campaign_localised_strings_string_raise_army_capped	Неможливо створити армію.||У вас недостатньо імперіуму.	true
campaign_localised_strings_string_politics_character_joined_your_family_from	Цей персонаж перейшов до вашої родини з наступної фракції:	true
campaign_localised_strings_string_cha_mission_avars_1	Розоріть 5 поселень.	true
campaign_localised_strings_string_details_panel_character_age	Епоха:	true
campaign_localised_strings_string_politics_action_impossible	Ця політична дія не може бути виконана:	true
campaign_localised_strings_string_recruitment_hire_mercenary	Найняти найманців	true
campaign_localised_strings_string_unit_upgrade_retrain_multiple_units	ЛКМ - перенавчити всі вибрані загони.	true
campaign_localised_strings_string_unit_upgrade_retrain_description	Заміна загону на більш досконалий.	true
campaign_localised_strings_string_cannot_migrate_under_siege	Ваш народ не може переселятися, якщо одне з ваших поселень знаходиться в облозі або під блокадою.	true
campaign_localised_strings_string_abandoned_region_rebel_faction_name	Закинуто	true
campaign_localised_strings_string_sea_region_control_status_replenishment_rate_mod_garrisoned	(+%d%% в портах)	true
campaign_localised_strings_string_military_history_defeats	Поразки:	true
campaign_localised_strings_string_unit_upgrade_retrain_single_unit	ЛКМ - перенавчити обраний загін. Результат:	true
campaign_localised_strings_string_cha_faction_avar_khaganate	Аварський каганат	true
campaign_localised_strings_string_sanitation_tooltip_header	Санітарія та забруднення	true
campaign_localised_strings_string_force_not_on_land	Щоб отримати можливість зводити споруди, накажіть своїй орді висадитися на сушу.	true
campaign_localised_strings_string_public_order_units	Загони	true
campaign_localised_strings_string_military_force_morale_idle	Відпочинок	true
campaign_localised_strings_string_sea_region_control_status_replenishment_rate_mod	Поповнення флоту: +%d%%	true
campaign_localised_strings_string_battle_ambush_you_success	Ворог не помітив вашу засідку. Атакуйте зараз - елемент несподіванки зіграє вам на руку!	true
campaign_localised_strings_string_raise_force_army_no_surplus	Не вдалося створити армію.||У вас немає достатнього надлишку населення.	true
campaign_localised_strings_string_politics_has_not_attained_office	Цей персонаж раніше не обіймав достатньо високої посади, щоб бути призначеним на цю.	true
campaign_localised_strings_string_military_force_morale_bonus_value_military_force	Армія	true
campaign_localised_strings_string_politics_event_assassination_wife_wounded	Його дружина була просто поранена.	true
campaign_localised_strings_string_details_panel_skills_unlocked_rank	Відкривається при ранзі:	true
campaign_localised_strings_string_military_force_morale_casualties	Зазнані втрати	true
campaign_localised_strings_string_military_history_commanders	Командири:	true
campaign_localised_strings_string_events_attrition_summary_force_navy	Флот:	true
campaign_localised_strings_string_military_force_growth_characters	Персонажі	true
campaign_localised_strings_string_public_order_celebration_next_turn	За поточного стану справ святкування розпочнеться наступного ходу!	true
campaign_localised_strings_string_religion_factor_buildings	Розвиток регіонів	true
campaign_localised_strings_string_military_history_victories	Перемоги:	true
campaign_localised_strings_string_raise_navy_no_port	Неможливо створити флот.||У цьому поселенні немає порту.	true
campaign_localised_strings_string_politics_cursus_next_level	Наступний рівень	true
campaign_localised_strings_string_tooltip_loyalty_description	Відданість персонажа справі вашої фракції. Якщо вірність впаде до нуля, персонаж розв'яже громадянську війну.	true
campaign_localised_strings_string_politics_event_blackmail_success	Його репутація заплямована плітками.	true
campaign_localised_strings_string_cha_faction_english_kingdom	Королівство Англія	true
campaign_localised_strings_string_public_order_technologys	Технології	true
campaign_localised_strings_string_recruitment_levy_from_client_state	Новобранці з держави-данника	true
campaign_localised_strings_string_migrate_button_selected_expedition	Всі поселення вашої країни будуть покинуті. [ЛКМ - скасування]	true
campaign_localised_strings_string_building_restriction_bel_bld_all_resources_lead_4	Для доступу до цієї споруди вам потрібно контролювати всі 3 регіони, в яких є свинець, і звести в кожному з них по споруді з ланцюжка відповідного ресурсу.	true
campaign_localised_strings_string_raise_army_no_funds	Неможливо створити армію.||У вас недостатньо грошей.	true
campaign_localised_strings_string_cannot_migrate_already_migrating_expedition	Ви вже почали переселення.	true
campaign_localised_strings_string_raise_navy_no_funds	Неможливо створити флот.||У вас недостатньо грошей.	true
campaign_localised_strings_string_politics_event_blackmail	Спроба шантажу!	true
campaign_localised_strings_string_politics_event_choice_invalid_insufficient_gravitas	Цей персонаж не має достатнього впливу для цієї дії.	true
campaign_localised_strings_string_public_order_technologys_tooltip	Освічені піддані - щасливі піддані.	true
campaign_localised_strings_string_development_points_tooltip_hordes	Надлишок населення||Щоб орда ставала більшою і сильнішою, їй потрібні люди. Надлишок населення можна використовувати як для посилення існуючої орди, так і для створення нових. Для зростання орди вкрай важливі табори і набіги.	true
campaign_localised_strings_string_military_force_morale_bonus_value_fortify_stance	Укріплення	true
campaign_localised_strings_string_cha_faction_ireland	Ірландія	true
campaign_localised_strings_string_politics_action_impossible_actor_not_male	[[col:red]]Цю дію можуть виконувати тільки чоловіки.[[/col]]	true
campaign_localised_strings_string_public_order_stabilising	Громадський порядок стабілізується.	true
campaign_localised_strings_string_migrate_button_active_expedition	Почавши переселення, ви покинете всі поселення своєї країни і перетворите армії на орди.	true
campaign_localised_strings_string_edicts_incoming_description	[[col:green]]Цей едикт набере чинності на початку наступного ходу.[[/col]]	true
campaign_localised_strings_string_building_restriction_bel_bld_all_resources_iron_4	Для доступу до цієї споруди вам потрібно контролювати всі 5 регіонів, в яких є залізо, і звести в кожному з них по споруді з ланцюжка відповідного ресурсу.	true
campaign_localised_strings_string_politics_character_not_your_faction	Ви не можете вживати заходів проти персонажів, які не входять до вашої родини.	true
campaign_localised_strings_string_force_not_in_correct_stance	Для будівництва орда повинна зупинитися. Віддавши цей наказ, ви накажете їй стати табором.	true
campaign_localised_strings_string_raise_army	Створити армію.||Створіть нове військо і призначте полководця, який буде ним командувати.	true
campaign_localised_strings_string_politics_action_impossible_actor_married	[[col:red]]Цей персонаж вже перебуває у шлюбі.[[/col]]	true
campaign_localised_strings_string_confirm_cancel_migration	Ви дійсно хочете скасувати переселення?	true
campaign_localised_strings_string_politics_action_make_heir_heading	[[col:yellow]]Оголосити спадкоємця[[/col]]	true
campaign_localised_strings_string_public_order_celebration	За поточного стану справ свято відбудеться через %n х.	true
campaign_localised_strings_string_public_order_devastation_tooltip	Руйнування тягнуть за собою загибель людей, і, що ще гірше, невдоволення.	true
campaign_localised_strings_string_public_order_plague	Хвороба	true
campaign_localised_strings_string_building_restriction_bel_bld_all_resources_gems_4	Для доступу до цієї споруди вам потрібно контролювати всі 3 регіони, в яких є самоцвіти, і звести в кожному з них споруду з ланцюжка відповідного ресурсу.	true
campaign_localised_strings_string_building_restriction_bel_bld_all_resources_gold_4	Для доступу до цієї споруди вам потрібно контролювати обидва регіони, в яких є золото, і звести в кожному з них споруду з ланцюжка відповідного ресурсу.	true
campaign_localised_strings_string_unit_upgrade_header	Поліпшити	true
campaign_localised_strings_string_politics_action_impossible_actor_already_a_retainer	[[col:red]]Цей персонаж вже є слугою.[[/col]]	true
campaign_localised_strings_string_politics_event_assassination_wife_killed	Їм не вдалося вбити його, проте вони вбили його дружину!	true
campaign_localised_strings_string_public_order_culture_differences	Питання віри	true
campaign_localised_strings_string_building_restriction_bel_bld_all_resources_furs_4	Для доступу до цієї споруди вам потрібно контролювати всі 4 регіони, в яких є хутро, і звести в кожному з них споруду з ланцюжка відповідного ресурсу.	true
campaign_localised_strings_string_unit_upgrade_cannot	Поліпшення неможливе:	true
campaign_localised_strings_string_imperium_01_title	Нікчемний	true
campaign_localised_strings_string_imperium_02_title	Помітний	true
campaign_localised_strings_string_imperium_03_title	Солідний	true
campaign_localised_strings_string_imperium_04_title	Вражаючий	true
campaign_localised_strings_string_imperium_05_title	Лякаючий	true
campaign_localised_strings_string_imperium_06_title	Жахаючий	true
campaign_localised_strings_string_imperium_07_title	Вищий	true
campaign_localised_strings_string_politics_event_promotion_success	Отримано нову посаду.	true
campaign_localised_strings_string_growth_food	Їжа	true
campaign_localised_strings_string_building_restriction_att_bld_eos_military_infantry_5_east_church	Будинок Хагія Макатас буде доступний при виконанні наступних умов:\\n[[col:yellow]]• 75% вашої фракції сповідують східне християнство.[[/col]]	true
campaign_localised_strings_string_army_morale_tooltip	Згуртованість||Якщо вона буде занадто низькою, воїни дезертирують, оголосять себе сепаратистами і почнуть громадянську війну!	true
campaign_localised_strings_string_cha_faction_italian_kingdom	Королівство Італія	true
campaign_localised_strings_string_end_turn_warning_bankrupt	Ваша скарбниця майже порожня.	true
campaign_localised_strings_string_gdp_other	Інше	true
campaign_localised_strings_string_unit_upgrade_cannot_reason_damaged_multiple	Ослаблено один загін або більше.	true
campaign_localised_strings_string_politics_event_promotion	Просування по службі!	true
campaign_localised_strings_string_gdp_entertainment	Культура	true
campaign_localised_strings_string_building_restriction_att_bld_eastmig_military_infantry_4	Парадний плац буде доступний при виконанні наступних умов:\\n[[col:yellow]]• Виконати завдання «Зустріч з Мавією – загроза»[[/col]]	true
campaign_localised_strings_string_building_restriction_att_bld_eastmig_military_infantry_5	Імперський плац буде доступний при виконанні наступних умов:\\n[[col:yellow]]• Виконати завдання «Зустріч з Мавією – звільнення»[[/col]]	true
campaign_localised_strings_string_sanitation_tooltip_description_good	У цьому поселенні рівень санітарії вище рівня забруднення. Ризик виникнення епідемій мінімальний.\\n	true
campaign_localised_strings_string_battle_ambush_you_intercept	Вашу армію помітили до того, як ви встигли напасти. Втім, ви як і раніше можете почати атаку і спробувати щастя в бою!	true
campaign_localised_strings_string_cha_faction_saxon_kingdom_objective	Контролюйте провінції Ангрія, Вільці, Остфальія, Ободрити і Саксонія.	true
campaign_localised_strings_string_public_order_devastation	Руйнування	true
campaign_localised_strings_string_end_turn_warning_military_force_morale_low	Рівень згуртованості цієї армії небезпечно низький:	true
campaign_localised_strings_string_recruitment_unavailable_blockading	Під час блокади найм військ неможливий.	true
campaign_localised_strings_string_gdp_fertility_agriculture	Землеробство [родюч.]	true
campaign_localised_strings_string_public_order_plague_tooltip	Чума	true
campaign_localised_strings_string_public_order_culture_differences_tooltip	Зіткнення культур і релігій може створити ефект «плавильного котла» — або призвести до конфліктів.	true
campaign_localised_strings_string_cha_faction_viking_kingdom	Королівство вікінгів	true
campaign_localised_strings_string_edicts_description	Провінційні едикти дозволяють впливати на громадський порядок, виробництво та інші аспекти фракції.\\n\\nЗахоплення і розвиток земель збільшить імперіум вашої фракції, що дозволить призначати більше губернаторів і видавати нові едикти.	true
campaign_localised_strings_string_growth_technologies	Технології	true
campaign_localised_strings_string_military_force_morale_bonus_value_foreign_waters	Ворожі води	true
campaign_localised_strings_string_public_order_region	Регіон	true
campaign_localised_strings_string_public_order_family_power_tooltip	Від впливовості вашої родини залежить те, як до вас ставляться люди.	true
campaign_localised_strings_string_raise_legacy_no_candidate	Неможливо відновити спадщину.||У вас немає кандидатів на посаду полководця.	true
campaign_localised_strings_string_sanitation_tooltip_description_bad	У цьому поселенні рівень забруднення вищий за рівень санітарії. Якщо не вжити заходів, можливі епідемії.\\n	true
campaign_localised_strings_string_edicts_outgoing_description	[[col:red]]Цей едикт втратить чинність на наступному ході.[[/col]]	true
campaign_localised_strings_string_military_force_morale_bonus_value_horde_in_fighting	Внутрішні чвари	true
campaign_localised_strings_string_cannot_migrate_already_migrating	Ви вже почали переселення.	true
campaign_localised_strings_string_character_type_son	Син	true
campaign_localised_strings_string_edicts_disabled_province_incomplete	[[col:red]]Ви не можете видавати едикти в провінціях без губернаторів.[[/col]]	true
campaign_localised_strings_string_public_order_stable	Громадський порядок стабільний.	true
campaign_localised_strings_string_sanitation_tooltip_total_sanitation	Загальна санітарія:	true
campaign_localised_strings_string_growth_buildings	Будівлі	true
campaign_localised_strings_string_events_attrition_summary_location_region	Регіон:	true
campaign_localised_strings_string_public_order_revolt	За поточного стану справ повстання рабів почнеться через %n х.	true
campaign_localised_strings_string_military_force_morale_bonus_value_offices	Посади	true
campaign_localised_strings_string_military_force_morale_bankruptcy	Скарбниця порожня	true
campaign_localised_strings_string_gdp_poor_fertility_bonus	Дохід від неродючих земель	true
campaign_localised_strings_string_unit_upgrade_cannot_reason_incorrect_stance	Військо в невідповідному режимі.	true
campaign_localised_strings_string_gdp_farming	Землеробство	true
campaign_localised_strings_string_politics_ministerial_position_expected_effects_no_selection	Виберіть персонажа, якого ви хочете призначити на посаду.\\n\\nНа цій посаді персонаж отримає наступні ефекти:	true
campaign_localised_strings_string_battle_ambush_they_success	Ваше військо не помітило ворожої засідки. На вас напали раптово, тому перевага на боці ваших ворогів.	true
campaign_localised_strings_string_military_force_morale_bonus_value_garrison_stance	У гарнізоні	true
campaign_localised_strings_string_att_eos_religious_mission_build_att_rel_church_east	Зведіть 4 споруди східного християнства, не будуючи інших релігійних будівель.	true
campaign_localised_strings_string_att_eos_tanukhid_mission_1	Зруйнуйте поселення в 3 регіонах, контрольованих Римом.	true
campaign_localised_strings_string_att_eos_tanukhid_mission_3	Перейдіть до осілого способу життя.	true
campaign_localised_strings_string_att_eos_tanukhid_mission_2	Звільніть 3 фракції.	true
campaign_localised_strings_string_bel_expedition_western_rome	Римське королівство	true
campaign_localised_strings_string_politics_ministerial_position_required_age	Необхідний вік:	true
campaign_localised_strings_string_character_retainer_of_full	Цей персонаж є слугою:	true
campaign_localised_strings_string_sanitation_tooltip_current_squalor	Рівень забруднення:	true
campaign_localised_strings_string_building_restriction_att_bld_eos_military_infantry_5_zoroastrian	Палац Безсмертних Святих буде доступний при виконанні наступних умов:\\n[[col:yellow]]• 75% вашої фракції сповідують зороастризм.[[/col]]	true
campaign_localised_strings_string_next_office	Наступна посада:	true
campaign_localised_strings_string_politics_ministerial_position_term	Термін служби:	true
campaign_localised_strings_string_unit_upgrade_retrain_cannot_reason_none_multiple	У даній провінції ці загони не навчаться нічому новому.	true
campaign_localised_strings_string_province_fertility_factor_events	Події	true
campaign_localised_strings_string_public_order_family_power	Політична ситуація	true
campaign_localised_strings_string_military_history_foundation_founder	Засновник:	true
campaign_localised_strings_string_public_order_uncertainty_tooltip	Невпевненість	true
campaign_localised_strings_string_politics_action_impossible_cannot_secure_loyalty	Ви не можете домогтися вірності цього персонажа.	true
campaign_localised_strings_string_building_restriction_bel_bld_all_resources_wood_4	Для доступу до цієї споруди вам потрібно контролювати всі 3 регіони, в яких є дерево, і звести в кожному з них по споруді з ланцюжка відповідного ресурсу.	true
campaign_localised_strings_string_politics_event_type	Подія:	true
campaign_localised_strings_string_military_force_morale_bonus_value_faction	Фракція	true
campaign_localised_strings_string_gdp_mining	!NOT USED!	true
campaign_localised_strings_string_unit_upgrade_cannot_reason_damaged_single	Цей загін ослаблений.	true
campaign_localised_strings_string_military_force_morale_bonus_value_buildings	Будівлі	true
campaign_localised_strings_string_province_fertility_factor_season	Пора року	true
campaign_localised_strings_string_province_fertility_factor_razing	Руйнування	true
campaign_localised_strings_string_public_order_events_tooltip	Громадська думка змінилася після недавніх подій.	true
campaign_localised_strings_string_military_force_morale_bonus_value_civil_war	Громадянська війна	true
campaign_localised_strings_string_unit_upgrade_retrain_cannot	Перенавчання неможливе:	true
campaign_localised_strings_string_unit_upgrade_cannot_reason_none_multiple	У даній провінції для цих загонів немає поліпшеного спорядження.	true
campaign_localised_strings_string_public_order_slaves	Іммігранти	true
campaign_localised_strings_string_politics_character_already_governor	Цей персонаж вже є губернатором.	true
campaign_localised_strings_string_unit_upgrade_retrain_header	Перенавчити	true
campaign_localised_strings_string_events_attrition_summary_force_army	Військо:	true
campaign_localised_strings_string_raise_navy	Створити флот.||Створення нового флоту і вибір флотоводця.	true
campaign_localised_strings_string_building_restriction_bel_bld_all_resources_salt_4	Для доступу до цієї споруди вам потрібно контролювати всі 3 регіони, в яких є сіль, і звести в кожному з них по будівлі з ланцюжка відповідного ресурсу.	true
campaign_localised_strings_string_public_order_events	Події	true
campaign_localised_strings_string_politics_action_impossible_actor_not_female	[[col:red]]Тільки жінки можуть вступати в шлюб з персонажами, які не входять до вашої родини.[[/col]]	true
campaign_localised_strings_string_cha_faction_spanish_kingdom	Королівство Іспанія	true
campaign_localised_strings_string_religion_factor_character	Персонажі	true
campaign_localised_strings_string_politics_action_impossible_retainer	Персонажі, які перебувають на службі, не можуть бути метою політичних дій.	true
campaign_localised_strings_string_public_order_slaves_tooltip	Люди тікають від воєн і заворушень у сусідні провінції, стаючи іммігрантами.	true
campaign_localised_strings_string_military_history_foundation	Створення:	true
campaign_localised_strings_string_military_force_morale_won_battle	Битва виграна	true
campaign_localised_strings_string_public_order_uncertainty	Невпевненість (-1 за хід)	true
campaign_localised_strings_string_tax_exempt_food_description	Ця провінція звільнена від податків і не робить внесок у виробництво їжі.	true
campaign_localised_strings_string_military_force_morale_bonus_value_plague	Пошесть	true
campaign_localised_strings_string_edicts_disabled_cap_reached	[[col:red]]Ви більше не можете видавати едикти.[[/col]]\\nЗахоплення і розвиток земель збільшить імперіум вашої фракції, що дозволить призначати більше губернаторів і видавати нові едикти.	true
campaign_localised_strings_string_att_eos_religious_mission_build_att_rel_judaism	Зведіть 4 іудейські споруди, не будуючи інших релігійних будівель.	true
campaign_localised_strings_string_religion_factor_osmosis	Проникнення	true
campaign_localised_strings_string_politics_character_heir	Спадкоємець	true
campaign_localised_strings_string_end_turn_warning_unused_edicts	Ви як і раніше можете видати едикт в одній з провінцій, для якої призначений губернатор:	true
campaign_localised_strings_string_growth_faction	Фракція	true
campaign_localised_strings_string_military_force_growth_events	Фракція	true
campaign_localised_strings_string_building_restriction_bel_bld_all_resources_orchards_4	Для доступу до цієї споруди вам потрібно контролювати всі 4 регіони, в яких є вино, і звести в кожному з них по споруді з ланцюжка відповідного ресурсу.	true
campaign_localised_strings_string_end_turn_warning_character_loyalty_low	Рівень вірності цієї людини низький:	true
campaign_localised_strings_string_growth_raiding	Наліт	true
campaign_localised_strings_string_raise_army_no_valid_location	Неможливо створити армію.||Немає підхожого місця.	true
campaign_localised_strings_string_military_force_growth_stance	Поточний режим	true
campaign_localised_strings_string_cannot_recruit_unit_source_settlement_besieged	Найняти загін неможливо.||Поселення в облозі.	true
campaign_localised_strings_string_politics_ministerial_position_expected_effects	На цій посаді обраний персонаж отримає наступні ефекти:	true
campaign_localised_strings_string_building_restriction_att_slav_wonder_1	Ця споруда буде доступна при виконанні наступних умов:\\n[[col:yellow]]• Наявність джерела деревини.\\n• Наявність родовища заліза.\\n• Поширення державної релігії не менше 70%.[[/col]]	true
campaign_localised_strings_string_cha_faction_cordoba_caliphate	Кордовський халіфат	true
campaign_localised_strings_string_military_history_battles_victory_close	Важка перемога над:	true
campaign_localised_strings_string_politics_event_target_family	Партія:	true
campaign_localised_strings_string_unit_details_xp	Досвід:	true
campaign_localised_strings_string_cha_mission_carloman_succession	Переможіть прихильників Карломана і захопіть регіон з його столицею.	true
campaign_localised_strings_string_military_history_years_service	Роки служби:	true
campaign_localised_strings_string_politics_event_assassination_wounded	Вони не виконали своє завдання: поранена жертва втекла.	true
campaign_localised_strings_string_bel_expedition_western_rome_separatists	Держава римських сепаратистів	true
campaign_localised_strings_string_politics_character_left_your_family_for	Цей персонаж пішов з вашої родини до наступної фракції:	true
campaign_localised_strings_string_edicts_incoming	Едикт, що набирає чинності:	true
campaign_localised_strings_string_info_panel_effect_summary_force	Вплив війська	true
campaign_localised_strings_string_building_restriction_att_slav_wonder_military_2	Ця споруда буде доступна при виконанні наступних умов:\\n[[col:yellow]]• Наявність родовища золота.\\n• Наявність родовища свинцю.\\n• Отримано 10 героїчних перемог.\\n• Поширення державної релігії не менше 70%.[[/col]]	true
campaign_localised_strings_string_building_restriction_att_slav_wonder_military_3	Ця споруда буде доступна при виконанні наступних умов:\\n[[col:yellow]]• Наявність родовища мармуру.\\n• Наявність родовища самоцвітів.\\n• Отримано 20 героїчних перемог.\\n• Поширення державної релігії не менше 80%.[[/col]]	true
campaign_localised_strings_string_edicts_allowed	Тут ви можете видати едикт.	true
campaign_localised_strings_string_raise_legacy_no_funds	Неможливо відновити спадщину.||У вас недостатньо грошей.	true
campaign_localised_strings_string_military_history_battles_victory_heroic	Героїчна перемога над:	true
campaign_localised_strings_string_tooltip_over_landbridge	Віадук	true
campaign_localised_strings_string_military_history_battles_defeat_close	Випадкова поразка від держави:	true
campaign_localised_strings_string_military_force_morale_bonus_value_raid_stance	Наліт	true
campaign_localised_strings_string_end_turn_warning_spare_governor_slot	Ви як і раніше можете призначити губернатора провінції.	true
campaign_localised_strings_string_general_type_politician	Державний чоловік	true
campaign_localised_strings_string_building_restriction_att_bld_eos_military_infantry_5_semitic	Обитель Захисників Шама буде доступна при виконанні наступних умов:\\n[[col:yellow]]• 75% вашої фракції сповідують семітське язичництво.[[/col]]	true
campaign_localised_strings_string_edicts_heading	Провінційні едикти	true
campaign_localised_strings_string_cannot_recruit_unit_army_full	Завербувати загін неможливо.||Армія досягла максимального розміру.	true
campaign_localised_strings_string_politics_event_adoption	Запропонувати усиновлення.	true
campaign_localised_strings_string_info_panel_effect_summary_agent	Вплив агента	true
campaign_localised_strings_string_politics_action_impossible_actor_not_married	[[col:red]]Щоб розлучитися, потрібно бути в шлюбі.[[/col]]	true
campaign_localised_strings_string_politics_action_impossible_actor_not_general	[[col:red]]Цей персонаж не є полководцем.[[/col]]	true
campaign_localised_strings_string_cha_faction_frankish_kingdom_objective	Фракція Карломана повинна бути знищена; вам має належати 30 регіонів.	true
campaign_localised_strings_string_campaign_morale_title_tooltip	Згуртованість	true
campaign_localised_strings_string_politics_event_assassination_success	Вони зуміли його вбити, все гаразд!	true
campaign_localised_strings_string_gdp_manufacture	Виробництво	true
campaign_localised_strings_string_growth_province	Провінція і регіон	true
campaign_localised_strings_string_tooltip_labour_points	Очки зростання:	true
campaign_localised_strings_string_public_order_desolation	Запустіння (лише з наступного ходу)	true
campaign_localised_strings_string_details_panel_tradition_cannot_no_skill_points	Немає очок традиції.	true
campaign_localised_strings_string_politics_action_impossible_different_faction	[[col:red]]Ви не можете вживати заходів проти персонажів інших фракцій.[[/col]]	true
campaign_localised_strings_string_military_force_morale_bonus_value_characters	Персонажі	true
campaign_localised_strings_string_politics_event_bribe_success	Він прийняв пропозицію і присягнувся на вірність іншій фракції. Тепер він служить її інтересам.	true
campaign_localised_strings_string_details_panel_ancillary_remove	Позбавити домочадців або предметів.	true
campaign_localised_strings_string_att_eos_axum_mission_1	Візьміть під контроль 2 джерела прянощів.	true
campaign_localised_strings_string_att_eos_axum_mission_2	Досягніть монополії на прянощі.	true
campaign_localised_strings_string_att_eos_axum_mission_3	Візьміть під контроль родовище золота.	true
campaign_localised_strings_string_sea_region_control_status_recruitment_cost_mod	Вартість найму флоту: %d%%	true
campaign_localised_strings_string_cannot_migrate_not_migratory	Ви не можете почати переселення, оскільки ваша фракція не є кочовою.	true
campaign_localised_strings_string_building_restriction_att_bld_religion_celtic_major_5	Храм Белена буде доступний при виконанні наступних умов: \\n\\n - Зведено 5 великих релігійних споруд. \\n - Основною релігією у всіх підконтрольних вам провінціях є кельтське язичництво.	true
campaign_localised_strings_string_public_order_desolation_tooltip	Війна приносить лише нещастя, і біженці спрямовують свій гнів на вас.	true
campaign_localised_strings_string_military_force_morale_change_of_soil	Чужа земля	true
campaign_localised_strings_string_politics_character_cannot_become_governor_travelling	Цей персонаж не може бути призначений на посаду, оскільки знаходиться в дорозі.	true
campaign_localised_strings_string_politics_event_bribe	Спроба підкупу!	true
campaign_localised_strings_string_building_restriction_att_bld_eos_military_infantry_5_judaism	Житло хаялімів буде доступне при виконанні наступних умов:\\n[[col:yellow]]• 75% вашої фракції сповідують іудаїзм.[[/col]]	true
campaign_localised_strings_string_politics_event_blackmail_discredited	Їхні вимоги не були виконані. Його репутація заплямована плітками.	true
campaign_localised_strings_string_politics_event_acting_family	Діюча партія:	true
campaign_localised_strings_string_politics_event_marriage_failure	Він відмовився від шлюбу. Баланс сил залишається незмінним.	true
campaign_localised_strings_string_politics_event_adoption_success	Він прийняв пропозицію і присягнув на вірність своїй новій партії. Тепер він служить їхнім інтересам.	true
campaign_localised_strings_string_raise_navy_no_valid_location	Неможливо створити флот.||Немає підхожого місця.	true
campaign_localised_strings_string_garrison_no_units_no_building	Немає гарнізону ||У вас немає будівель, які дозволяють збирати гарнізонні загони.	true
campaign_localised_strings_string_politics_action_impossible_target_own_family	[[col:red]]Метою цієї дії не можуть бути інші члени сім'ї.[[/col]]	true
campaign_localised_strings_string_gdp_fertility	Родючість	true
campaign_localised_strings_string_politics_event_assassination	Замах на вбивство!	true
campaign_localised_strings_string_public_order_revolt_next_turn	За поточного стану справ повстання рабів почнеться на наступний хід.	true
campaign_localised_strings_string_politics_action_make_heir_description	Спадкоємець очолить фракцію після смерті її поточного лідера. Виберіть кандидата, якого ви вважаєте найбільш підхожим на цю роль, але врахуйте, що позбавлення права на спадщину істотно знизить рівень вірності персонажа.\\n\\nОголошення спадкоємця набирає чинності негайно.	true
campaign_localised_strings_string_cha_faction_avar_khaganate_objective	Лідер вашої фракції повинен досягти як мінімум 5 рангу.	true
campaign_localised_strings_string_military_force_morale_bonus_value_patrol_stance	Патрулювання	true
campaign_localised_strings_string_building_restriction_att_slav_wonder_civic_2	Ця споруда буде доступна при виконанні наступних умов:\\n[[col:yellow]]• Наявність родовища золота.\\n• Наявність родовища свинцю.\\n• Дохід від торгівлі не менше 4000.\\n• Поширення державної релігії не менше 70%.[[/col]]	true
campaign_localised_strings_string_building_restriction_att_slav_wonder_civic_3	Ця споруда буде доступна при виконанні наступних умов:\\n[[col:yellow]]• Наявність родовища мармуру.\\n• Наявність родовища самоцвітів.\\n• Дохід від торгівлі не менше 8000.\\n• Поширення державної релігії не менше 70%.[[/col]]	true
campaign_localised_strings_string_public_order_technology	Технології	true
campaign_localised_strings_string_military_force_morale_bonus_value_own_waters	Дружні води	true
campaign_localised_strings_string_tooltip_loyalty_header	Вірність	true
campaign_localised_strings_string_tooltip_levy_unit_recruitment_unit_mouseover	ЛКМ — додати новобранців до черги. ПКМ — дізнатися більше.||Щоб призвати новобранців, натисніть ЛКМ по кнопці «Найняти».	true
campaign_localised_strings_string_garrison_no_units_momentarily	Немає гарнізону ||Загони почнуть поповнюватися на наступному ході.	true
campaign_localised_strings_string_public_order_culture_tooltip	Зіткнення культур і релігій може створити ефект «плавильного котла» - або призвести до конфліктів.	true
campaign_localised_strings_string_building_restriction_att_bld_barbarian_civic_market_general_5_legendary_celts	Королівський ринок буде доступний при виконанні наступних умов: \\n\\n - Отримано доступ до 9 видів торгових ресурсів.	true
campaign_localised_strings_string_politics_action_impossible_actor_not_politician	[[col:red]]Тільки державні діячі можуть ставати слугами інших персонажів.[[/col]]	true
campaign_localised_strings_string_cha_mission_vikings_1	Зруйнуйте 5 поселень в Англії (провінції Вессекс, Мерсія і Нортумбрія).	true
campaign_localised_strings_string_unit_upgrade_retrain_cannot_reason_none_multiple_horde	У даному ордені ці загони вже не навчаться нічому новому.	true
campaign_localised_strings_string_details_panel_tradition_select	Ця частина може засвоїти ще одну традицію.\\nКлацніть ЛКМ по традиції, щоб засвоїти її.	true
campaign_localised_strings_string_politics_action_impossible_actor_gravitas_insufficient	[[col:red]]Цей персонаж недостатньо впливовий для виконання даної дії.[[/col]]\\n\\nПерсонажі набувають впливу, досягаючи успіхів на посаді командира або губернатора, а також беручи участь у столичній політиці.	true
campaign_localised_strings_string_province_shared	Розділена провінція.	true
campaign_localised_strings_string_politics_character_status_in_transit	У дорозі	true
campaign_localised_strings_string_military_force_morale_bonus_value_settle_stance	Укріплення	true
campaign_localised_strings_string_politics_action_gravitas_cost	Очки впливу:	true
campaign_localised_strings_string_politics_action_impossible_actor_faction_leader_only	[[col:red]]Цю політичну дію може виконати тільки лідер фракції.[[/col]]	true
campaign_localised_strings_string_recruitment_unavailable_cannot_switch_stance	Найм неможливий. Ця армія не є осілою і не має достатнього запасу очок дій для переходу в цей стан.	true
campaign_localised_strings_string_military_force_morale_bonus_value_tax	Податок	true
campaign_localised_strings_string_recruitment_levy_from_satrapy	Новобранці з маріонеткової держави	true
campaign_localised_strings_string_raise_navy_blockaded	Неможливо створити флот.||Порт цього поселення в блокаді.	true
campaign_localised_strings_string_raise_navy_no_candidate	Неможливо створити флот.||У вас немає кандидатів на посаду флотоводця.	true
campaign_localised_strings_string_raise_army_no_candidate	Неможливо створити армію.||У вас немає кандидатів на посаду полководця.	true
campaign_localised_strings_string_retrain_upgrade_header	Перенавчити	true
campaign_localised_strings_string_edicts_current	Діючий едикт:	true
campaign_localised_strings_string_current_office	Найвища посада на даний момент:	true
campaign_localised_strings_string_public_order_culture	Релігія	true
campaign_localised_strings_string_force_not_in_correct_stance_expedition	Для будівництва експедиція повинна зупинитися. Віддавши цей наказ, ви накажете їй розбити табір.	true
campaign_localised_strings_string_politics_action_impossible_actor_post_requirement_fail	[[col:red]]Не виконані мінімальні вимоги для цієї посади.[[/col]]	true
campaign_localised_strings_string_public_order_faction_tooltip	Ваш народ втомився від постійних воєн.	true
campaign_localised_strings_string_unit_upgrade_cannot_reason_none_single	У даній провінції для цього загону немає поліпшеного спорядження.	true
campaign_localised_strings_string_public_order_raiding_tooltip	Наліт	true
campaign_localised_strings_string_authority_desc	Захист від дій агента, що підривають владу.	true
campaign_localised_strings_string_military_history_battles_defeat_phyrric	Героїчна поразка від:	true
campaign_localised_strings_string_tooltip_mercenary_recruitment_unit_mouseover	ЛКМ - додати загін найманців в чергу. ПКМ - дізнатися більше.||Щоб набрати найманців, клацніть ЛКМ по кнопці «Найняти».	true
campaign_localised_strings_string_character_type_child	Дитя	true
campaign_localised_strings_string_politics_event_adoption_failure	Він відмовився від пропозиції і зберіг вірність своїй партії.	true
campaign_localised_strings_string_public_order_characters_tooltip	Присутність цієї людини і його почту може вплинути на громадський порядок.	true
campaign_localised_strings_string_politics_event_marriage_success	Шлюб був укладений - баланс сил відновлено.	true
campaign_localised_strings_string_politics_ministerial_position_expected_effects_when_qualified	При досягненні мінімальних вимог обраний персонаж зможе зайняти цю посаду і отримати наступні ефекти:	true
campaign_localised_strings_string_public_order_resistance_to_occupation_tooltip	Кожен хід зменшується на 1.	true
campaign_localised_strings_string_politics_event_marriage	Пропозиція про шлюб	true
campaign_localised_strings_string_politics_power_support_popular_gravitas	Вплив: %u	true
campaign_localised_strings_string_public_order_characters	Персонажі	true
campaign_localised_strings_string_growth_other	Інше	true
campaign_localised_strings_string_politics_event_assassination_failure	Вони не змогли його вбити.	true
campaign_localised_strings_string_public_order_resistance_to_occupation	Нестабільність (-1 за х.)	true
campaign_localised_strings_string_growth_taxes	Податки	true
campaign_localised_strings_string_gdp_subsistence	Мале господарство	true
campaign_localised_strings_string_gdp_animal_husbandry	Тваринництво	true
campaign_localised_strings_string_public_order_faction	Втома від воєн	true
campaign_localised_strings_string_details_panel_ancillary_select	Немає ні домочадців, ні предметів.\\nКлацніть на доступного домочадця або предмет, щоб передати їх цьому персонажу. Ефект проявиться на наступний хід.	true
campaign_localised_strings_string_tooltip_cancel_unit_recruitment	ЛКМ - прибрати загін з черги||ПКМ - дізнатися більше	true
campaign_localised_strings_string_eos_empire_of_the_east	Імперія Сходу	true
campaign_localised_strings_string_public_order_raiding	Нальоти	true
campaign_localised_strings_string_military_force_morale_bonus_value_food	Їжа	true
campaign_localised_strings_string_other_nobles_candidates_header	Кандидати	true
campaign_localised_strings_string_politics_action_impossible_target_self	[[col:red]]Персонажі не можуть вживати дій проти самих себе.[[/col]]	true
campaign_localised_strings_string_development_points_tooltip_hordes_growth_max_expedition	[[col:yellow]]У цій експедиції досягнуто максимальний надлишок населення.[[/col]]	true
campaign_localised_strings_string_military_history_foundation_location	Розташування:	true
campaign_localised_strings_string_public_order_faction_province	%PLACEHOLDER% (UNUSED)	true
campaign_localised_strings_string_confirm_religious_conversion	Ви дійсно хочете прийняти нову релігію:	true
campaign_localised_strings_string_building_restriction_att_bld_all_resources_port_spice_4	Порт для торгівлі прянощами буде доступний при виконанні наступних умов:\\n[[col:yellow]]• Монополія на прянощі.[[/col]]	true
campaign_localised_strings_string_building_restriction_att_bld_all_resources_port_spice_3	Східний порт буде доступний при виконанні наступних умов:\\n[[col:yellow]]• Контроль над 2 або більше джерелами прянощів.[[/col]]	true
campaign_localised_strings_string_att_slav_venedians_mission_1	Заселити 5 покинутих регіонів.	true
campaign_localised_strings_string_public_order_buildings	Будівлі	true
campaign_localised_strings_string_character_retainer_of	Слуга:	true
campaign_localised_strings_string_politics_event_divorce	Розлучення!	true
campaign_localised_strings_string_unit_details_mancount	Людей:	true
campaign_localised_strings_string_politics_ministerial_position_effects	Займана посада наділяє цього персонажа наступними ефектами:	true
campaign_localised_strings_string_growth_armies	Армії	true
campaign_localised_strings_string_events_strings_character_type	Тип персонажа:	true
campaign_localised_strings_string_unit_upgrade_retrain_cannot_reason_none_single_horde	У даній орді цей загін вже не навчиться нічому новому.	true
campaign_localised_strings_string_military_force_morale_sacked_settlement	Військові трофеї	true
campaign_localised_strings_string_public_order_resources	Ресурси	true
campaign_localised_strings_string_public_order_rebellion	За поточного стану справ повстання почнеться через %n х.	true
campaign_localised_strings_string_campaign_ambush_success_chance	Шанс на успіх засідки: %d%%	true
campaign_localised_strings_string_cannot_recruit_force_region_under_siege	Це поселення в облозі. Ви не зможете зібрати тут війська, поки облога не буде знята.	true
campaign_localised_strings_string_military_force_morale_attrition	Небойові втрати	true
campaign_localised_strings_string_politics_event_divorce_success	Шлюб розірвано.	true
campaign_localised_strings_string_unit_upgrade_cannot_reason_foreign_territory	Військо знаходиться на ворожій землі.	true
campaign_localised_strings_string_public_order_buildings_tooltip	Будівлі руйнуються, інфраструктура занепадає, і це дратує людей - ніхто не хоче жити в злиднях.	true
campaign_localised_strings_string_confirm_begin_migration	Ви дійсно хочете почати переселення?	true
campaign_localised_strings_string_military_force_morale_bonus_value_technologies	Технології	true
campaign_localised_strings_string_public_order_resources_tooltip	Якщо в місто надходять багатства й розкіш, мешканці не замислюються, звідки все це береться.	true
campaign_localised_strings_string_cha_faction_scotland	Шотландія	true
campaign_localised_strings_string_politics_action_impossible_target_already_has_retainer	[[col:red]]У цього персонажа вже є слуга.[[/col]]	true
campaign_localised_strings_string_button_start_migration	Почати переселення||Ваша фракція покине всі свої поселення і почне міграцію. Вартість інфраструктури частково повернеться до вашої скарбниці, а деякі споруди ви візьмете з собою і зможете розгорнути на новому місці, зайнявши покинуте поселення або захопивши чуже. Надлишок населення буде розподілений між вашими військами.	true
campaign_localised_strings_string_cha_faction_holy_roman_empire	Священна Римська імперія	true
campaign_localised_strings_string_att_slav_sclaveneans_mission_2	Не програти жодної битви протягом 20 ходів.	true
campaign_localised_strings_string_att_slav_sclaveneans_mission_1	Виграти 5 битв з гунами.	true
campaign_localised_strings_string_military_force_morale_supplies	Припаси	true
campaign_localised_strings_string_siege_cannot_surrender_without_blockade	Це поселення не капітулює, поки його підтримує порт. Заблокуйте його з моря, щоб в поселенні почався голод.	true
campaign_localised_strings_string_character_neutral_effect_level	Нейтральний рівень. Немає ні позитивних, ні негативних ефектів.	true
campaign_localised_strings_string_raise_legacy_besieged	Неможливо відновити спадщину.||Це поселення в облозі.	true
campaign_localised_strings_string_battle_ambush_they_intercept	Ваше військо помітило засідку ворога. Хоча його плани розкриті, ворог йде в бій!	true
campaign_localised_strings_string_military_force_morale_kings_own	Царські воїни	true
campaign_localised_strings_string_politics_action_cancel	Скасування цієї політичної дії.	true
campaign_localised_strings_string_cha_mission_pope_help_1	Захопіть або розоріть ломбардську столицю.	true
campaign_localised_strings_string_military_force_morale_concurrent_wars	Кілька воєн	true
campaign_localised_strings_string_development_points_tooltip_hordes_growth_max	[[col:yellow]]У цій орді досягнуто максимальний надлишок населення.[[/col]]	true
campaign_localised_strings_string_building_restriction_att_bld_eos_mint	Царський монетний двір буде доступний при виконанні наступних умов:\\n[[col:yellow]]• Наявність родовища золота.\\n• Монополія на прянощі.[[/col]]	true
campaign_localised_strings_string_gdp_fertility_livestock	Худоба [родючість]	true
campaign_localised_strings_string_imperium_tooltip_03	Солідний||Слава про ваші успіхи розноситься по всьому світу; до вас ставляться з повагою і побоюванням.	true
campaign_localised_strings_string_imperium_tooltip_02	Помітний||Ви зайняли гідне місце в світі.	true
campaign_localised_strings_string_imperium_tooltip_01	Нікчемний||Ви поки що не впливаєте майже ні на що... але це поки!	true
campaign_localised_strings_string_imperium_tooltip_07	Вищий||Ви досягли найвищої могутності.	true
campaign_localised_strings_string_imperium_tooltip_06	Жахаючий||Світ здригається перед вашою могутністю.	true
campaign_localised_strings_string_imperium_tooltip_05	Лякаючий||Ваша могутність вселяє заздрість і страх ворогам.	true
campaign_localised_strings_string_imperium_tooltip_04	Вражаючий||Ваші досягнення увійшли в легенди; багато правителів мріють зрівнятися з вами.	true
campaign_localised_strings_string_building_restriction_att_bld_barbarian_civic_tavern_5_legendary_celts	Чертог бардів буде доступний при виконанні наступних умов: \\n\\n - Отримано 3 героїчні перемоги.	true
campaign_localised_strings_string_religion_factor_faction_traits	Особливість фракції	true
campaign_localised_strings_string_public_order_province	Провінція	true
campaign_localised_strings_string_military_force_morale_released_captives	Немає полонених	true
campaign_localised_strings_string_military_force_morale_bonus_value_own_territory	Дружня територія	true
campaign_localised_strings_string_details_panel_tradition_cannot_select	Це військо не може перейняти цю традицію:	true
campaign_localised_strings_string_gdp_land_trade	!NOT USED!	true
campaign_localised_strings_string_military_force_morale_bonus_value_march_stance	Масове переселення	true
campaign_localised_strings_string_politics_action_impossible_target_dead	[[col:red]]Цей персонаж мертвий! Проти нього неможливо вживати жодних дій.[[/col]]	true
campaign_localised_strings_string_development_points_tooltip_hordes_insufficent_development_points_number	Необхідний надлишок населення: %n.||Ваша орда з часом зросте. Щоб прискорити її зростання, здійснюйте набіги та зводьте певні споруди.	true
campaign_localised_strings_string_raise_legacy_no_surplus	Не вдалося відновити спадщину.||У вас недостатній надлишок населення.	true
campaign_localised_strings_string_raise_legacy	Відновити спадщину.||Відродіть ім’я розформованого або знищеного війська.||Нова армія збереже всі традиції свого попередника.	true
campaign_localised_strings_string_unit_upgrade_cannot_reason_none_single_horde	У даній орді для цього загону немає поліпшеного спорядження.	true
campaign_localised_strings_string_politics_cursus_current_level	Поточний рівень	true
campaign_localised_strings_string_details_panel_tradition_cannot_low_rank	Занадто низький ранг.	true
campaign_localised_strings_string_gdp_local_trade	Місцева торгівля	true
campaign_localised_strings_string_raise_force_navy_cannot	Неможливо створити флот	true
campaign_localised_strings_string_cannot_recruit_agent_region_not_owned	Це поселення вам не належить. Ви не можете найняти тут агента.	true
campaign_localised_strings_string_military_force_morale_bonus_value_faction_trait	Особливість фракції	true
campaign_localised_strings_string_politics_event_outcome	Наслідки	true
campaign_localised_strings_string_cha_faction_frankish_kingdom	Королівство франків	true
campaign_localised_strings_string_cha_faction_cordoba_caliphate_objective	Поширення ісламу як державної релігії повинно бути не менше 75%.	true
campaign_localised_strings_string_politics_power_support_popular_current	Поточне панування:	true
campaign_localised_strings_string_cannot_issue_edict_to_unowned_region	[[col:red]]Ви можете видавати едикти тільки у власних регіонах.[[/col]]	true
campaign_localised_strings_string_politics_event_target_character	Мета:	true
campaign_localised_strings_string_details_panel_skills_cannot_low_rank	Занадто низький ранг.	true
campaign_localised_strings_string_cunning_desc	Захист від дій агента, що знижують хитрість.	true
campaign_localised_strings_string_cannot_recruit_agent_region_under_siege	Це поселення в облозі. Ви не зможете найняти тут агента, поки облога не буде знята.	true
campaign_localised_strings_string_politics_governor_cap_reached	Ви вже призначили максимальну кількість губернаторів.	true
campaign_localised_strings_string_politics_power_support_political_description	Контроль - це міра вашої політичної майстерності та здатності диктувати свою волю еліті. Він змінюється за участю вашої родини в політичних інтригах, а також після деяких подій кампанії.\\n\\nПоєднання панування і контролю визначає загальний рівень влади вашої родини.	true
campaign_localised_strings_string_unit_upgrade_retrain_cannot_reason_none_single	У цій провінції цей загін не навчиться нічого нового.	true
campaign_localised_strings_string_edicts_cancel	Скасування едикту\\nДія едикту буде припинена на початку наступного ходу.	true
campaign_localised_strings_string_bel_western_roman_separatists	Західноримські сепаратисти	true
campaign_localised_strings_string_raise_legacy_blockaded	Неможливо відновити спадщину.||Порт цього поселення в блокаді.	true
campaign_localised_strings_string_garrison_no_units_siege	Без гарнізону ||Гарнізон не можна поповнювати, поки місто в облозі.	true
campaign_localised_strings_string_military_force_morale_decimated	Децимація	true
campaign_localised_strings_string_gdp_sea_trade	Морська торгівля	true
campaign_localised_strings_string_public_order_improving	Рівень громадського порядку підвищується.	true
campaign_localised_strings_string_end_turn_warning_character_skill_to_be_picked	У цього персонажа є не присвоєна навичка:	true
campaign_localised_strings_string_cha_mission_asturias_1	Заселіть 2 з наступних регіонів:\\nЛеон, Вальядолід, Саламанка	true
campaign_localised_strings_string_sea_region_control_status_port_gdp_modifier_reduction	Добробут від морської торгівлі: -%d%% (піратство)	true
campaign_localised_strings_string_military_force_morale_ambitious_leader	Честолюбний лідер	true
campaign_localised_strings_string_details_panel_tradition_unlocked_rank	Відкривається при ранзі:	true
campaign_localised_strings_string_gdp_learning	!NOT USED!	true
campaign_localised_strings_string_growth_tooltip_description_expedition	Надлишок зростаючого населення експедиції можна використовувати для її посилення або створення нових експедицій.	true
campaign_localised_strings_string_unit_upgrade_cannot_reason_insufficient_funds	У вас недостатньо коштів.	true
campaign_localised_strings_string_public_order_military_crackdown_tooltip	Якщо інші способи не діють, порядок буде підтримуватися за допомогою насильства.	true
campaign_localised_strings_string_unit_upgrade_cannot_reason_none_multiple_horde	У даному ордені для цих загонів немає поліпшеного спорядження.	true
campaign_localised_strings_string_public_order_military_activity	Військова присутність	true
campaign_localised_strings_string_politics_character_is_faction	Цей персонаж входить до сім'ї наступної фракції:	true
campaign_localised_strings_string_cannot_recruit_force_region_not_owned	Це поселення вам не належить. Ви не можете зібрати тут війська.	true
campaign_localised_strings_string_raise_force_navy_cannot_port_required	[[col:red]]Ви можете створювати флоти тільки в прибережних поселеннях.[[/col]]	true
campaign_localised_strings_string_public_order_buildings_squalor_tooltip	Забруднення	true
campaign_localised_strings_string_public_order_banditry_tooltip	Бродяги й розбійники порушують громадський порядок, збурюють розуми та сіють зерна невдоволення.	true
campaign_localised_strings_string_details_panel_ancillary_none	Немає домочадців і предметів, які можна було б дати персонажу.	true
campaign_localised_strings_string_public_order_conquest_tooltip	Тяготи війни та окупації штовхають людей до заколоту.	true
campaign_localised_strings_string_public_order_baseline_tooltip	Рівень складності вплине на громадський порядок.	true
campaign_localised_strings_string_cha_faction_viking_kingdom_objective	Розоріть не менше 25 поселень.	true
campaign_localised_strings_string_province_fertility_factor_base	Базова родючість	true
campaign_localised_strings_string_politics_character_cannot_act_wounded	Поки цей персонаж поранений, він не може ні здійснювати політичні дії, ні бути їх метою.	true
campaign_localised_strings_string_public_order_buildings_squalor	Будівлі	true
campaign_localised_strings_string_public_order_banditry	Розбійники	true
campaign_localised_strings_string_military_force_morale_bonus_value_guarded_navy	Супровід суден	true
campaign_localised_strings_string_cha_faction_english_kingdom_objective	Контролюйте провінції Вессекс, Мерсія і Нортумбрія.	true
campaign_localised_strings_string_cha_faction_italian_kingdom_objective	Контролюйте провінції Фріулі, Ломбардія, Екзархат, Беневенто, Калабрія, Сицилія і Рим (крім м. Риму).	true
campaign_localised_strings_string_military_force_morale_raiding	Наліт	true
campaign_localised_strings_string_raise_legacy_no_legacy	Неможливо відновити спадщину.||У вас немає спадщини, яку можна було б відновити.	true
campaign_localised_strings_string_public_order_garrison	Гарнізон	true
campaign_localised_strings_string_politics_character_cannot_be_acted_or_act_travelling	Цей персонаж не може вживати дій або бути їхньою метою, оскільки перебуває в дорозі.	true
campaign_localised_strings_string_public_order_baseline	Складність	true
campaign_localised_strings_string_public_order_conquest	Захоплення (тільки наст. хід)	true
campaign_localised_strings_string_cannot_recruit_unit_source_settlement_blockaded	Найняти загін неможливо.||Поселення заблоковано.	true
campaign_localised_strings_string_character_type_daughter	Дочка	true
campaign_localised_strings_string_edicts_issued	Видані едикти:	true
campaign_localised_strings_string_province_owned	Своя провінція.	true
campaign_localised_strings_string_general_type_general	Полководець	true
campaign_localised_strings_string_public_order_military_crackdown	Воєнний стан	true
campaign_localised_strings_string_military_history_battles_defeat_heroic	Розгромна поразка від:	true
campaign_localised_strings_string_details_panel_ancillary_cannot_assign	[[col:yellow]]Зараз немає ні домочадців, ні предметів, які можна було б дати цьому персонажу.[[/col]]	true
campaign_localised_strings_string_cha_faction_spanish_kingdom_objective	Контролюйте провінції Валенсія, Толедо, Іспанська марка, Нижня марка, Середня марка, Наварра, Леон і Галісія.	true
campaign_localised_strings_string_general_type_admiral	Флотоводець	true
campaign_localised_strings_string_sanitation_tooltip_current_sanitation	Рівень санітарії:	true
campaign_localised_strings_string_public_order_military_activity_tooltip	Недавні бойові дії дали місцевим жителям привід для чуток.	true
