key	text	tooltip
#Loc;1;text/db/cdir_events_dilemma_choice_details.loc		
cdir_events_dilemma_choice_details_localised_choice_label_att_dilemma_religious_celtic_religious_sanctions_1SECOND	Ввести санкції	true
cdir_events_dilemma_choice_details_localised_choice_title_cha_dilemma_pope_attacked_1SECOND	Господь посилає випробування, щоб зміцнити нас. Кожен повинен нести свій хрест сам.	true
cdir_events_dilemma_choice_details_localised_choice_label_cha_dilemma_lombard_pope_demands_1FIRST	Віддати Равенну	true
cdir_events_dilemma_choice_details_localised_choice_title_political_event_assassinationFIRST	Подвоїти охорону і нагадати всім, що ми робимо із зрадниками!	true
cdir_events_dilemma_choice_details_localised_choice_label_att_political_action_dilemma_secure_loyalty_briberyTHIRD	Неважливо	true
cdir_events_dilemma_choice_details_localised_choice_label_att_political_action_dilemma_assassinate_suspiciousFIRST	Замести сліди	true
cdir_events_dilemma_choice_details_localised_choice_title_att_political_action_dilemma_secure_loyalty_mutilationTHIRD	Його доля нас не хвилює. Ми займаємося більш важливими справами.	true
cdir_events_dilemma_choice_details_localised_choice_title_att_subject_domestic_nordic_the_flyting_1THIRD	Нехай за вас виступить полководець. Він підтвердить вашу перевагу.	true
cdir_events_dilemma_choice_details_localised_choice_title_ybor_level_A_alamanniSECOND	Жерці кажуть, що вона дарує мудрість і захист Годана.	true
cdir_events_dilemma_choice_details_localised_choice_label_att_subject_politics_civil_challengerFOURTH	Дати йому посаду	true
cdir_events_dilemma_choice_details_localised_choice_label_att_subject_politics_civil_hostageSECOND	Залишити в заручниках	true
cdir_events_dilemma_choice_details_localised_choice_label_att_political_action_dilemma_secure_loyalty_briberyFIRST	Невеликий хабар	true
cdir_events_dilemma_choice_details_localised_choice_label_att_political_action_dilemma_assassinate_suspiciousTHIRD	Неважливо	true
cdir_events_dilemma_choice_details_localised_choice_title_att_political_action_dilemma_secure_loyalty_mutilationFIRST	Після цього він вже нікому не знадобиться!	true
cdir_events_dilemma_choice_details_localised_choice_title_att_subject_domestic_nordic_the_flyting_1FIRST	У нас немає часу на такі дурниці.	true
cdir_events_dilemma_choice_details_localised_choice_label_att_subject_military_roman_master_hostile_governorSECOND	Очорнити його	true
cdir_events_dilemma_choice_details_localised_choice_title_ybor_level_A_burgundiFIRST	Він вирваний з мертвих рук ворога.	true
cdir_events_dilemma_choice_details_localised_choice_label_att_subject_domestic_barb_nomad_stolen_swordFIRST	Зробити новий меч	true
cdir_events_dilemma_choice_details_localised_choice_label_att_political_action_dilemma_seek_office_obstructionSECOND	Указ	true
cdir_events_dilemma_choice_details_localised_choice_label_cha_dilemma_lombard_pope_demands_3FIRST	Віддати Равенну	true
cdir_events_dilemma_choice_details_localised_choice_label_cha_dilemma_lombard_pope_demands_2THIRD	Підлеситися до Карла	true
cdir_events_dilemma_choice_details_localised_choice_title_att_dilemma_religious_christian_the_council_of_toledo_1FIRST	Ці люди вже достатньо настраждалися. Потрібно примиритися з ними.	true
cdir_events_dilemma_choice_details_localised_choice_label_att_subject_politics_barb_nomad_tribal_loyaltyTHIRD	Примирити сторони	true
cdir_events_dilemma_choice_details_localised_choice_label_att_subject_politics_civil_secret_meetingsSECOND	Зустрітися з ними	true
cdir_events_dilemma_choice_details_localised_choice_title_att_subject_domestic_none_the_silk_trader_1SECOND	Новий торговий шлях принесе велику користь нашому народу. Давайте його поліпшимо.	true
cdir_events_dilemma_choice_details_localised_choice_label_att_subject_domestic_barb_nomad_stolen_swordTHIRD	Не робити нічого	true
cdir_events_dilemma_choice_details_localised_choice_title_ollam_ri_A1iSECOND	Короля не цікавить балаканина. Золото - інша справа!	true
cdir_events_dilemma_choice_details_localised_choice_label_att_dilemma_religious_orthodox_religious_sanctions_1SECOND	Ввести санкції	true
cdir_events_dilemma_choice_details_localised_choice_label_cha_dilemma_lombard_pope_demands_2FIRST	Віддати Равенну	true
cdir_events_dilemma_choice_details_localised_choice_label_att_dilemma_religious_germanic_religious_sanctions_1SECOND	Ввести санкції	true
cdir_events_dilemma_choice_details_localised_choice_title_att_subject_domestic_civil_idiot_magistrateSECOND	Не можна, щоб управління народом залежало від випадку!	true
cdir_events_dilemma_choice_details_localised_choice_title_att_subject_domestic_none_hidden_treasure_1SECOND	Люди заслужили право отримати вигоду з цієї знахідки. Розділи все порівну між ними.	true
cdir_events_dilemma_choice_details_localised_choice_title_cha_dilemma_cordoba_1SECOND	Нехай воїни стануть на березі в повному озброєнні. Ми теж можемо показати силу!	true
cdir_events_dilemma_choice_details_localised_choice_label_att_subject_military_none_war_child_1SECOND	Збрехати	true
cdir_events_dilemma_choice_details_localised_choice_label_att_subject_politics_barb_nomad_tribal_loyaltyFIRST	Похвалити одну групу	true
cdir_events_dilemma_choice_details_localised_choice_title_att_eos_marib_dam_repair_2THIRD	Ми не можемо дозволити собі, щоб наші селяни перестали довіряти греблі!	true
cdir_events_dilemma_choice_details_localised_choice_title_att_eos_marib_dam_repair_3FIRST	Та вона й так втримається... Правда?	true
cdir_events_dilemma_choice_details_localised_choice_label_att_political_action_dilemma_embezzlement_suspiciousTHIRD	Неважливо	true
cdir_events_dilemma_choice_details_localised_choice_label_att_subject_domestic_civil_idiot_magistrateFOURTH	Не робити нічого	true
cdir_events_dilemma_choice_details_localised_choice_label_att_subject_religious_christian_candidate_for_bishopFIRST	Відкликати його кандидатуру	true
cdir_events_dilemma_choice_details_localised_choice_label_att_subject_domestic_civil_master_agitatorFOURTH	Не робити нічого	true
cdir_events_dilemma_choice_details_localised_choice_title_att_eos_marib_dam_repair_3THIRD	Ми не можемо дозволити собі, щоб наші селяни перестали довіряти греблі!	true
cdir_events_dilemma_choice_details_localised_choice_title_att_eos_marib_dam_repair_2FIRST	Та вона й так втримається... Правда?	true
cdir_events_dilemma_choice_details_localised_choice_label_att_political_action_dilemma_embezzlement_suspiciousFIRST	Замести сліди	true
cdir_events_dilemma_choice_details_localised_choice_label_att_dilemma_religious_catholic_religious_sanctions_1SECOND	Ввести санкції	true
cdir_events_dilemma_choice_details_localised_choice_label_att_subject_religious_christian_candidate_for_bishopTHIRD	Почекати результатів	true
cdir_events_dilemma_choice_details_localised_choice_label_cha_dilemma_cordoba_1FOURTH	Не робити нічого	true
cdir_events_dilemma_choice_details_localised_choice_title_att_subject_religious_hun_lightningTHIRD	Його вибрав Тенгрі? А що, якщо йому судилося правити людьми?	true
cdir_events_dilemma_choice_details_localised_choice_label_att_political_action_dilemma_adoption_added_incentiveFIRST	Дати хабар	true
cdir_events_dilemma_choice_details_localised_choice_title_att_eos_marib_dam_repair_0THIRD	Ми не можемо дозволити собі, щоб наші селяни перестали довіряти греблі!	true
cdir_events_dilemma_choice_details_localised_choice_title_att_eos_marib_dam_repair_1FIRST	Та вона й так втримається... Правда?	true
cdir_events_dilemma_choice_details_localised_choice_label_att_subject_domestic_eastern_the_chovgan_tourney_1THIRD	Розкрити інкогніто	true
cdir_events_dilemma_choice_details_localised_choice_title_att_subject_domestic_nomad_sword_of_attilaFOURTH	Це просто селянські справи, не витрачай на них час.	true
cdir_events_dilemma_choice_details_localised_choice_label_att_subject_military_nomad_master_swordsmithFOURTH	Не робити нічого...	true
cdir_events_dilemma_choice_details_localised_choice_title_att_subject_domestic_none_workers_on_strike_1SECOND	...ні, ви саме раби.	true
cdir_events_dilemma_choice_details_localised_choice_title_ollam_ri_pictiFIRST	У його чорній гладі відбиваються всі таємниці людей.	true
cdir_events_dilemma_choice_details_localised_choice_title_att_subject_politics_civil_challengerSECOND	Краще змусити його замовкнути, поки його промови не стали небезпечними.	true
cdir_events_dilemma_choice_details_localised_choice_label_att_subject_diplomatic_none_tribute_1SECOND	Прийняти дар	true
cdir_events_dilemma_choice_details_localised_choice_title_att_subject_religious_hun_lightningFIRST	Людина, яку так любить Тенгрі, принесе удачу твоєму дому.	true
cdir_events_dilemma_choice_details_localised_choice_label_att_political_action_dilemma_adoption_added_incentiveTHIRD	Залякування	true
cdir_events_dilemma_choice_details_localised_choice_label_att_subject_politics_nomad_hostageSECOND	Залишити в заручниках	true
cdir_events_dilemma_choice_details_localised_choice_label_att_subject_politics_roman_hostageSECOND	Залишити в заручниках	true
cdir_events_dilemma_choice_details_localised_choice_title_att_eos_marib_dam_repair_1THIRD	Ми не можемо дозволити собі, щоб наші селяни перестали довіряти греблі!	true
cdir_events_dilemma_choice_details_localised_choice_title_att_eos_marib_dam_repair_0FIRST	Та вона й так встоїть... Правда?	true
cdir_events_dilemma_choice_details_localised_choice_label_att_subject_domestic_eastern_the_chovgan_tourney_1FIRST	Не звертати уваги	true
cdir_events_dilemma_choice_details_localised_choice_label_att_subject_politics_rome_corruptionSECOND	Заспокоїти народ	true
cdir_events_dilemma_choice_details_localised_choice_title_cha_dilemma_charlemagne_daughter_1FIRST	Такому немає місця ні в моєму домі, ні в моєму королівстві!	true
cdir_events_dilemma_choice_details_localised_choice_label_att_subject_domestic_roman_a_little_flutter_1SECOND	Поставити на гладіатора	true
cdir_events_dilemma_choice_details_localised_choice_label_att_subject_domestic_roman_a_little_flutter_2SECOND	Поставити на ветерана	true
cdir_events_dilemma_choice_details_localised_choice_label_cha_dilemma_pope_attacked_1SECOND	Залишитися осторонь	true
cdir_events_dilemma_choice_details_localised_choice_label_att_subject_politics_nomad_hostageFOURTH	Не робити нічого	true
cdir_events_dilemma_choice_details_localised_choice_label_att_subject_politics_roman_hostageFOURTH	Не робити нічого	true
cdir_events_dilemma_choice_details_localised_choice_title_ybor_level_A_alamanniFIRST	Він вирваний з мертвих рук ворожого володаря.	true
cdir_events_dilemma_choice_details_localised_choice_title_att_subject_domestic_barb_nomad_enemy_tradeFIRST	Вбити зрадника!	true
cdir_events_dilemma_choice_details_localised_choice_label_att_subject_politics_rome_corruptionFOURTH	Проігнорувати народ	true
cdir_events_dilemma_choice_details_localised_choice_label_att_political_action_dilemma_secure_loyalty_mutilationFIRST	Оскопити	true
cdir_events_dilemma_choice_details_localised_choice_label_att_eos_sassanid_insult_2FIRST	Вигнати його	true
cdir_events_dilemma_choice_details_localised_choice_title_att_subject_domestic_nomad_sword_of_attilaSECOND	Він намагається втертися до тебе в довіру. Не потрібні тобі його подарунки.	true
cdir_events_dilemma_choice_details_localised_choice_label_att_subject_military_nomad_master_swordsmithSECOND	Вбити його	true
cdir_events_dilemma_choice_details_localised_choice_title_cha_dilemma_lombard_pope_demands_1FIRST	Як може благочестивий християнин відмовити в проханні Святому Отцю і порушити урочисту обіцянку?	true
cdir_events_dilemma_choice_details_localised_choice_label_att_political_action_dilemma_secure_loyalty_mutilationTHIRD	Неважливо	true
cdir_events_dilemma_choice_details_localised_choice_label_att_eos_sassanid_insult_3FIRST	Ввічливо відмовитися	true
cdir_events_dilemma_choice_details_localised_choice_title_att_subject_politics_civil_challengerFOURTH	Багатство і посада зроблять його нашим прихильником.	true
cdir_events_dilemma_choice_details_localised_choice_label_ybor_level_A_alamanniSECOND	Брошка	true
cdir_events_dilemma_choice_details_localised_choice_title_att_subject_domestic_barb_nomad_stolen_swordFIRST	Нехай коваль викує новий меч.	true
cdir_events_dilemma_choice_details_localised_choice_label_att_subject_domestic_civil_master_agitatorSECOND	Провести часткові реформи	true
cdir_events_dilemma_choice_details_localised_choice_title_att_eos_religious_event_rebellion_att_fact_himyar_att_rel_semitic_paganismSECOND	Його народ достатньо страждав, зробимо виняток для нього, якщо це можливо.	true
cdir_events_dilemma_choice_details_localised_choice_title_cha_dilemma_lombard_pope_demands_2FIRST	Мені не потрібна війна з франками. Нехай папа бере, що хоче. Передайте Карлу Великому, що питання вирішено.	true
cdir_events_dilemma_choice_details_localised_choice_label_cha_dilemma_cordoba_1SECOND	Зібрати воїнів	true
cdir_events_dilemma_choice_details_localised_choice_title_att_subject_military_none_war_child_1SECOND	Він - справжній член сім'ї, нехай і не по крові...	true
cdir_events_dilemma_choice_details_localised_choice_title_att_subject_domestic_nomadic_the_kassai_contest_1FIRST	Це його справа, а не наша.	true
cdir_events_dilemma_choice_details_localised_choice_title_att_subject_politics_barb_nomad_tribal_loyaltyFIRST	Нехай боги побачать велич обраних вами воїнів!	true
cdir_events_dilemma_choice_details_localised_choice_title_att_subject_domestic_none_foreign_migrants_1SECOND	Нам ледь вистачає їжі, щоб прогодувати себе. Зайві роти нам не потрібні - тим більше ці дикуни.	true
cdir_events_dilemma_choice_details_localised_choice_title_att_subject_domestic_barb_nomad_stolen_swordTHIRD	У нас немає часу на такі дрібні чвари.	true
cdir_events_dilemma_choice_details_localised_choice_label_att_subject_domestic_none_the_silk_trader_1SECOND	Довірити йому караван	true
cdir_events_dilemma_choice_details_localised_choice_label_att_subject_domestic_civil_idiot_magistrateSECOND	Скасувати ставку	true
cdir_events_dilemma_choice_details_localised_choice_label_att_subject_domestic_none_hidden_treasure_1SECOND	Віддати народу	true
cdir_events_dilemma_choice_details_localised_choice_title_cha_dilemma_lombard_pope_demands_3FIRST	Не варто ризикувати всім королівством заради власної гордості. Нехай папа забере заслужене важкою працею.	true
cdir_events_dilemma_choice_details_localised_choice_title_att_dilemma_religious_hellenic_religious_sanctions_1SECOND	Ми повинні прийняти закон, що обмежує права язичників молитися.	true
cdir_events_dilemma_choice_details_localised_choice_title_cha_dilemma_lombard_pope_demands_2THIRD	Вихваляйте його. Переконайте його, що він кращий за нас. Тоді, можливо, він піде нам назустріч.	true
cdir_events_dilemma_choice_details_localised_choice_title_att_subject_domestic_nomadic_the_kassai_contest_1THIRD	Він добре складений, та й хитрості, схоже, йому не позичати. Нехай він покаже себе.	true
cdir_events_dilemma_choice_details_localised_choice_label_att_eos_sassanid_insult_1FIRST	Захистити свій народ	true
cdir_events_dilemma_choice_details_localised_choice_title_att_subject_politics_barb_nomad_tribal_loyaltyTHIRD	Нам потрібна єдність. Ми - одне плем'я.	true
cdir_events_dilemma_choice_details_localised_choice_label_att_subject_politics_civil_secret_meetingsFOURTH	Взяти їх на службу	true
cdir_events_dilemma_choice_details_localised_choice_label_att_dilemma_religious_tengri_religious_sanctions_1SECOND	Ввести санкції	true
cdir_events_dilemma_choice_details_localised_choice_title_att_subject_religious_christian_candidate_for_bishopFIRST	Він не готовий до такої честі. Йому ще багато чого потрібно зробити.	true
cdir_events_dilemma_choice_details_localised_choice_label_att_eos_marib_dam_repair_3THIRD	Капітальний ремонт	true
cdir_events_dilemma_choice_details_localised_choice_label_att_eos_marib_dam_repair_2FIRST	Не робити нічого	true
cdir_events_dilemma_choice_details_localised_choice_title_att_subject_domestic_civil_idiot_magistrateFOURTH	Нехай дурень сам розбирається з цією справою.	true
cdir_events_dilemma_choice_details_localised_choice_title_att_political_action_dilemma_embezzlement_suspiciousTHIRD	Нехай собі пліткують і гадають. Яке нам діло до того, про що теревенять селяни?	true
cdir_events_dilemma_choice_details_localised_choice_title_cha_dilemma_cordoba_1FOURTH	Чудове вино!	true
cdir_events_dilemma_choice_details_localised_choice_title_att_subject_diplomatic_none_the_feast_1THIRD	Запроси наших союзників, щоб вони теж могли на це помилуватися. Така подія - привід продемонструвати наше багатство і силу.	true
cdir_events_dilemma_choice_details_localised_choice_label_att_subject_military_roman_master_hostile_governorFOURTH	Не робити нічого	true
cdir_events_dilemma_choice_details_localised_choice_label_att_eos_religious_event_rebellion_att_fact_axum_att_rel_church_eastFIRST	Вигнати його	true
cdir_events_dilemma_choice_details_localised_choice_title_att_subject_religious_christian_candidate_for_bishopTHIRD	Ми не повинні втручатися в хід виборів. Нехай все йде само собою.	true
cdir_events_dilemma_choice_details_localised_choice_label_att_eos_marib_dam_repair_2THIRD	Капітальний ремонт	true
cdir_events_dilemma_choice_details_localised_choice_label_att_eos_marib_dam_repair_3FIRST	Не робити нічого	true
cdir_events_dilemma_choice_details_localised_choice_title_att_political_action_dilemma_embezzlement_suspiciousFIRST	Вони повинні зробити все, щоб не залишити доказів.	true
cdir_events_dilemma_choice_details_localised_choice_title_att_subject_diplomatic_none_the_feast_1FIRST	Зараз не час для подібних дурниць.	true
cdir_events_dilemma_choice_details_localised_choice_label_att_subject_politics_civil_hostageFOURTH	Не робити нічого	true
cdir_events_dilemma_choice_details_localised_choice_label_cha_dilemma_charlemagne_daughter_1FIRST	Покарати дочку	true
cdir_events_dilemma_choice_details_localised_choice_label_att_eos_marib_dam_repair_1THIRD	Капітальний ремонт	true
cdir_events_dilemma_choice_details_localised_choice_label_att_eos_marib_dam_repair_0FIRST	Не робити нічого	true
cdir_events_dilemma_choice_details_localised_choice_title_att_subject_domestic_eastern_the_chovgan_tourney_1FIRST	Те, чим воєначальники займаються у вільний час - їхня особиста справа.	true
cdir_events_dilemma_choice_details_localised_choice_label_att_subject_military_none_drunk_on_watch_1SECOND	Випороти його	true
cdir_events_dilemma_choice_details_localised_choice_title_att_subject_domestic_roman_a_little_flutter_1SECOND	Це молодий боєць, але в нього непогані задатки. Можливо, настав час дати йому шанс?	true
cdir_events_dilemma_choice_details_localised_choice_title_att_subject_domestic_roman_a_little_flutter_2SECOND	Ха! Юність нічого не означає, якщо їй протистоїть досвід. Вихід може бути тільки один. Я ставлю на ветерана.	true
cdir_events_dilemma_choice_details_localised_choice_label_att_eos_marib_dam_repair_0THIRD	Капітальний ремонт	true
cdir_events_dilemma_choice_details_localised_choice_label_att_eos_marib_dam_repair_1FIRST	Не робити нічого	true
cdir_events_dilemma_choice_details_localised_choice_title_att_subject_domestic_eastern_the_chovgan_tourney_1THIRD	Він не повинен ховатися, всі благородні люди можуть змагатися на рівних. Виділимо йому кошти.	true
cdir_events_dilemma_choice_details_localised_choice_title_att_subject_domestic_barb_nomad_stolen_swordSECOND	Приведемо сюди обох і з'ясуємо, хто винен.	true
cdir_events_dilemma_choice_details_localised_choice_label_ollam_ri_pictiFIRST	Він йде до озера.	true
cdir_events_dilemma_choice_details_localised_choice_label_att_subject_domestic_none_workers_on_strike_1SECOND	Розігнати натовп	true
cdir_events_dilemma_choice_details_localised_choice_label_att_subject_politics_civil_challengerSECOND	Змусити його замовкнути	true
cdir_events_dilemma_choice_details_localised_choice_title_att_subject_diplomatic_none_tribute_1SECOND	Ну хто ж відмовиться від такого щедрого подарунка, відкине такий благородний жест?	true
cdir_events_dilemma_choice_details_localised_choice_title_att_political_action_dilemma_seek_office_obstructionFIRST	Давним-давно ми зробили йому чимало благодіянь. Прийшов час попросити про послугу у відповідь...	true
cdir_events_dilemma_choice_details_localised_choice_title_att_political_action_dilemma_adoption_added_incentiveFIRST	Може, це його переконає?	true
cdir_events_dilemma_choice_details_localised_choice_title_ollam_ri_A1iiSECOND	Простий і ефективний спосіб виграти будь-який поєдинок волі.	true
cdir_events_dilemma_choice_details_localised_choice_title_att_subject_politics_civil_hostageSECOND	Хлопчик знадобиться тобі і як заручник.	true
cdir_events_dilemma_choice_details_localised_choice_label_att_subject_religious_christian_the_money_lender_1THIRD	Стратити його	true
cdir_events_dilemma_choice_details_localised_choice_title_att_political_action_dilemma_secure_loyalty_briberyFIRST	Кожного можна купити. Кожного.	true
cdir_events_dilemma_choice_details_localised_choice_title_att_political_action_dilemma_assassinate_suspiciousTHIRD	Нехай собі пліткують і гадають. Яке нам діло до того, про що теревенять селяни?	true
cdir_events_dilemma_choice_details_localised_choice_title_att_subject_military_nomad_master_swordsmithFOURTH	У вас є більш важливі справи.	true
cdir_events_dilemma_choice_details_localised_choice_label_slav_dilemma_venedians_2THIRD	Не давати нічого	true
cdir_events_dilemma_choice_details_localised_choice_label_slav_dilemma_venedians_3FIRST	Заплатити данину	true
cdir_events_dilemma_choice_details_localised_choice_title_att_dilemma_domestic_roman_saint_telemachus_1SECOND	Ці ігри - священна традиція, що сягає корінням у глибину часів. Вони повинні тривати!	true
cdir_events_dilemma_choice_details_localised_choice_title_att_political_action_dilemma_seek_office_obstructionTHIRD	Не варто витрачати на нього час. У нас є більш важливі справи.	true
cdir_events_dilemma_choice_details_localised_choice_title_att_political_action_dilemma_adoption_added_incentiveTHIRD	Або він приєднається до нас, або йому доведеться змиритися з наслідками.	true
cdir_events_dilemma_choice_details_localised_choice_label_ollam_ri_A1SECOND	Дивитися їй в очі.	true
cdir_events_dilemma_choice_details_localised_choice_label_ollam_ri_A2SECOND	Спробувати вмовити його.	true
cdir_events_dilemma_choice_details_localised_choice_label_ollam_ri_A3SECOND	Підійти до неї.	true
cdir_events_dilemma_choice_details_localised_choice_label_ollam_ri_B1SECOND	Залишити шкуру собі.	true
cdir_events_dilemma_choice_details_localised_choice_label_ollam_ri_B2SECOND	Пощадити його.	true
cdir_events_dilemma_choice_details_localised_choice_title_att_dilemma_religious_celtic_religious_sanctions_1SECOND	Ми повинні прийняти закон, що обмежує права єретиків молитися.	true
cdir_events_dilemma_choice_details_localised_choice_label_att_subject_religious_christian_the_money_lender_1FIRST	Не звертати уваги	true
cdir_events_dilemma_choice_details_localised_choice_title_att_political_action_dilemma_secure_loyalty_briberyTHIRD	Його доля нас не хвилює. Ми займаємося більш важливими справами.	true
cdir_events_dilemma_choice_details_localised_choice_title_att_political_action_dilemma_assassinate_suspiciousFIRST	Вони повинні зробити все, щоб не залишити доказів.	true
cdir_events_dilemma_choice_details_localised_choice_title_att_subject_politics_rome_corruptionSECOND	Мудрий правитель прислухається до думки народу.	true
cdir_events_dilemma_choice_details_localised_choice_label_slav_dilemma_venedians_3THIRD	Не давати нічого	true
cdir_events_dilemma_choice_details_localised_choice_label_slav_dilemma_venedians_2FIRST	Заплатити данину	true
cdir_events_dilemma_choice_details_localised_choice_label_att_dilemma_military_none_war_child_1SECOND	Залишити дитину	true
cdir_events_dilemma_choice_details_localised_choice_title_att_subject_politics_civil_secret_meetingsSECOND	Цікаво, чого вони хочуть? Треба сходити і поговорити з ними.	true
cdir_events_dilemma_choice_details_localised_choice_title_att_subject_military_none_the_spy_1FOURTH	Давай переманемо його на наш бік.	true
cdir_events_dilemma_choice_details_localised_choice_title_att_eos_religious_event_rebellion_att_fact_axum_att_rel_church_eastSECOND	Його народ достатньо страждав, зробимо виняток для нього, якщо це можливо.	true
cdir_events_dilemma_choice_details_localised_choice_label_att_subject_religious_hun_lightningFOURTH	Не робити нічого	true
cdir_events_dilemma_choice_details_localised_choice_label_slav_dilemma_venedians_1FIRST	Заплатити данину	true
cdir_events_dilemma_choice_details_localised_choice_title_att_political_action_dilemma_gather_support_oppositionTHIRD	Це нас не стосується. Ми займаємося більш важливими справами.	true
cdir_events_dilemma_choice_details_localised_choice_title_att_subject_military_roman_master_hostile_governorSECOND	Доручити пліткарям зганьбити цього дурня.	true
cdir_events_dilemma_choice_details_localised_choice_title_att_dilemma_religious_catholic_religious_sanctions_1SECOND	Ми повинні прийняти закон, що обмежує права єретиків молитися.	true
cdir_events_dilemma_choice_details_localised_choice_label_cha_dilemma_saxon_1SECOND	Не робити нічого	true
cdir_events_dilemma_choice_details_localised_choice_label_att_subject_religious_barb_strangerSECOND	Отримати відомості	true
cdir_events_dilemma_choice_details_localised_choice_label_slav_dilemma_venedians_1THIRD	Не давати нічого	true
cdir_events_dilemma_choice_details_localised_choice_label_att_dilemma_religious_christian_the_council_of_toledo_1FIRST	Голосувати за Присцилліана	true
cdir_events_dilemma_choice_details_localised_choice_title_att_political_action_dilemma_gather_support_oppositionFIRST	Ми повинні будь-якою ціною довести цю справу до кінця.	true
cdir_events_dilemma_choice_details_localised_choice_label_att_political_action_dilemma_adoption_added_incentiveSECOND	Указ	true
cdir_events_dilemma_choice_details_localised_choice_label_ybor_level_A_burgundiFIRST	Розкішний меч	true
cdir_events_dilemma_choice_details_localised_choice_title_att_subject_domestic_civil_master_agitatorFOURTH	Борги простолюдинів - їхня особиста справа.	true
cdir_events_dilemma_choice_details_localised_choice_title_att_political_action_dilemma_seek_office_obstructionSECOND	Воля вождя - закон.	true
cdir_events_dilemma_choice_details_localised_choice_title_att_subject_religious_barb_strangerFOURTH	У нас немає часу на подібні дрібниці.	true
cdir_events_dilemma_choice_details_localised_choice_label_att_subject_military_none_the_spy_1SECOND	Допитати його	true
cdir_events_dilemma_choice_details_localised_choice_label_ollam_ri_A1iSECOND	Викрасти чашу.	true
cdir_events_dilemma_choice_details_localised_choice_title_att_dilemma_religious_orthodox_religious_sanctions_1SECOND	Ми повинні прийняти закон, що обмежує права єретиків молитися.	true
cdir_events_dilemma_choice_details_localised_choice_title_att_subject_religious_hun_lightningSECOND	Якщо ти підтримаєш його, він всім розповість про твої злі справи.	true
cdir_events_dilemma_choice_details_localised_choice_label_slav_dilemma_sclaveneans_1FIRST	Перейти в наступ	true
cdir_events_dilemma_choice_details_localised_choice_title_att_dilemma_religious_germanic_religious_sanctions_1SECOND	Ми повинні прийняти закон, що обмежує права язичників молитися.	true
cdir_events_dilemma_choice_details_localised_choice_title_att_political_action_dilemma_adoption_added_incentiveFOURTH	Він того не вартий.	true
cdir_events_dilemma_choice_details_localised_choice_label_att_subject_domestic_none_withholding_taxes_1SECOND	Вислати війська	true
cdir_events_dilemma_choice_details_localised_choice_title_att_subject_politics_nomad_hostageSECOND	Хлопчик знадобиться тобі і як заручник.	true
cdir_events_dilemma_choice_details_localised_choice_title_att_subject_politics_roman_hostageSECOND	Хлопчик знадобиться тобі і як заручник.	true
cdir_events_dilemma_choice_details_localised_choice_label_att_subject_religious_hun_lightningFIRST	Усиновити його	true
cdir_events_dilemma_choice_details_localised_choice_label_political_event_assassinationFIRST	Підготуватися	true
cdir_events_dilemma_choice_details_localised_choice_label_slav_dilemma_venedians_4THIRD	Не давати нічого	true
cdir_events_dilemma_choice_details_localised_choice_title_att_subject_domestic_none_the_festival_1THIRD	Ми повинні прославляти полководців і перемоги, які зробили наш народ великим. Демонстрація грубої сили ще нікому не шкодила!	true
cdir_events_dilemma_choice_details_localised_choice_label_att_subject_domestic_nordic_the_flyting_1THIRD	Доручити воїну	true
cdir_events_dilemma_choice_details_localised_choice_label_att_subject_religious_hun_lightningTHIRD	Вбити його	true
cdir_events_dilemma_choice_details_localised_choice_label_att_subject_domestic_nomad_sword_of_attilaFOURTH	Не робити нічого	true
cdir_events_dilemma_choice_details_localised_choice_label_slav_dilemma_venedians_4FIRST	Заплатити данину	true
cdir_events_dilemma_choice_details_localised_choice_title_att_subject_domestic_none_the_festival_1FIRST	У такий час ти говориш про святкування? Серйозно? Щоб я більше цього не чув при мені.	true
cdir_events_dilemma_choice_details_localised_choice_label_att_subject_domestic_nordic_the_flyting_1FIRST	Не звертати уваги	true
cdir_events_dilemma_choice_details_localised_choice_title_ybor_level_A_burgundiSECOND	Жерці кажуть, що вона дарує мудрість і захист Годана.	true
cdir_events_dilemma_choice_details_localised_choice_label_att_political_action_dilemma_seek_office_obstructionFIRST	Політична допомога	true
cdir_events_dilemma_choice_details_localised_choice_title_att_subject_religious_christian_the_money_lender_1FIRST	Цього разу ми закриємо очі на його дії. Він уже не раз вірно служив нам.	true
cdir_events_dilemma_choice_details_localised_choice_label_att_subject_domestic_nomad_sword_of_attilaSECOND	Відіслати його геть	true
cdir_events_dilemma_choice_details_localised_choice_title_att_dilemma_military_none_war_child_1SECOND	Ми не можемо доглядати за цією дитиною. Віддай її рабу.	true
cdir_events_dilemma_choice_details_localised_choice_title_slav_dilemma_venedians_3FIRST	Їм потрібні лише гроші. Наші життя коштують набагато дорожче.	true
cdir_events_dilemma_choice_details_localised_choice_title_slav_dilemma_venedians_2THIRD	Ми не схиляємося ні перед ким. Не давайте їм нічого.	true
cdir_events_dilemma_choice_details_localised_choice_label_ollam_ri_A1iiSECOND	Вдарити її по морді.	true
cdir_events_dilemma_choice_details_localised_choice_title_att_subject_politics_nomad_hostageFOURTH	Це просто дрібниця, нехай інші розбираються з ним.	true
cdir_events_dilemma_choice_details_localised_choice_title_att_subject_politics_roman_hostageFOURTH	Це просто дрібниця, нехай інші розбираються з ним.	true
cdir_events_dilemma_choice_details_localised_choice_title_ollam_ri_A1SECOND	Кішка повинна поважати короля!	true
cdir_events_dilemma_choice_details_localised_choice_title_ollam_ri_A2SECOND	Легендарний король може стати корисним союзником.	true
cdir_events_dilemma_choice_details_localised_choice_title_ollam_ri_A3SECOND	Вона може багато чому навчити короля.	true
cdir_events_dilemma_choice_details_localised_choice_title_ollam_ri_B1SECOND	Якби шкура була чарівною, вони б самі скористалися нею.	true
cdir_events_dilemma_choice_details_localised_choice_title_ollam_ri_B2SECOND	Можливо, так він спокутує свої злочини.	true
cdir_events_dilemma_choice_details_localised_choice_label_att_political_action_dilemma_seek_office_obstructionTHIRD	Неважливо	true
cdir_events_dilemma_choice_details_localised_choice_title_att_subject_religious_christian_the_money_lender_1THIRD	Він - брудний брехун, це очевидно, і тому заслуговує смерті.	true
cdir_events_dilemma_choice_details_localised_choice_label_att_subject_domestic_barb_nomad_enemy_tradeFIRST	Стратити його	true
cdir_events_dilemma_choice_details_localised_choice_label_att_subject_domestic_barb_nomad_stolen_swordSECOND	Вирішити суперечку	true
cdir_events_dilemma_choice_details_localised_choice_title_slav_dilemma_venedians_2FIRST	Їм потрібні лише гроші. Наші життя коштують набагато дорожче.	true
cdir_events_dilemma_choice_details_localised_choice_title_slav_dilemma_venedians_3THIRD	Ми не схиляємося ні перед ким. Не давайте їм нічого.	true
cdir_events_dilemma_choice_details_localised_choice_label_att_dilemma_domestic_roman_saint_telemachus_1SECOND	Кинути протестувальників у темницю	true
cdir_events_dilemma_choice_details_localised_choice_label_att_subject_military_none_the_spy_1FOURTH	Найняти його	true
cdir_events_dilemma_choice_details_localised_choice_label_att_eos_religious_event_rebellion_att_fact_axum_att_rel_church_eastSECOND	Підкупити його	true
cdir_events_dilemma_choice_details_localised_choice_title_att_subject_religious_hun_lightningFOURTH	Це просто забава для селян. Відпустити його.	true
cdir_events_dilemma_choice_details_localised_choice_title_att_political_action_dilemma_adoption_added_incentiveSECOND	Якщо його володар забажає, йому доведеться підкоритися!	true
cdir_events_dilemma_choice_details_localised_choice_title_slav_dilemma_venedians_1FIRST	Їм потрібні лише гроші. Наші життя коштують набагато дорожче.	true
cdir_events_dilemma_choice_details_localised_choice_label_att_political_action_dilemma_gather_support_oppositionFIRST	Усі засоби хороші	true
cdir_events_dilemma_choice_details_localised_choice_title_att_subject_domestic_civil_master_agitatorSECOND	Зменшення податків з окремих обраних громадян допоможе заспокоїти маси.	true
cdir_events_dilemma_choice_details_localised_choice_title_att_subject_religious_barb_strangerSECOND	Клинок у спині - переконлива причина вирушити в дорогу.	true
cdir_events_dilemma_choice_details_localised_choice_label_att_eos_religious_event_rebellion_att_fact_himyar_att_rel_semitic_paganismSECOND	Підкупити його	true
cdir_events_dilemma_choice_details_localised_choice_title_cha_dilemma_saxon_1SECOND	Нам не потрібен ні ваш бог, ні ваші обіцянки! Навіть якщо ви нас вб'єте, наше життя продовжиться в самій землі!	true
cdir_events_dilemma_choice_details_localised_choice_title_slav_dilemma_venedians_1THIRD	Ми не схиляємося ні перед ким. Не давайте їм нічого.	true
cdir_events_dilemma_choice_details_localised_choice_label_att_political_action_dilemma_gather_support_oppositionTHIRD	Неважливо	true
cdir_events_dilemma_choice_details_localised_choice_title_att_eos_religious_event_rebellion_att_fact_axum_att_rel_church_eastFIRST	Ми не будемо витрачати на цих єретиків ні час, ні гроші. Їхні погрози - порожні слова!	true
cdir_events_dilemma_choice_details_localised_choice_title_att_subject_military_roman_master_hostile_governorFOURTH	Чи стане натовп слухати його брехливі промови? Навряд чи.	true
cdir_events_dilemma_choice_details_localised_choice_title_slav_dilemma_sclaveneans_1FIRST	Склавини не ухиляються від бою і не чекають його. Ми атакуємо першими!	true
cdir_events_dilemma_choice_details_localised_choice_label_att_subject_religious_barb_strangerFOURTH	Не робити нічого	true
cdir_events_dilemma_choice_details_localised_choice_title_att_subject_domestic_none_withholding_taxes_1SECOND	Відправимо туди солдатів, нехай заберуть те, що належить нам по праву. Тих, хто чинитиме опір, вбити.	true
cdir_events_dilemma_choice_details_localised_choice_label_att_political_action_dilemma_adoption_added_incentiveFOURTH	Неважливо	true
cdir_events_dilemma_choice_details_localised_choice_label_att_subject_diplomatic_none_the_feast_1FIRST	Ігнорувати прохання	true
cdir_events_dilemma_choice_details_localised_choice_label_att_subject_domestic_nomadic_the_kassai_contest_1FIRST	Не звертати уваги	true
cdir_events_dilemma_choice_details_localised_choice_title_att_subject_politics_civil_secret_meetingsFOURTH	Ворогів краще тримати під контролем. Треба дати їм посади у владі.	true
cdir_events_dilemma_choice_details_localised_choice_title_att_subject_military_none_the_spy_1SECOND	Він напевно щось знає про наших ворогів. Ми повинні з'ясувати, що йому відомо.	true
cdir_events_dilemma_choice_details_localised_choice_title_att_dilemma_religious_tengri_religious_sanctions_1SECOND	Ми повинні прийняти закон, що обмежує права язичників молитися.	true
cdir_events_dilemma_choice_details_localised_choice_label_att_subject_domestic_none_foreign_migrants_1SECOND	Вигнати їх	true
cdir_events_dilemma_choice_details_localised_choice_label_att_dilemma_religious_hellenic_religious_sanctions_1SECOND	Ввести санкції	true
cdir_events_dilemma_choice_details_localised_choice_label_att_subject_religious_hun_lightningSECOND	Стати його покровителем	true
cdir_events_dilemma_choice_details_localised_choice_label_att_subject_diplomatic_none_the_feast_1THIRD	Запросити союзників	true
cdir_events_dilemma_choice_details_localised_choice_title_att_eos_sassanid_insult_1FIRST	Відкрито кинути виклик шахіншаху, ризикуючи накликати на себе його гнів.	true
cdir_events_dilemma_choice_details_localised_choice_label_att_subject_domestic_nomadic_the_kassai_contest_1THIRD	Оплатити участь	true
cdir_events_dilemma_choice_details_localised_choice_label_ybor_level_A_alamanniFIRST	Розкішний меч	true
cdir_events_dilemma_choice_details_localised_choice_title_att_subject_politics_rome_corruptionFOURTH	З таким Сенатом Рим простояв уже кілька століть - і простоїть ще стільки ж.	true
cdir_events_dilemma_choice_details_localised_choice_title_slav_dilemma_venedians_4THIRD	Ми не схиляємося ні перед ким. Не давайте їм нічого.	true
cdir_events_dilemma_choice_details_localised_choice_label_ybor_level_A_burgundiSECOND	Брошка	true
cdir_events_dilemma_choice_details_localised_choice_title_att_eos_sassanid_insult_2FIRST	Як він сміє таке говорити! Вигнати його - і плювати на наслідки!	true
cdir_events_dilemma_choice_details_localised_choice_label_att_subject_domestic_none_the_festival_1THIRD	Військові перемоги	true
cdir_events_dilemma_choice_details_localised_choice_title_att_subject_politics_civil_hostageFOURTH	Це просто дрібниця, нехай інші розбираються з ним.	true
cdir_events_dilemma_choice_details_localised_choice_title_att_subject_military_nomad_master_swordsmithSECOND	Люди низького стану повинні знати своє місце.	true
cdir_events_dilemma_choice_details_localised_choice_title_att_subject_military_none_drunk_on_watch_1SECOND	Він повинен стати прикладом для інших. Покараємо його на очах у всіх.	true
cdir_events_dilemma_choice_details_localised_choice_title_slav_dilemma_venedians_4FIRST	Їм потрібні лише гроші. Наші життя коштують набагато дорожче.	true
cdir_events_dilemma_choice_details_localised_choice_title_att_eos_sassanid_insult_3FIRST	Скажіть, що ви розумієте його, але ваш обов'язок правителя - захищати підданих.	true
cdir_events_dilemma_choice_details_localised_choice_label_att_subject_domestic_none_the_festival_1FIRST	Не звертати уваги	true
cdir_events_dilemma_choice_details_localised_choice_title_att_subject_domestic_barb_nomad_enemy_tradeSECOND	Нехай цей дурень стане прикладом для всіх.	true
cdir_events_dilemma_choice_details_localised_choice_title_political_event_ministerial_positionSECOND	Підвищити його в посаді. Подивимося, як він впорається з новою роллю.	true
cdir_events_dilemma_choice_details_localised_choice_label_att_subject_religious_none_the_holy_site_1FIRST	Не звертати уваги	true
cdir_events_dilemma_choice_details_localised_choice_label_att_subject_religious_none_the_relic_seller_1SECOND	Прийняти хабар	true
cdir_events_dilemma_choice_details_localised_choice_label_att_subject_religious_tengri_illegal_practice_1FIRST	Стратити його	true
cdir_events_dilemma_choice_details_localised_choice_title_att_subject_domestic_eastern_the_chovgan_tourney_1SECOND	Ця людина відіграє занадто важливу роль у нашій стратегії. Ми не маємо права ним жертвувати.	true
cdir_events_dilemma_choice_details_localised_choice_title_cha_dilemma_verdenSECOND	Зберіть їхніх ватажків. Вони ПОВІРЯТЬ в Єдиного Бога.	true
cdir_events_dilemma_choice_details_localised_choice_title_ollam_ri_ASECOND	Яка ще зброя може звучати і бути кубком?	true
cdir_events_dilemma_choice_details_localised_choice_title_ollam_ri_BSECOND	Свинею? Та їх варто стратити за одну цю брехню!	true
cdir_events_dilemma_choice_details_localised_choice_title_att_dilemma_religious_christian_council_of_ephesus_1SECOND	Несторій має право висловлювати свою думку, нехай навіть вона відрізняється від поглядів папи.	true
cdir_events_dilemma_choice_details_localised_choice_label_att_subject_religious_none_the_holy_site_1THIRD	Брати плату за вхід	true
cdir_events_dilemma_choice_details_localised_choice_title_political_event_assassinationSECOND	Нові чутки? Як це нудно!	true
cdir_events_dilemma_choice_details_localised_choice_label_att_subject_military_none_the_gift_of_speed_1SECOND	Поставити їх у стійла	true
cdir_events_dilemma_choice_details_localised_choice_title_att_dilemma_religious_arian_religious_sanctions_1FIRST	Для нас всі люди рівні. До аріан потрібно ставитися так само, як і до всіх інших.	true
cdir_events_dilemma_choice_details_localised_choice_label_att_subject_religious_tengri_illegal_practice_1THIRD	Залишити його у в'язниці	true
cdir_events_dilemma_choice_details_localised_choice_title_att_subject_domestic_barb_temple_sacrilegeFOURTH	Якщо боги захочуть його покарати, вони зроблять це самі.	true
cdir_events_dilemma_choice_details_localised_choice_title_att_subject_religious_christian_the_money_lender_1SECOND	Він згрішив проти Господа, а не держави. Нехай з ним розбирається церква.	true
cdir_events_dilemma_choice_details_localised_choice_label_att_bel_request_justinian_narses_1SECOND	Відсторонити від справ	true
cdir_events_dilemma_choice_details_localised_choice_label_att_bel_request_theodosia_ioannina_1SECOND	Вбити Анастасія	true
cdir_events_dilemma_choice_details_localised_choice_label_att_subject_religious_hellenic_pilgrims_1THIRD	Дозволити	true
cdir_events_dilemma_choice_details_localised_choice_title_att_subject_religious_hellenic_illegal_practice_1THIRD	Він поклоняється лжебогам. Хай подумає про це, поки гниє в темниці!	true
cdir_events_dilemma_choice_details_localised_choice_title_att_political_action_dilemma_assassinate_suspiciousSECOND	Не може бути. Вони... в той час вони виконували доручення монарха!	true
cdir_events_dilemma_choice_details_localised_choice_label_slav_dilemma_sclaveneans_1SECOND	Готуватися до оборони	true
cdir_events_dilemma_choice_details_localised_choice_title_political_event_marriage_maleFIRST	Це невідповідна партія. Ми не можемо допустити укладення такого союзу.	true
cdir_events_dilemma_choice_details_localised_choice_label_att_subject_religious_hellenic_pilgrims_1FIRST	Не звертати уваги	true
cdir_events_dilemma_choice_details_localised_choice_title_att_subject_religious_hellenic_illegal_practice_1FIRST	Убити цього мерзенного язичника на пострах іншим.	true
cdir_events_dilemma_choice_details_localised_choice_label_att_eos_marib_dam_repair_0SECOND	Дрібний ремонт	true
cdir_events_dilemma_choice_details_localised_choice_label_att_eos_marib_dam_repair_1SECOND	Дрібний ремонт	true
cdir_events_dilemma_choice_details_localised_choice_label_att_eos_marib_dam_repair_2SECOND	Дрібний ремонт	true
cdir_events_dilemma_choice_details_localised_choice_label_att_eos_marib_dam_repair_3SECOND	Дрібний ремонт	true
cdir_events_dilemma_choice_details_localised_choice_title_ollam_ri_A1iiFIRST	Король не боїться ні звіра, ні людини.	true
cdir_events_dilemma_choice_details_localised_choice_label_att_dilemma_religious_celtic_religious_sanctions_1FIRST	Надати їм рівні права	true
cdir_events_dilemma_choice_details_localised_choice_label_att_subject_military_nomad_master_swordsmithFIRST	Зробити його рабом	true
cdir_events_dilemma_choice_details_localised_choice_title_att_subject_religious_none_the_true_cross_1SECOND	Ми могли б виставити цю річ у церкві. Люди будуть приходити здалеку, щоб подивитися на неї.	true
cdir_events_dilemma_choice_details_localised_choice_label_att_subject_religious_barb_bloodlessFOURTH	Не робити нічого	true
cdir_events_dilemma_choice_details_localised_choice_title_cha_dilemma_lombard_pope_demands_2FOURTH	Навіть якщо Карл Великий підтримає папу, я все одно відмовлю. Хто вони такі, щоб вирішувати долю ломбардів?	true
cdir_events_dilemma_choice_details_localised_choice_label_att_bel_request_justinian_narses_1FIRST	Призначити на посаду	true
cdir_events_dilemma_choice_details_localised_choice_label_att_subject_religious_christian_pontifex_maximus_1FIRST	Дочекатися результатів	true
cdir_events_dilemma_choice_details_localised_choice_title_att_subject_diplomatic_none_diplomatic_dispute_1FIRST	Напевно, в ньому просто говорив хміль. Всі ми час від часу поводимося необачно.	true
cdir_events_dilemma_choice_details_localised_choice_label_att_subject_religious_christian_the_black_sheep_1THIRD	Позбавити священника сану	true
cdir_events_dilemma_choice_details_localised_choice_label_att_subject_domestic_civil_hostile_disputeSECOND	Відіслати його	true
cdir_events_dilemma_choice_details_localised_choice_label_att_subject_military_nomad_master_swordsmithTHIRD	Звільнити його	true
cdir_events_dilemma_choice_details_localised_choice_title_att_subject_religious_zoroastrian_illegal_practice_1SECOND	Ми терпимо ставимося до чужих вірувань. Відпусти його.	true
cdir_events_dilemma_choice_details_localised_choice_label_att_subject_religious_christian_pontifex_maximus_1THIRD	Відкликати кандидата	true
cdir_events_dilemma_choice_details_localised_choice_label_att_bel_request_antoninia_thedosius_1SECOND	Відмовитися	true
cdir_events_dilemma_choice_details_localised_choice_label_att_bel_request_theodosia_pope_1FIRST	Змістити його	true
cdir_events_dilemma_choice_details_localised_choice_title_att_subject_diplomatic_none_diplomatic_dispute_1THIRD	Замкни цього тупицю десь подалі, з очей геть, тоді його промови нікому не зашкодять.	true
cdir_events_dilemma_choice_details_localised_choice_label_att_subject_religious_christian_the_black_sheep_1FIRST	Не звертати уваги	true
cdir_events_dilemma_choice_details_localised_choice_title_att_subject_religious_zoroastrian_pilgrims_1SECOND	Розігнати сектантів. Тих, хто не піде до сходу сонця, вбити.	true
cdir_events_dilemma_choice_details_localised_choice_label_cha_dilemma_mercia_1SECOND	Затримати його	true
cdir_events_dilemma_choice_details_localised_choice_title_att_political_action_dilemma_secure_loyalty_briberySECOND	Може, якась дрібничка допоможе схилити його на наш бік?	true
cdir_events_dilemma_choice_details_localised_choice_title_att_subject_religious_tengri_pilgrims_1THIRD	Нехай вони і дикуни, але це місце для них священне. Хто ми такі, щоб заважати їм?	true
cdir_events_dilemma_choice_details_localised_choice_label_att_subject_domestic_all_stone_masonSECOND	Відіслати його геть	true
cdir_events_dilemma_choice_details_localised_choice_label_att_subject_politics_barb_nomad_challengerSECOND	Змусити його замовкнути	true
cdir_events_dilemma_choice_details_localised_choice_label_att_subject_domestic_none_excess_materials_1SECOND	Використати їх	true
cdir_events_dilemma_choice_details_localised_choice_title_att_subject_military_none_the_gift_of_speed_1FOURTH	Ці коні, очевидно, коштують недешево.	true
cdir_events_dilemma_choice_details_localised_choice_title_att_subject_religious_tengri_pilgrims_1FIRST	Їхні справи нас не стосуються.	true
cdir_events_dilemma_choice_details_localised_choice_label_att_subject_domestic_barb_nomad_enemy_tradeSECOND	Покарати його	true
cdir_events_dilemma_choice_details_localised_choice_label_att_subject_diplomatic_none_border_dispute_1SECOND	Повернути землю силою	true
cdir_events_dilemma_choice_details_localised_choice_label_att_subject_domestic_all_stone_masonFOURTH	Не робити нічого	true
cdir_events_dilemma_choice_details_localised_choice_title_att_political_action_dilemma_embezzlement_suspiciousSECOND	Не може бути. Вони... в той час вони виконували доручення монарха!	true
cdir_events_dilemma_choice_details_localised_choice_label_att_subject_politics_barb_nomad_challengerFOURTH	Взяти його на службу	true
cdir_events_dilemma_choice_details_localised_choice_title_att_subject_religious_none_the_holy_site_1THIRD	Чому б не брати гроші з паломників? Де ж твоя підприємницька жилка?	true
cdir_events_dilemma_choice_details_localised_choice_label_political_event_assassinationSECOND	Ігнорувати	true
cdir_events_dilemma_choice_details_localised_choice_label_cha_dilemma_pope_help_1FIRST	Прийняти сторону папи	true
cdir_events_dilemma_choice_details_localised_choice_label_att_subject_military_none_the_lanista_1THIRD	Найняти його	true
cdir_events_dilemma_choice_details_localised_choice_title_att_subject_military_none_the_gift_of_speed_1SECOND	Нехай дадуть потомство. На цьому можна заробити чималі гроші.	true
cdir_events_dilemma_choice_details_localised_choice_title_att_subject_religious_none_the_holy_site_1FIRST	Сам з ним розбирайся, старий.	true
cdir_events_dilemma_choice_details_localised_choice_title_att_subject_religious_none_the_relic_seller_1SECOND	Він просто торговець, який намагається заробити собі на життя. Такою винахідливістю слід захоплюватися!	true
cdir_events_dilemma_choice_details_localised_choice_label_att_subject_military_none_the_lanista_1FIRST	Проігнорувати його	true
cdir_events_dilemma_choice_details_localised_choice_label_att_subject_domestic_civil_hostile_disputeFOURTH	Не робити нічого	true
cdir_events_dilemma_choice_details_localised_choice_title_att_subject_politics_civil_challengerFIRST	Чим спокійніший народ, тим менше проблем.	true
cdir_events_dilemma_choice_details_localised_choice_title_cha_dilemma_charlemagne_daughter_1SECOND	Хто з нас не гуляв ночами з друзями?	true
cdir_events_dilemma_choice_details_localised_choice_title_cha_dilemma_viking_1_cha_fact_merciaSECOND	Ці родючі землі подарують майбутнє нашому народу. Не сумніваюся, ми знайдемо, кого грабувати замість вас.	true
cdir_events_dilemma_choice_details_localised_choice_label_att_subject_religious_germanic_illegal_practice_1THIRD	Залишити його у в'язниці	true
cdir_events_dilemma_choice_details_localised_choice_title_att_subject_religious_germanic_pilgrims_1THIRD	Ці місця священні для них. Що з того, якщо ми залишимо їх у спокої?	true
cdir_events_dilemma_choice_details_localised_choice_title_att_subject_military_none_mercenary_commander_1THIRD	Зайвих солдатів не буває. Може, ми зможемо домовитися на загальну вигоду?	true
cdir_events_dilemma_choice_details_localised_choice_label_att_subject_religious_orthodox_illegal_practice_1THIRD	Залишити його у в'язниці	true
cdir_events_dilemma_choice_details_localised_choice_title_att_subject_religious_none_the_golden_tongued_1FIRST	Він повинен направляти на шлях істинний місцевих жителів. Нехай залишається.	true
cdir_events_dilemma_choice_details_localised_choice_title_att_subject_religious_celtic_pilgrims_1THIRD	Це місце для них священне. Хто ми такі, щоб заважати їм?	true
cdir_events_dilemma_choice_details_localised_choice_label_att_eos_marib_dam_repair_0FOURTH	Повний ремонт	true
cdir_events_dilemma_choice_details_localised_choice_label_att_eos_marib_dam_repair_1FOURTH	Повний ремонт	true
cdir_events_dilemma_choice_details_localised_choice_label_att_eos_marib_dam_repair_2FOURTH	Повний ремонт	true
cdir_events_dilemma_choice_details_localised_choice_label_att_eos_marib_dam_repair_3FOURTH	Повний ремонт	true
cdir_events_dilemma_choice_details_localised_choice_title_att_subject_politics_civil_challengerTHIRD	Нехай він замовкне назавжди.	true
cdir_events_dilemma_choice_details_localised_choice_label_att_political_action_dilemma_assassinate_suspiciousSECOND	Надійне алібі	true
cdir_events_dilemma_choice_details_localised_choice_label_att_subject_religious_barb_bloodlessSECOND	Пожертвувати людину	true
cdir_events_dilemma_choice_details_localised_choice_title_cha_dilemma_lombard_pope_demands_1SECOND	Я не стану змінювати кордони через якісь договори між давно померлими людьми!	true
cdir_events_dilemma_choice_details_localised_choice_title_cha_dilemma_lombard_pope_demands_2SECOND	Наша земля дорожча за будь-яке золото. Зробіть папі таку пропозицію, перед якою він не встоїть, і проблема вирішиться сама собою!	true
cdir_events_dilemma_choice_details_localised_choice_title_cha_dilemma_lombard_pope_demands_3SECOND	Клянуся своїм мечем і всіма фібрами своєї душі, що ці землі залишаться частиною Ломбардії!	true
cdir_events_dilemma_choice_details_localised_choice_label_att_political_action_dilemma_diminish_popularity_followup_mercifulSECOND	Засудити	true
cdir_events_dilemma_choice_details_localised_choice_label_att_subject_religious_germanic_illegal_practice_1FIRST	Стратити його	true
cdir_events_dilemma_choice_details_localised_choice_title_att_subject_religious_germanic_pilgrims_1FIRST	Їхні справи нас не стосуються.	true
cdir_events_dilemma_choice_details_localised_choice_title_att_subject_military_none_mercenary_commander_1FIRST	На даний момент найманці нам не потрібні.	true
cdir_events_dilemma_choice_details_localised_choice_label_att_dilemma_religious_manichaeism_religious_sanctions_1FIRST	Надати їм рівні права	true
cdir_events_dilemma_choice_details_localised_choice_label_att_subject_religious_orthodox_illegal_practice_1FIRST	Стратити його	true
cdir_events_dilemma_choice_details_localised_choice_title_att_subject_religious_none_the_golden_tongued_1THIRD	Такому талановитому проповіднику не можна заважати. Нехай і далі творить добрі справи в нашій країні.	true
cdir_events_dilemma_choice_details_localised_choice_title_att_subject_religious_celtic_pilgrims_1FIRST	Їхні справи нас не обходять — аби тільки не задумали напасти на нас!	true
cdir_events_dilemma_choice_details_localised_choice_title_att_subject_military_nomad_master_swordsmithFIRST	Подивимося, що нам запропонує цей чужинець.	true
cdir_events_dilemma_choice_details_localised_choice_title_att_subject_religious_manichaeism_pilgrims_1SECOND	Розігнати сектантів. Тих, хто не піде до сходу сонця, вбити.	true
cdir_events_dilemma_choice_details_localised_choice_label_att_subject_religious_none_the_holy_site_1SECOND	Викупити землю	true
cdir_events_dilemma_choice_details_localised_choice_title_att_subject_religious_christian_pontifex_maximus_1THIRD	Ми не хочемо, щоб він став папою зараз.	true
cdir_events_dilemma_choice_details_localised_choice_label_att_subject_religious_none_the_true_cross_1SECOND	Купити реліквію	true
cdir_events_dilemma_choice_details_localised_choice_label_att_subject_religious_christian_candidate_for_bishopSECOND	Підкупити кардиналів	true
cdir_events_dilemma_choice_details_localised_choice_label_att_subject_religious_catholic_illegal_practice_1THIRD	Залишити його у в'язниці	true
cdir_events_dilemma_choice_details_localised_choice_title_att_subject_religious_catholic_pilgrims_1THIRD	Хто ми такі, щоб ставити під сумнів чужу віру?	true
cdir_events_dilemma_choice_details_localised_choice_title_att_bel_request_antoninia_thedosius_1SECOND	Я вже усиновив одного твого бастарда. З мене досить.	true
cdir_events_dilemma_choice_details_localised_choice_label_att_subject_diplomatic_none_diplomatic_dispute_1FIRST	Не звертати уваги	true
cdir_events_dilemma_choice_details_localised_choice_label_att_subject_religious_celtic_illegal_practice_1FIRST	Стратити її	true
cdir_events_dilemma_choice_details_localised_choice_title_att_dilemma_religious_celtic_religious_sanctions_1FIRST	Для нас всі люди рівні. До язичників потрібно ставитися так само, як і до всіх інших.	true
cdir_events_dilemma_choice_details_localised_choice_title_att_subject_military_nomad_master_swordsmithTHIRD	Напевно, вільна людина буде працювати краще, ніж та, що закута в ланцюги.	true
cdir_events_dilemma_choice_details_localised_choice_title_att_subject_domestic_barb_temple_sacrilegeSECOND	Нехай Юпітер вирішує його долю.	true
cdir_events_dilemma_choice_details_localised_choice_title_att_bel_request_justinian_narses_1FIRST	Людина, якій довіряєш ти, заслуговує і на мою довіру.	true
cdir_events_dilemma_choice_details_localised_choice_title_att_subject_religious_christian_pontifex_maximus_1FIRST	Ми не повинні втручатися в справи церкви.	true
cdir_events_dilemma_choice_details_localised_choice_label_att_subject_religious_catholic_illegal_practice_1FIRST	Стратити його	true
cdir_events_dilemma_choice_details_localised_choice_title_att_subject_religious_catholic_pilgrims_1FIRST	Їхні справи нас не стосуються.	true
cdir_events_dilemma_choice_details_localised_choice_label_att_subject_diplomatic_none_diplomatic_dispute_1THIRD	Заключити під варту	true
cdir_events_dilemma_choice_details_localised_choice_title_att_bel_request_theodosia_pope_1FIRST	Влада над душами важливіша за ниці мирські потреби. Я втручуся.	true
cdir_events_dilemma_choice_details_localised_choice_label_att_subject_religious_celtic_illegal_practice_1THIRD	Залишити її у в'язниці	true
cdir_events_dilemma_choice_details_localised_choice_label_att_subject_religious_barb_strangerTHIRD	Торгувати з ним	true
cdir_events_dilemma_choice_details_localised_choice_title_cha_dilemma_verdenFOURTH	Язичникам немає пощади! Вбити їх усіх - нехай в Саксонії править Єдиний Бог!	true
cdir_events_dilemma_choice_details_localised_choice_label_att_subject_domestic_civil_idiot_magistrateTHIRD	Вбити чиновника	true
cdir_events_dilemma_choice_details_localised_choice_label_att_political_action_dilemma_secure_loyalty_briberySECOND	Великий хабар	true
cdir_events_dilemma_choice_details_localised_choice_label_att_subject_religious_christian_pontifex_maximus_1SECOND	Змастити колеса	true
cdir_events_dilemma_choice_details_localised_choice_label_att_bel_request_theodosia_amalasuntha_1FIRST	Відмовитися від завдання	true
cdir_events_dilemma_choice_details_localised_choice_label_att_subject_military_none_the_gift_of_speed_1FOURTH	Продати їх	true
cdir_events_dilemma_choice_details_localised_choice_label_att_subject_religious_barb_strangerFIRST	Заплатити йому	true
cdir_events_dilemma_choice_details_localised_choice_label_att_subject_domestic_civil_idiot_magistrateFIRST	Передати посаду	true
cdir_events_dilemma_choice_details_localised_choice_title_att_subject_religious_manichaeism_illegal_practice_1SECOND	Ми терпимо ставимося до чужих вірувань. Відпусти його.	true
cdir_events_dilemma_choice_details_localised_choice_title_att_dilemma_religious_zoroastrian_religious_sanctions_1FIRST	Для нас всі люди рівні. До зороастрійців потрібно ставитися так само, як і до всіх інших.	true
cdir_events_dilemma_choice_details_localised_choice_label_att_subject_domestic_eastern_the_chovgan_tourney_1SECOND	Заборонити участь	true
cdir_events_dilemma_choice_details_localised_choice_label_att_subject_religious_zoroastrian_pilgrims_1SECOND	Заборонити	true
cdir_events_dilemma_choice_details_localised_choice_title_cha_dilemma_mercia_1SECOND	Поставте вартого біля його дверей. Він нікуди не піде!	true
cdir_events_dilemma_choice_details_localised_choice_label_ollam_ri_ASECOND	Ріг.	true
cdir_events_dilemma_choice_details_localised_choice_label_ollam_ri_BSECOND	Вбити їх.	true
cdir_events_dilemma_choice_details_localised_choice_label_cha_dilemma_verdenSECOND	Хрестити їх ватажків	true
cdir_events_dilemma_choice_details_localised_choice_title_att_subject_religious_tengri_illegal_practice_1THIRD	Навряд чи хтось зможе переконати цього дурня. Нехай гниє в темниці.	true
cdir_events_dilemma_choice_details_localised_choice_title_att_subject_domestic_all_stone_masonSECOND	Ми не потребуємо допомоги іноземців.	true
cdir_events_dilemma_choice_details_localised_choice_title_att_subject_domestic_none_excess_materials_1SECOND	Використовуй матеріали, коли будеш щось будувати. У господарстві все знадобиться.	true
cdir_events_dilemma_choice_details_localised_choice_label_political_event_marriage_maleSECOND	Благословити	true
cdir_events_dilemma_choice_details_localised_choice_title_att_dilemma_domestic_none_plentiful_harvest_1SECOND	Нам потрібно зберегти його на крайній випадок.	true
cdir_events_dilemma_choice_details_localised_choice_title_att_dilemma_religious_zoroastrian_the_manichean_heresy_1FIRST	Маніхейці становлять загрозу. Потрібно якомога швидше вигнати їх з наших земель!	true
cdir_events_dilemma_choice_details_localised_choice_title_att_subject_religious_tengri_illegal_practice_1FIRST	Вбити цього кретина - прилюдно, найповільнішим способом.	true
cdir_events_dilemma_choice_details_localised_choice_title_att_subject_politics_rome_corruptionTHIRD	Вислухаємо думку народу і Сенату.	true
cdir_events_dilemma_choice_details_localised_choice_title_att_subject_military_none_drunk_on_watch_1FIRST	Нам потрібно, щоб ці люди були на нашому боці. Зробимо йому догану, але не більше того.	true
cdir_events_dilemma_choice_details_localised_choice_label_ollam_ri_A1iiFIRST	Продовжити дивитися.	true
cdir_events_dilemma_choice_details_localised_choice_title_slav_dilemma_sclaveneans_1SECOND	Їхня зброя і лютість - ніщо перед нашою рішучістю. Нехай приходять!	true
cdir_events_dilemma_choice_details_localised_choice_title_att_subject_nomadic_tribal_strife_1SECOND	Хто сильний, той і правий.	true
cdir_events_dilemma_choice_details_localised_choice_title_att_subject_domestic_all_stone_masonTHIRD	Я не довіряю йому, в ньому є щось підозріле...	true
cdir_events_dilemma_choice_details_localised_choice_label_att_bel_request_antoninia_rumours_1SECOND	Вбити його	true
cdir_events_dilemma_choice_details_localised_choice_title_att_subject_religious_barb_bloodlessFOURTH	Тут ми нічого не можемо зробити.	true
cdir_events_dilemma_choice_details_localised_choice_title_att_subject_religious_christian_the_black_sheep_1THIRD	Мабуть, він знав про переконання сестри. Прожени його, а її покарай.	true
cdir_events_dilemma_choice_details_localised_choice_label_att_subject_domestic_barb_temple_sacrilegeFOURTH	Не робити нічого	true
cdir_events_dilemma_choice_details_localised_choice_label_att_subject_religious_christian_the_money_lender_1SECOND	Видати його жерцям	true
cdir_events_dilemma_choice_details_localised_choice_title_att_subject_politics_rome_corruptionFIRST	Тим, хто не служить Риму, немає місця в Сенаті.	true
cdir_events_dilemma_choice_details_localised_choice_title_att_subject_military_none_drunk_on_watch_1THIRD	Нехай кожен десяток тягне соломинки. І того, хто витягне коротку, вб'ють інші дев'ять.	true
cdir_events_dilemma_choice_details_localised_choice_label_att_subject_religious_zoroastrian_illegal_practice_1SECOND	Звільнити його	true
cdir_events_dilemma_choice_details_localised_choice_title_att_subject_domestic_all_stone_masonFIRST	Подумай, скільки величних будівель залишиться після тебе, якщо тобі буде служити така людина.	true
cdir_events_dilemma_choice_details_localised_choice_title_att_bel_request_justinian_narses_1SECOND	Прошу мене пробачити, але моє завдання настільки важливе, що я не можу довірити його нікому.	true
cdir_events_dilemma_choice_details_localised_choice_title_att_bel_request_justinian_photius_1SECOND	Моя дружина цілком підтримує мене. Я без неї не проживу.	true
cdir_events_dilemma_choice_details_localised_choice_title_att_dilemma_religious_christian_conference_of_carthage_1FIRST	Тільки Римська церква проповідує істинну віру. Ці люди - єретики.	true
cdir_events_dilemma_choice_details_localised_choice_title_att_subject_religious_christian_the_black_sheep_1FIRST	Нехай і далі дотримується старих звичаїв. Від цього шкоди не буде.	true
cdir_events_dilemma_choice_details_localised_choice_title_att_subject_domestic_civil_hostile_disputeSECOND	Вигнати його з очей, і народ все забуде.	true
cdir_events_dilemma_choice_details_localised_choice_title_att_bel_request_theodosia_ioannina_1SECOND	Не смій більше тиранити мою сім'ю. Я вчиню так, як вважаю за потрібне.	true
cdir_events_dilemma_choice_details_localised_choice_label_att_subject_religious_barb_bloodlessTHIRD	Спалити барана	true
cdir_events_dilemma_choice_details_localised_choice_label_att_subject_religious_hellenic_illegal_practice_1THIRD	Залишити його у в'язниці	true
cdir_events_dilemma_choice_details_localised_choice_title_att_subject_religious_hellenic_pilgrims_1THIRD	Це місце для них священне. Хто ми такі, щоб заважати їм?	true
cdir_events_dilemma_choice_details_localised_choice_title_att_eos_marib_dam_repair_0SECOND	Відправте туди десяток робітників, нехай зроблять що-небудь.	true
cdir_events_dilemma_choice_details_localised_choice_title_att_eos_marib_dam_repair_1SECOND	Відправте туди десяток робітників, нехай зроблять що-небудь.	true
cdir_events_dilemma_choice_details_localised_choice_title_att_eos_marib_dam_repair_2SECOND	Відправте туди десяток робітників, нехай зроблять що-небудь.	true
cdir_events_dilemma_choice_details_localised_choice_title_att_eos_marib_dam_repair_3SECOND	Відправте туди десяток робітників, нехай зроблять що-небудь.	true
cdir_events_dilemma_choice_details_localised_choice_label_political_event_ministerial_positionFIRST	Перешкодити просуванню	true
cdir_events_dilemma_choice_details_localised_choice_label_political_event_marriage_maleFIRST	Втрутитися	true
cdir_events_dilemma_choice_details_localised_choice_label_cha_dilemma_lombard_pope_demands_2FOURTH	Не поступатися	true
cdir_events_dilemma_choice_details_localised_choice_label_att_subject_religious_barb_bloodlessFIRST	Пожертвувати більше баранів	true
cdir_events_dilemma_choice_details_localised_choice_label_att_subject_religious_hellenic_illegal_practice_1FIRST	Стратити його	true
cdir_events_dilemma_choice_details_localised_choice_title_att_subject_religious_hellenic_pilgrims_1FIRST	Їхні справи нас не стосуються.	true
cdir_events_dilemma_choice_details_localised_choice_label_att_dilemma_religious_christian_council_of_carthage_1SECOND	Прийняти пелагіанство	true
cdir_events_dilemma_choice_details_localised_choice_label_ollam_ri_A1iFIRST	Шукати воду.	true
cdir_events_dilemma_choice_details_localised_choice_label_political_event_ministerial_positionSECOND	Не робити нічого	true
cdir_events_dilemma_choice_details_localised_choice_title_att_subject_politics_barb_nomad_challengerSECOND	Страх змусить його замовкнути.	true
cdir_events_dilemma_choice_details_localised_choice_label_att_subject_religious_tengri_pilgrims_1FIRST	Не звертати уваги	true
cdir_events_dilemma_choice_details_localised_choice_label_att_dilemma_religious_tengri_religious_sanctions_1FIRST	Дати їм рівні права	true
cdir_events_dilemma_choice_details_localised_choice_label_att_dilemma_religious_christian_council_of_ephesus_1SECOND	Встати на бік Несторія	true
cdir_events_dilemma_choice_details_localised_choice_label_att_dilemma_religious_arian_religious_sanctions_1FIRST	Дати їм рівні права	true
cdir_events_dilemma_choice_details_localised_choice_label_att_subject_religious_tengri_pilgrims_1THIRD	Дозволити	true
cdir_events_dilemma_choice_details_localised_choice_title_political_event_marriage_maleSECOND	Ми офіційно благословляємо цей союз.	true
cdir_events_dilemma_choice_details_localised_choice_label_att_dilemma_domestic_none_plentiful_harvest_1SECOND	Покласти на склад	true
cdir_events_dilemma_choice_details_localised_choice_title_att_subject_military_none_the_lanista_1FIRST	Він служив своїй країні вірою і правдою, тож нехай тепер живе спокійно.	true
cdir_events_dilemma_choice_details_localised_choice_title_att_subject_politics_barb_nomad_challengerFOURTH	Треба дати йому місце в раді.	true
cdir_events_dilemma_choice_details_localised_choice_label_att_subject_religious_manichaeism_illegal_practice_1SECOND	Звільнити його	true
cdir_events_dilemma_choice_details_localised_choice_label_att_dilemma_religious_zoroastrian_the_manichean_heresy_1FIRST	Вигнати їх	true
cdir_events_dilemma_choice_details_localised_choice_title_cha_dilemma_pope_help_1FIRST	Мій батько пролив кров за цю землю. Я вимагаю виконати обіцянку!	true
cdir_events_dilemma_choice_details_localised_choice_title_att_subject_military_none_the_lanista_1THIRD	Він знову зможе служити своїй країні. Він хороший воїн, нам знадобляться його таланти.	true
cdir_events_dilemma_choice_details_localised_choice_title_att_eos_marib_dam_repair_0FOURTH	Не шкодуйте золота! Гребля повинна стояти, а вода - залишатися під контролем!	true
cdir_events_dilemma_choice_details_localised_choice_title_att_eos_marib_dam_repair_1FOURTH	Не шкодуйте золота! Гребля повинна стояти, а вода - залишатися під контролем!	true
cdir_events_dilemma_choice_details_localised_choice_title_att_eos_marib_dam_repair_2FOURTH	Не шкодуйте золота! Гребля повинна стояти, а вода - залишатися під контролем!	true
cdir_events_dilemma_choice_details_localised_choice_title_att_eos_marib_dam_repair_3FOURTH	Не шкодуйте золота! Гребля повинна стояти, а вода - залишатися під контролем!	true
cdir_events_dilemma_choice_details_localised_choice_label_att_subject_politics_rome_corruptionTHIRD	Досягти компромісу	true
cdir_events_dilemma_choice_details_localised_choice_label_att_subject_religious_manichaeism_pilgrims_1SECOND	Заборонити	true
cdir_events_dilemma_choice_details_localised_choice_label_att_subject_military_none_drunk_on_watch_1THIRD	Влаштувати децимацію	true
cdir_events_dilemma_choice_details_localised_choice_title_att_political_action_dilemma_diminish_popularity_followup_mercifulSECOND	Нехай всі знають, що подібні дії не залишаться безкарними.	true
cdir_events_dilemma_choice_details_localised_choice_label_att_subject_domestic_all_stone_masonTHIRD	Нехай його вб'ють	true
cdir_events_dilemma_choice_details_localised_choice_title_att_subject_religious_christian_candidate_for_bishopSECOND	Нам слід підвищити шанси нашого кандидата.	true
cdir_events_dilemma_choice_details_localised_choice_label_att_subject_nomadic_tribal_strife_1SECOND	Влаштувати поєдинок між ними	true
cdir_events_dilemma_choice_details_localised_choice_label_cha_dilemma_lombard_pope_demands_1SECOND	Твердо відмовитися	true
cdir_events_dilemma_choice_details_localised_choice_label_cha_dilemma_lombard_pope_demands_2SECOND	Запропонувати гроші	true
cdir_events_dilemma_choice_details_localised_choice_label_cha_dilemma_lombard_pope_demands_3SECOND	Поклястися не віддавати	true
cdir_events_dilemma_choice_details_localised_choice_title_att_bel_request_antoninia_rumours_1SECOND	Хочеш мене обдурити? Більше ти його не побачиш!	true
cdir_events_dilemma_choice_details_localised_choice_label_att_subject_religious_catholic_pilgrims_1THIRD	Дозволити	true
cdir_events_dilemma_choice_details_localised_choice_label_att_subject_military_none_mercenary_commander_1FIRST	Проігнорувати його	true
cdir_events_dilemma_choice_details_localised_choice_title_att_subject_religious_catholic_illegal_practice_1THIRD	Єретик! Нехай гниє в темниці!	true
cdir_events_dilemma_choice_details_localised_choice_title_att_dilemma_religious_manichaeism_religious_sanctions_1FIRST	Для нас всі люди рівні. До маніхейців потрібно ставитися так само, як і до всіх інших.	true
cdir_events_dilemma_choice_details_localised_choice_label_att_subject_religious_none_the_golden_tongued_1THIRD	Відправити в інший регіон	true
cdir_events_dilemma_choice_details_localised_choice_label_att_subject_religious_celtic_pilgrims_1FIRST	Не звертати уваги	true
cdir_events_dilemma_choice_details_localised_choice_label_att_subject_politics_rome_corruptionFIRST	Покарати сенаторів	true
cdir_events_dilemma_choice_details_localised_choice_label_att_subject_military_none_drunk_on_watch_1FIRST	Не звертати уваги	true
cdir_events_dilemma_choice_details_localised_choice_title_att_subject_domestic_civil_hostile_disputeFOURTH	Про це скоро забудуть.	true
cdir_events_dilemma_choice_details_localised_choice_label_cha_dilemma_charlemagne_daughter_1SECOND	Покарати пліткарів	true
cdir_events_dilemma_choice_details_localised_choice_label_att_bel_request_justinian_photius_1SECOND	Вбити Фотія	true
cdir_events_dilemma_choice_details_localised_choice_label_att_subject_domestic_all_stone_masonFIRST	Взяти його на службу	true
cdir_events_dilemma_choice_details_localised_choice_label_att_subject_military_none_mercenary_commander_1THIRD	Попросити знижку	true
cdir_events_dilemma_choice_details_localised_choice_label_att_subject_religious_catholic_pilgrims_1FIRST	Не звертати уваги	true
cdir_events_dilemma_choice_details_localised_choice_title_att_subject_religious_catholic_illegal_practice_1FIRST	Вбити його. Нехай його доля стане уроком для інших.	true
cdir_events_dilemma_choice_details_localised_choice_label_att_dilemma_religious_christian_conference_of_carthage_1FIRST	Примусити їх приєднатися	true
cdir_events_dilemma_choice_details_localised_choice_label_att_subject_religious_none_the_golden_tongued_1FIRST	Залишити його	true
cdir_events_dilemma_choice_details_localised_choice_label_att_subject_religious_celtic_pilgrims_1THIRD	Дозволити	true
cdir_events_dilemma_choice_details_localised_choice_label_att_subject_domestic_barb_temple_sacrilegeSECOND	Видати його жерцям	true
cdir_events_dilemma_choice_details_localised_choice_label_att_subject_politics_civil_challengerFIRST	Нехай говорить	true
cdir_events_dilemma_choice_details_localised_choice_title_att_subject_religious_barb_bloodlessTHIRD	Ми повинні кинути цю потворну істоту у вогонь.	true
cdir_events_dilemma_choice_details_localised_choice_label_cha_dilemma_viking_1_cha_fact_merciaSECOND	Забрати землі	true
cdir_events_dilemma_choice_details_localised_choice_label_att_subject_religious_germanic_pilgrims_1THIRD	Дозволити	true
cdir_events_dilemma_choice_details_localised_choice_title_att_subject_religious_germanic_illegal_practice_1THIRD	Нехай подумає про свої гріхи.	true
cdir_events_dilemma_choice_details_localised_choice_title_att_subject_religious_orthodox_illegal_practice_1THIRD	Нехай подумає про свої гріхи.	true
cdir_events_dilemma_choice_details_localised_choice_title_att_dilemma_religious_christian_council_of_carthage_1SECOND	Хто ми такі, щоб судити його? «Хто без гріха, той нехай першим кине камінь», - так сказав наш Спаситель...	true
cdir_events_dilemma_choice_details_localised_choice_title_att_subject_religious_celtic_illegal_practice_1THIRD	Вона поклоняється лжебогу. Нехай подумає про це, поки гниє в темниці!	true
cdir_events_dilemma_choice_details_localised_choice_label_att_subject_politics_civil_challengerTHIRD	Вбити його	true
cdir_events_dilemma_choice_details_localised_choice_title_att_subject_religious_barb_bloodlessFIRST	Боги повинні отримати своє.	true
cdir_events_dilemma_choice_details_localised_choice_title_att_subject_religious_none_the_holy_site_1SECOND	Ми купимо твою землю і побудуємо на ній храм на честь святого.	true
cdir_events_dilemma_choice_details_localised_choice_title_political_event_ministerial_positionFIRST	Очевидно, що для цієї роботи він не годиться.	true
cdir_events_dilemma_choice_details_localised_choice_title_att_subject_religious_barb_bloodlessSECOND	Богів задобрить тільки справжня жертва.	true
cdir_events_dilemma_choice_details_localised_choice_label_att_subject_religious_germanic_pilgrims_1FIRST	Не звертати уваги	true
cdir_events_dilemma_choice_details_localised_choice_title_att_subject_religious_germanic_illegal_practice_1FIRST	Вбити його. Нехай його доля стане уроком для інших.	true
cdir_events_dilemma_choice_details_localised_choice_title_att_subject_religious_orthodox_illegal_practice_1FIRST	Вбити цього дурня, а його ікони розбити. Нехай іншим буде наука.	true
cdir_events_dilemma_choice_details_localised_choice_title_att_subject_religious_celtic_illegal_practice_1FIRST	Вбити її. Нехай її смерть стане уроком для інших.	true
cdir_events_dilemma_choice_details_localised_choice_title_att_subject_diplomatic_none_border_dispute_1SECOND	Такі дії можуть розпалити смуту. Відправ туди солдатів, нехай вони наведуть порядок.	true
cdir_events_dilemma_choice_details_localised_choice_title_att_dilemma_religious_tengri_religious_sanctions_1FIRST	Для нас всі люди рівні. До тенгріанців потрібно ставитися так само, як і до всіх інших.	true
cdir_events_dilemma_choice_details_localised_choice_title_att_subject_religious_barb_strangerFIRST	На цій людині печатка долі. Ми повинні прислухатися до його слів.	true
cdir_events_dilemma_choice_details_localised_choice_label_att_political_action_dilemma_embezzlement_suspiciousSECOND	Надійне алібі	true
cdir_events_dilemma_choice_details_localised_choice_title_att_subject_domestic_civil_idiot_magistrateFIRST	Буде урок цьому дурневі!	true
cdir_events_dilemma_choice_details_localised_choice_title_ollam_ri_A1iFIRST	Король хоче своїми очима побачити це диво.	true
cdir_events_dilemma_choice_details_localised_choice_title_att_subject_domestic_all_stone_masonFOURTH	У вас є більш важливі справи.	true
cdir_events_dilemma_choice_details_localised_choice_label_att_dilemma_religious_zoroastrian_religious_sanctions_1FIRST	Дати їм рівні права	true
cdir_events_dilemma_choice_details_localised_choice_title_att_subject_religious_barb_strangerTHIRD	Кожного можна купити. І мені здається, що його ціна нижча, ніж йому здається.	true
cdir_events_dilemma_choice_details_localised_choice_title_att_subject_domestic_civil_idiot_magistrateTHIRD	Цей дурень підвів тебе. Нехай його доля стане уроком для інших.	true
cdir_events_dilemma_choice_details_localised_choice_label_cha_dilemma_verdenFOURTH	Вбити їх усіх	true
cdir_events_dilemma_choice_details_localised_choice_title_att_subject_religious_christian_pontifex_maximus_1SECOND	Невелика сума в руках потрібної людини значно підвищить шанси нашого кандидата.	true
cdir_events_dilemma_choice_details_localised_choice_title_att_bel_request_theodosia_amalasuntha_1FIRST	Якщо Юстиніан в небезпеці, мій обов'язок - захищати його.	true
cdir_events_dilemma_choice_details_localised_choice_title_att_bel_request_antoninia_rumours_1FIRST	Можливо, я прийняв все занадто близько до серця... до того ж, пара-трійка талантів срібла ніколи не буде зайвою.	true
cdir_events_dilemma_choice_details_localised_choice_title_att_subject_religious_hun_shamanSECOND	Ця людина оскаржує твоє право керувати народом.	true
cdir_events_dilemma_choice_details_localised_choice_label_att_bel_request_antoninia_thedosius_1FIRST	Усиновити його	true
cdir_events_dilemma_choice_details_localised_choice_title_att_subject_religious_orthodox_illegal_practice_1SECOND	Ми терпимо ставимося до чужих вірувань. Відпусти його.	true
cdir_events_dilemma_choice_details_localised_choice_label_att_subject_religious_arian_pilgrims_1SECOND	Заборонити	true
cdir_events_dilemma_choice_details_localised_choice_title_att_subject_politics_roman_hostageFIRST	Хлопчику потрібно дати шанс самому творити свою долю.	true
cdir_events_dilemma_choice_details_localised_choice_label_att_subject_domestic_nomad_sword_of_attilaTHIRD	Подарувати меч	true
cdir_events_dilemma_choice_details_localised_choice_title_att_subject_domestic_none_hidden_treasure_1THIRD	Б'юся об заклад, це покриє частину витрат на армію, та й найманців дозволить завербувати.	true
cdir_events_dilemma_choice_details_localised_choice_label_att_subject_military_roman_master_hostile_governorTHIRD	Вбити його	true
cdir_events_dilemma_choice_details_localised_choice_label_cha_dilemma_verdenFIRST	Звільнити їх	true
cdir_events_dilemma_choice_details_localised_choice_label_political_event_assassination_failure_discoveredSECOND	Проявити милосердя	true
cdir_events_dilemma_choice_details_localised_choice_title_att_eos_tanukhids_settleSECOND	Вірні союзники, звільнені нами, повинні вільно правити своїми землями.	true
cdir_events_dilemma_choice_details_localised_choice_label_att_subject_religious_arian_illegal_practice_1SECOND	Звільнити його	true
cdir_events_dilemma_choice_details_localised_choice_label_political_event_marriage_femaleSECOND	Благословити	true
cdir_events_dilemma_choice_details_localised_choice_title_att_subject_politics_roman_hostageTHIRD	Якщо він повернеться в сім'ю, то, можливо, принесе цим дикунам наші звичаї.	true
cdir_events_dilemma_choice_details_localised_choice_label_att_subject_domestic_nomad_sword_of_attilaFIRST	Прийняти дар	true
cdir_events_dilemma_choice_details_localised_choice_title_att_subject_domestic_none_hidden_treasure_1FIRST	Не турбуйся, ми самі розберемося...	true
cdir_events_dilemma_choice_details_localised_choice_label_att_subject_military_roman_master_hostile_governorFIRST	Дати хабар	true
cdir_events_dilemma_choice_details_localised_choice_title_cha_dilemma_pope_attacked_1FIRST	Той, кого сам Господь визнав гідним влади, заслуговує на нашу допомогу.	true
cdir_events_dilemma_choice_details_localised_choice_title_ollam_ri_votadiniSECOND	Вікові дерева несуть життя хоробрим і смерть необережним.	true
cdir_events_dilemma_choice_details_localised_choice_label_cha_dilemma_verdenTHIRD	Вбити їх ватажків	true
cdir_events_dilemma_choice_details_localised_choice_label_att_bel_request_theodosia_amalasuntha_1SECOND	Прийняти завдання	true
cdir_events_dilemma_choice_details_localised_choice_label_att_dilemma_religious_zoroastrian_religious_sanctions_1SECOND	Ввести санкції	true
cdir_events_dilemma_choice_details_localised_choice_title_slav_dilemma_venedians_1SECOND	Що ми можемо протиставити їхній шаленій люті? Дайте їм те, чого вони вимагають.	true
cdir_events_dilemma_choice_details_localised_choice_title_slav_dilemma_venedians_2SECOND	Що ми можемо протиставити їхній шаленій люті? Дайте їм те, чого вони вимагають.	true
cdir_events_dilemma_choice_details_localised_choice_title_slav_dilemma_venedians_3SECOND	Що ми можемо протиставити їхній шаленій люті? Дайте їм те, чого вони вимагають.	true
cdir_events_dilemma_choice_details_localised_choice_title_slav_dilemma_venedians_4SECOND	Що ми можемо протиставити їхній шаленій люті? Дайте їм те, чого вони вимагають.	true
cdir_events_dilemma_choice_details_localised_choice_label_att_subject_religious_zoroastrian_corpseSECOND	Вбити його	true
cdir_events_dilemma_choice_details_localised_choice_label_att_subject_military_none_the_spy_1THIRD	Призначити наставником	true
cdir_events_dilemma_choice_details_localised_choice_title_att_subject_domestic_roman_a_little_flutter_2THIRD	Це молодий боєць, але у нього непогані задатки. Можливо, тепер він зможе показати себе в справі?	true
cdir_events_dilemma_choice_details_localised_choice_title_att_bel_request_theodosia_ioannina_1FIRST	Як би там не було, нам треба виправляти ситуацію, а не погіршувати її.	true
cdir_events_dilemma_choice_details_localised_choice_title_att_subject_religious_none_the_true_cross_1THIRD	Очевидно, що цій людині не можна довіряти: він продає підроблені реліквії заради наживи. З ним потрібно розібратися.	true
cdir_events_dilemma_choice_details_localised_choice_label_att_political_action_dilemma_assassinate_wound_suspiciousTHIRD	Неважливо	true
cdir_events_dilemma_choice_details_localised_choice_label_att_subject_military_barb_master_hostile_governorTHIRD	Вбити його	true
cdir_events_dilemma_choice_details_localised_choice_label_att_subject_religious_arian_pilgrims_1FIRST	Не звертати уваги	true
cdir_events_dilemma_choice_details_localised_choice_label_att_dilemma_religious_manichaeism_religious_sanctions_1SECOND	Ввести санкції	true
cdir_events_dilemma_choice_details_localised_choice_label_att_political_action_dilemma_assassinate_caughtSECOND	Засудити	true
cdir_events_dilemma_choice_details_localised_choice_label_att_subject_military_none_the_spy_1FIRST	Не звертати уваги	true
cdir_events_dilemma_choice_details_localised_choice_label_cha_dilemma_saxon_1FIRST	Прийняти хрещення	true
cdir_events_dilemma_choice_details_localised_choice_label_att_dilemma_domestic_roman_saint_telemachus_1FIRST	Заборонити ігри	true
cdir_events_dilemma_choice_details_localised_choice_label_cha_dilemma_viking_1_cha_fact_northumbriaSECOND	Забрати землі	true
cdir_events_dilemma_choice_details_localised_choice_title_att_subject_domestic_roman_a_little_flutter_2FIRST	Любов до азартних ігор - це порок, який потрібно викорінити. А нам, крім того, потрібно займатися справами держави.	true
cdir_events_dilemma_choice_details_localised_choice_title_att_subject_religious_none_the_true_cross_1FIRST	Нам не варто забивати собі голову цією нісенітницею.	true
cdir_events_dilemma_choice_details_localised_choice_label_att_political_action_dilemma_assassinate_wound_suspiciousFIRST	Замести сліди	true
cdir_events_dilemma_choice_details_localised_choice_label_att_subject_military_barb_master_hostile_governorFIRST	Дати хабар	true
cdir_events_dilemma_choice_details_localised_choice_label_att_subject_religious_arian_pilgrims_1THIRD	Дозволити	true
cdir_events_dilemma_choice_details_localised_choice_title_ollam_ri_votadiniFIRST	У його чорній гладі відбиваються всі таємниці людей.	true
cdir_events_dilemma_choice_details_localised_choice_title_cha_dilemma_cordoba_1THIRD	Слова дешевші за мечі, але вражають не гірше. Негайно відправте посла!	true
cdir_events_dilemma_choice_details_localised_choice_title_att_subject_domestic_roman_a_little_flutter_1FIRST	Любов до азартних ігор - це порок, який потрібно викорінити. А нам, крім того, потрібно займатися справами держави.	true
cdir_events_dilemma_choice_details_localised_choice_label_att_eos_tanukhids_settleFIRST	Анексувати землі союзників	true
cdir_events_dilemma_choice_details_localised_choice_title_political_event_adoptionSECOND	Дозволити усиновлення.	true
cdir_events_dilemma_choice_details_localised_choice_title_cha_dilemma_cordoba_1FIRST	Золото чи життя народу? Вибір очевидний.	true
cdir_events_dilemma_choice_details_localised_choice_title_att_subject_domestic_roman_a_little_flutter_1THIRD	Ха! Юність нічого не означає, якщо їй протистоїть досвід. Вихід може бути тільки один. Юний дурень програє.	true
cdir_events_dilemma_choice_details_localised_choice_title_att_political_action_dilemma_embezzlement_caughtSECOND	Нехай всі знають, що вони діяли за наказом і на благо держави.	true
cdir_events_dilemma_choice_details_localised_choice_label_att_subject_religious_orthodox_illegal_practice_1SECOND	Звільнити його	true
cdir_events_dilemma_choice_details_localised_choice_title_political_event_assassination_success_discoveredSECOND	Крові і так пролито занадто багато.	true
cdir_events_dilemma_choice_details_localised_choice_title_att_political_action_dilemma_embezzlement_caughtFOURTH	Вони самі про себе подбають. Їхня доля нас не хвилює.	true
cdir_events_dilemma_choice_details_localised_choice_title_ollam_ri_pictiSECOND	Вікові дерева несуть життя хоробрим і смерть необережним.	true
cdir_events_dilemma_choice_details_localised_choice_title_att_subject_military_roman_master_hostile_governorFIRST	Великий хабар швидко змусить його передумати.	true
cdir_events_dilemma_choice_details_localised_choice_label_att_subject_politics_roman_hostageTHIRD	Повернути його	true
cdir_events_dilemma_choice_details_localised_choice_title_att_subject_domestic_nomad_sword_of_attilaFIRST	Кожному великому воєначальнику потрібна легендарна зброя.	true
cdir_events_dilemma_choice_details_localised_choice_label_ollam_ri_votadiniSECOND	Він іде в ліс.	true
cdir_events_dilemma_choice_details_localised_choice_title_cha_dilemma_verdenTHIRD	Вбийте їх ватажків. Нехай всі бачать, що буває з тими, хто заперечує Слово Боже.	true
cdir_events_dilemma_choice_details_localised_choice_title_political_event_marriage_femaleSECOND	Ми благословляємо її.	true
cdir_events_dilemma_choice_details_localised_choice_label_att_political_action_dilemma_diminish_popularity_reversalTHIRD	Неважливо	true
cdir_events_dilemma_choice_details_localised_choice_label_att_subject_domestic_civil_married_slavesTHIRD	Випороти рабів	true
cdir_events_dilemma_choice_details_localised_choice_title_att_subject_military_roman_master_hostile_governorTHIRD	Ніж у спину — і він замовкне назавжди.	true
cdir_events_dilemma_choice_details_localised_choice_label_att_subject_politics_roman_hostageFIRST	Дати йому громадянство	true
cdir_events_dilemma_choice_details_localised_choice_title_att_subject_domestic_nomad_sword_of_attilaTHIRD	Така зброя стане чудовим подарунком.	true
cdir_events_dilemma_choice_details_localised_choice_title_cha_dilemma_verdenFIRST	Милосердя - справжня чеснота християнського короля.	true
cdir_events_dilemma_choice_details_localised_choice_title_att_bel_request_theodosia_amalasuntha_1SECOND	На жаль, пані імператрице, але я не можу порушити прямий наказ імператора.	true
cdir_events_dilemma_choice_details_localised_choice_title_att_dilemma_religious_zoroastrian_religious_sanctions_1SECOND	Ми повинні прийняти закон, що обмежує права язичників молитися.	true
cdir_events_dilemma_choice_details_localised_choice_title_att_bel_request_theodosia_pope_1SECOND	Імператору дана влада самим Богом. Тільки він має право судити папу.	true
cdir_events_dilemma_choice_details_localised_choice_label_slav_dilemma_anteans_1SECOND	Вбити його за зухвалість	true
cdir_events_dilemma_choice_details_localised_choice_label_slav_dilemma_anteans_2SECOND	Вбити його	true
cdir_events_dilemma_choice_details_localised_choice_label_att_dilemma_religious_christian_conference_of_carthage_1SECOND	Змиритися з ними	true
cdir_events_dilemma_choice_details_localised_choice_label_att_political_action_dilemma_diminish_popularity_reversalFIRST	Виправдати	true
cdir_events_dilemma_choice_details_localised_choice_label_att_subject_domestic_civil_married_slavesFIRST	Дозволити шлюб	true
cdir_events_dilemma_choice_details_localised_choice_label_ollam_ri_A2FIRST	Проігнорувати його.	true
cdir_events_dilemma_choice_details_localised_choice_label_ollam_ri_B2FIRST	Утопити його в молоці.	true
cdir_events_dilemma_choice_details_localised_choice_label_att_subject_diplomatic_none_tribute_1FIRST	Проігнорувати його	true
cdir_events_dilemma_choice_details_localised_choice_title_att_subject_domestic_none_workers_on_strike_1FIRST	Рано чи пізно вони здадуться.	true
cdir_events_dilemma_choice_details_localised_choice_title_cha_dilemma_viking_1_cha_fact_northumbriaSECOND	Ці родючі землі подарують майбутнє нашому народу. Не сумніваюся, ми знайдемо, кого грабувати замість вас.	true
cdir_events_dilemma_choice_details_localised_choice_label_att_bel_request_theodosia_ioannina_1FIRST	Не прислухатися до дружини	true
cdir_events_dilemma_choice_details_localised_choice_title_att_dilemma_religious_manichaeism_religious_sanctions_1SECOND	Ми повинні прийняти закон, що обмежує права єретиків молитися.	true
cdir_events_dilemma_choice_details_localised_choice_title_att_subject_politics_barb_nomad_secret_meetingsFIRST	Навіщо витрачати час на всі ці жалюгідні ігри? Вбити їх - і справа з кінцем.	true
cdir_events_dilemma_choice_details_localised_choice_title_att_subject_religious_arian_pilgrims_1THIRD	Хто ми такі, щоб ставити під сумнів чужу віру?	true
cdir_events_dilemma_choice_details_localised_choice_label_att_political_action_dilemma_gather_support_oppositionSECOND	Зловживання владою	true
cdir_events_dilemma_choice_details_localised_choice_title_att_eos_religious_event_rebellion_att_fact_axum_att_rel_semitic_paganismSECOND	Його народ достатньо страждав, зробимо виняток для нього, якщо це можливо.	true
cdir_events_dilemma_choice_details_localised_choice_label_att_subject_religious_zoroastrian_corpseFOURTH	Не робити нічого	true
cdir_events_dilemma_choice_details_localised_choice_title_att_political_action_dilemma_marriage_impedimentSECOND	Якщо його володар забажає, йому доведеться підкоритися!	true
cdir_events_dilemma_choice_details_localised_choice_title_att_political_action_dilemma_assassinate_caughtSECOND	Вони зганьбили і себе, і весь двір монарха!	true
cdir_events_dilemma_choice_details_localised_choice_label_ollam_ri_A3FIRST	Спіймати коня.	true
cdir_events_dilemma_choice_details_localised_choice_label_att_subject_diplomatic_none_tribute_1THIRD	Вбити його	true
cdir_events_dilemma_choice_details_localised_choice_title_att_subject_domestic_none_workers_on_strike_1THIRD	Добре.	true
cdir_events_dilemma_choice_details_localised_choice_label_att_dilemma_religious_christian_council_of_carthage_1FIRST	Засудити пелагіанство	true
cdir_events_dilemma_choice_details_localised_choice_title_att_subject_politics_barb_nomad_secret_meetingsTHIRD	Один із змовників все ще зберігає вірність. Нехай він зірве змову.	true
cdir_events_dilemma_choice_details_localised_choice_title_att_subject_religious_arian_pilgrims_1FIRST	Їхні справи нас не стосуються.	true
cdir_events_dilemma_choice_details_localised_choice_title_att_dilemma_religious_zoroastrian_the_manichean_heresy_1SECOND	Ці люди завдають шкоди іншим. Нехай з ним розбираються члени їхньої секти.	true
cdir_events_dilemma_choice_details_localised_choice_label_att_subject_diplomatic_none_diplomatic_dispute_1SECOND	Вимагати данину	true
cdir_events_dilemma_choice_details_localised_choice_title_att_political_action_dilemma_secure_loyalty_mutilationSECOND	Не бачу зла, не чую зла...	true
cdir_events_dilemma_choice_details_localised_choice_title_ybor_level_A_langobardiFIRST	Він вирваний з мертвих рук ворожого володаря.	true
cdir_events_dilemma_choice_details_localised_choice_title_att_eos_tanukhids_settleFIRST	«Ці землі зроблять нашу імперію процвітаючою!»	true
cdir_events_dilemma_choice_details_localised_choice_title_att_dilemma_religious_christian_the_manichean_heresy_1SECOND	Маніхейство багато в чому схоже на християнство. Нам потрібно терпимо ставитися до інших релігій.	true
cdir_events_dilemma_choice_details_localised_choice_label_ollam_ri_A1FIRST	Зробити честь.	true
cdir_events_dilemma_choice_details_localised_choice_label_ollam_ri_B1FIRST	Використати шкуру.	true
cdir_events_dilemma_choice_details_localised_choice_label_att_bel_request_justinian_photius_1FIRST	Знехтувати Антоніною	true
cdir_events_dilemma_choice_details_localised_choice_title_att_subject_religious_hun_shamanFOURTH	Нехай шаман говорить, що хоче.	true
cdir_events_dilemma_choice_details_localised_choice_title_att_subject_politics_civil_hostageTHIRD	Повернувши його, ми заслужимо прихильність його родини.	true
cdir_events_dilemma_choice_details_localised_choice_label_att_subject_religious_catholic_pilgrims_1SECOND	Заборонити	true
cdir_events_dilemma_choice_details_localised_choice_label_att_subject_domestic_roman_a_little_flutter_1FIRST	Не звертати уваги	true
cdir_events_dilemma_choice_details_localised_choice_label_cha_dilemma_cordoba_1THIRD	Надіслати дипломата	true
cdir_events_dilemma_choice_details_localised_choice_label_att_subject_diplomatic_none_border_dispute_1FIRST	Ігнорувати суперечку	true
cdir_events_dilemma_choice_details_localised_choice_label_political_event_adoptionSECOND	Дозволити	true
cdir_events_dilemma_choice_details_localised_choice_title_att_subject_religious_arian_pilgrims_1SECOND	Вони повинні знайти інший шлях до свого бога.	true
cdir_events_dilemma_choice_details_localised_choice_title_att_subject_politics_civil_hostageFIRST	Людина такого розуму повинна служити нам.	true
cdir_events_dilemma_choice_details_localised_choice_title_att_subject_religious_barb_stonesFOURTH	Ми не в силах зупинити те, що вже рушило.	true
cdir_events_dilemma_choice_details_localised_choice_label_att_subject_domestic_roman_a_little_flutter_1THIRD	Поставити проти гладіатора	true
cdir_events_dilemma_choice_details_localised_choice_label_cha_dilemma_cordoba_1FIRST	Заплатити податок	true
cdir_events_dilemma_choice_details_localised_choice_label_att_bel_request_antoninia_rumours_1FIRST	Закрити очі	true
cdir_events_dilemma_choice_details_localised_choice_label_att_subject_diplomatic_none_border_dispute_1THIRD	Викупити землю	true
cdir_events_dilemma_choice_details_localised_choice_label_att_political_action_dilemma_embezzlement_caughtSECOND	Взяти відповідальність	true
cdir_events_dilemma_choice_details_localised_choice_label_att_subject_military_none_mercenary_commander_1SECOND	Прийняти пропозицію	true
cdir_events_dilemma_choice_details_localised_choice_label_att_subject_domestic_roman_a_little_flutter_2THIRD	Поставити проти ветерана	true
cdir_events_dilemma_choice_details_localised_choice_label_att_subject_domestic_none_hidden_treasure_1FIRST	Не звертати уваги	true
cdir_events_dilemma_choice_details_localised_choice_label_cha_dilemma_pope_attacked_1FIRST	Пообіцяти захист	true
cdir_events_dilemma_choice_details_localised_choice_label_att_subject_domestic_civil_hostile_disputeTHIRD	Засудити його суперника	true
cdir_events_dilemma_choice_details_localised_choice_title_att_political_action_dilemma_assassinate_wound_suspiciousTHIRD	Нехай собі пліткують і гадають. Яке нам діло до того, про що теревенять селяни?	true
cdir_events_dilemma_choice_details_localised_choice_title_att_subject_military_barb_master_hostile_governorTHIRD	Вбити його і підсмажити на вогнищі!	true
cdir_events_dilemma_choice_details_localised_choice_label_att_subject_religious_hun_shamanFIRST	Змусити його замовкнути	true
cdir_events_dilemma_choice_details_localised_choice_label_att_subject_religious_arian_illegal_practice_1FIRST	Стратити його	true
cdir_events_dilemma_choice_details_localised_choice_label_att_subject_politics_barb_nomad_secret_meetingsFOURTH	Взяти їх на службу	true
cdir_events_dilemma_choice_details_localised_choice_title_att_dilemma_domestic_roman_saint_telemachus_1FIRST	Вбивство цієї людини стало соломинкою, яка зламала спину верблюда. Ігри тривали занадто довго, їх потрібно припинити.	true
cdir_events_dilemma_choice_details_localised_choice_label_att_subject_domestic_roman_a_little_flutter_2FIRST	Не звертати уваги	true
cdir_events_dilemma_choice_details_localised_choice_label_att_subject_domestic_none_hidden_treasure_1THIRD	Віддати армії	true
cdir_events_dilemma_choice_details_localised_choice_label_att_subject_religious_catholic_illegal_practice_1SECOND	Звільнити їх	true
cdir_events_dilemma_choice_details_localised_choice_label_att_subject_domestic_civil_hostile_disputeFIRST	Покарати його	true
cdir_events_dilemma_choice_details_localised_choice_label_att_subject_military_barb_master_hostile_governorFOURTH	Не робити нічого	true
cdir_events_dilemma_choice_details_localised_choice_title_att_political_action_dilemma_assassinate_wound_suspiciousFIRST	Вони повинні зробити все, щоб не залишити доказів.	true
cdir_events_dilemma_choice_details_localised_choice_title_att_subject_military_barb_master_hostile_governorFIRST	Щедрі дари заткнуть йому горло.	true
cdir_events_dilemma_choice_details_localised_choice_label_att_subject_religious_hun_shamanTHIRD	Зберегти йому життя	true
cdir_events_dilemma_choice_details_localised_choice_label_ybor_level_A_langobardiSECOND	Брошка	true
cdir_events_dilemma_choice_details_localised_choice_label_att_subject_religious_arian_illegal_practice_1THIRD	Залишити його у в'язниці	true
cdir_events_dilemma_choice_details_localised_choice_label_ollam_ri_votadiniFIRST	Він йде до озера.	true
cdir_events_dilemma_choice_details_localised_choice_title_att_subject_religious_arian_illegal_practice_1SECOND	Ми милосердні, ми терпимо ставимося до чужої віри. Звільни його.	true
cdir_events_dilemma_choice_details_localised_choice_title_att_subject_politics_nomad_hostageFIRST	Хлопчик може принести тобі велику користь.	true
cdir_events_dilemma_choice_details_localised_choice_title_att_subject_military_none_the_spy_1FIRST	Нехай гниє в темниці.	true
cdir_events_dilemma_choice_details_localised_choice_title_cha_dilemma_saxon_1FIRST	Заради любові до свого народу я прийму хрещення.	true
cdir_events_dilemma_choice_details_localised_choice_label_att_subject_religious_hellenic_pilgrims_1SECOND	Заборонити	true
cdir_events_dilemma_choice_details_localised_choice_title_political_event_blackmailSECOND	Ці чутки безпідставні.	true
cdir_events_dilemma_choice_details_localised_choice_label_ollam_ri_BFIRST	Звільнити їх.	true
cdir_events_dilemma_choice_details_localised_choice_label_att_subject_religious_none_the_true_cross_1FIRST	Відмовитися від угоди	true
cdir_events_dilemma_choice_details_localised_choice_label_att_eos_tanukhids_settleSECOND	Залишитися союзниками	true
cdir_events_dilemma_choice_details_localised_choice_title_political_event_assassination_failure_discoveredSECOND	Потрібно покласти цьому край, поки хтось не завдав серйозної шкоди!	true
cdir_events_dilemma_choice_details_localised_choice_title_att_subject_politics_nomad_hostageTHIRD	Повернувши його, ми заслужимо прихильність його родини.	true
cdir_events_dilemma_choice_details_localised_choice_label_att_subject_religious_germanic_pilgrims_1SECOND	Заборонити	true
cdir_events_dilemma_choice_details_localised_choice_title_att_subject_military_none_the_spy_1THIRD	Нехай поділиться досвідом з нашими агентами.	true
cdir_events_dilemma_choice_details_localised_choice_title_att_political_action_dilemma_assassinate_wound_suspiciousSECOND	Не може бути. Вони... в той час вони виконували доручення монарха!	true
cdir_events_dilemma_choice_details_localised_choice_title_att_subject_military_barb_master_hostile_governorSECOND	Над чоловічою гідністю, значить? Ну що ж, подивимося, у кого довше!	true
cdir_events_dilemma_choice_details_localised_choice_label_att_subject_religious_none_the_true_cross_1THIRD	Конфіскувати товари	true
cdir_events_dilemma_choice_details_localised_choice_title_att_dilemma_religious_christian_the_council_of_toledo_1SECOND	Очевидно, що ці люди - єретики, які порушили святі заповіти. Їх потрібно покарати за цей злочин.	true
cdir_events_dilemma_choice_details_localised_choice_title_att_subject_politics_barb_nomad_secret_meetingsSECOND	Нехай вони висловлять свої наміри в обличчя.	true
cdir_events_dilemma_choice_details_localised_choice_title_att_subject_religious_zoroastrian_corpseSECOND	Цей чоловік порушив закони нашої віри. Такий злочин повинен бути покараний.	true
cdir_events_dilemma_choice_details_localised_choice_label_slav_dilemma_venedians_1SECOND	Дати їжу	true
cdir_events_dilemma_choice_details_localised_choice_label_slav_dilemma_venedians_2SECOND	Дати їжу	true
cdir_events_dilemma_choice_details_localised_choice_label_slav_dilemma_venedians_3SECOND	Дати їжу	true
cdir_events_dilemma_choice_details_localised_choice_label_slav_dilemma_venedians_4SECOND	Дати їжу	true
cdir_events_dilemma_choice_details_localised_choice_label_ollam_ri_ATHIRD	Ніхто!	true
cdir_events_dilemma_choice_details_localised_choice_label_att_subject_religious_germanic_illegal_practice_1SECOND	Звільнити його	true
cdir_events_dilemma_choice_details_localised_choice_label_att_subject_religious_zoroastrian_corpseFIRST	Оштрафувати його	true
cdir_events_dilemma_choice_details_localised_choice_label_att_subject_religious_hun_shamanSECOND	Вбити його	true
cdir_events_dilemma_choice_details_localised_choice_label_att_subject_religious_barb_stonesSECOND	Принести жертву	true
cdir_events_dilemma_choice_details_localised_choice_label_att_subject_religious_hellenic_illegal_practice_1SECOND	Звільнити його	true
cdir_events_dilemma_choice_details_localised_choice_label_ollam_ri_AFIRST	Друїд.	true
cdir_events_dilemma_choice_details_localised_choice_title_att_bel_request_antoninia_thedosius_1FIRST	Феодосій? Цей милий юнак? Звичайно, моя дорога!	true
cdir_events_dilemma_choice_details_localised_choice_label_att_subject_religious_zoroastrian_corpseTHIRD	Пробачити його	true
cdir_events_dilemma_choice_details_localised_choice_label_att_subject_politics_civil_hostageFIRST	Взяти його на службу	true
cdir_events_dilemma_choice_details_localised_choice_label_att_subject_religious_barb_stonesFOURTH	Не робити нічого	true
cdir_events_dilemma_choice_details_localised_choice_title_att_subject_diplomatic_none_border_dispute_1FIRST	Упевнений, вони самі домовляться між собою без втручання держави.	true
cdir_events_dilemma_choice_details_localised_choice_label_att_subject_politics_civil_hostageTHIRD	Повернути його	true
cdir_events_dilemma_choice_details_localised_choice_title_att_subject_religious_catholic_pilgrims_1SECOND	Паломники повинні негайно покинути наші землі.	true
cdir_events_dilemma_choice_details_localised_choice_title_att_subject_diplomatic_none_border_dispute_1THIRD	Якщо земля належить державі, то ніяких суперечок бути не може. Виділи кошти.	true
cdir_events_dilemma_choice_details_localised_choice_label_att_subject_religious_hun_shamanFOURTH	Не робити нічого	true
cdir_events_dilemma_choice_details_localised_choice_title_att_subject_military_none_mercenary_commander_1SECOND	Ці війська нам знадобляться. Та й його пропозиція досить непогана.	true
cdir_events_dilemma_choice_details_localised_choice_label_ollam_ri_pictiSECOND	Він іде в ліс.	true
cdir_events_dilemma_choice_details_localised_choice_label_att_subject_domestic_none_workers_on_strike_1FIRST	Ігнорувати	true
cdir_events_dilemma_choice_details_localised_choice_title_att_subject_diplomatic_none_tribute_1FIRST	Відведіть його геть, сьогодні ми його не приймемо.	true
cdir_events_dilemma_choice_details_localised_choice_title_att_subject_domestic_civil_hostile_disputeFIRST	Публічне осудження вирішить проблему.	true
cdir_events_dilemma_choice_details_localised_choice_title_att_subject_military_barb_master_hostile_governorFOURTH	Нехай базікає свої дурниці.	true
cdir_events_dilemma_choice_details_localised_choice_title_att_subject_religious_catholic_illegal_practice_1SECOND	Ми терпимо ставимося до чужих вірувань. Відпусти його.	true
cdir_events_dilemma_choice_details_localised_choice_title_att_subject_religious_arian_illegal_practice_1THIRD	Єретик! Нехай гниє в темниці!	true
cdir_events_dilemma_choice_details_localised_choice_label_att_eos_religious_event_rebellion_att_fact_axum_att_rel_semitic_paganismSECOND	Підкупити його	true
cdir_events_dilemma_choice_details_localised_choice_title_att_subject_religious_hun_shamanFIRST	Вирізати йому язика! Подивимося, як він тоді буде проповідувати про кінець світу!	true
cdir_events_dilemma_choice_details_localised_choice_title_att_subject_politics_barb_nomad_secret_meetingsFOURTH	Треба дати їм місце за нашим столом. Тоді ми зможемо тримати їх при собі.	true
cdir_events_dilemma_choice_details_localised_choice_title_att_subject_religious_zoroastrian_corpseFOURTH	Це тебе не стосується. Нехай інші займаються цією справою.	true
cdir_events_dilemma_choice_details_localised_choice_title_slav_dilemma_anteans_1SECOND	Ніхто не сміє безкарно обманювати мене! Переріжте йому брехливу горлянку!	true
cdir_events_dilemma_choice_details_localised_choice_title_slav_dilemma_anteans_2SECOND	Мерзенний брехун! Спіймайте його і розрубайте на шматки!	true
cdir_events_dilemma_choice_details_localised_choice_label_att_political_action_dilemma_marriage_impedimentSECOND	Указ	true
cdir_events_dilemma_choice_details_localised_choice_label_att_subject_domestic_none_workers_on_strike_1THIRD	Збільшити платню	true
cdir_events_dilemma_choice_details_localised_choice_title_att_subject_diplomatic_none_tribute_1THIRD	Накажи вбити їх усіх, і посланця теж. Вони - шпигуни, це очевидно.	true
cdir_events_dilemma_choice_details_localised_choice_title_att_subject_domestic_civil_hostile_disputeTHIRD	Звичайно ж, у всьому винен його суперник.	true
cdir_events_dilemma_choice_details_localised_choice_title_att_dilemma_religious_christian_council_of_carthage_1FIRST	Первородний гріх - головне положення істинної віри! Ми повинні викорінити єресь.	true
cdir_events_dilemma_choice_details_localised_choice_title_att_subject_religious_arian_illegal_practice_1FIRST	Вбити його. Нехай його доля стане уроком для інших.	true
cdir_events_dilemma_choice_details_localised_choice_label_att_dilemma_religious_zoroastrian_the_manichean_heresy_1SECOND	Залишити їх	true
cdir_events_dilemma_choice_details_localised_choice_title_ybor_level_A_langobardiSECOND	Жерці кажуть, що вона дарує мудрість і захист Годана.	true
cdir_events_dilemma_choice_details_localised_choice_title_att_subject_religious_hun_shamanTHIRD	Може, ти в силах якось змінити своє майбутнє?	true
cdir_events_dilemma_choice_details_localised_choice_title_att_subject_diplomatic_none_diplomatic_dispute_1SECOND	Таку образу не можна забувати. Ми - гордий народ.	true
cdir_events_dilemma_choice_details_localised_choice_label_att_political_action_dilemma_assassinate_wound_suspiciousSECOND	Надійне алібі	true
cdir_events_dilemma_choice_details_localised_choice_title_ollam_ri_A3FIRST	З лошат кельпі виростають чудові коні.	true
cdir_events_dilemma_choice_details_localised_choice_label_att_subject_politics_nomad_hostageTHIRD	Повернути його	true
cdir_events_dilemma_choice_details_localised_choice_title_att_subject_religious_germanic_pilgrims_1SECOND	Розігнати язичників. Тих, хто не піде до сходу сонця, вбити.	true
cdir_events_dilemma_choice_details_localised_choice_label_att_subject_military_barb_master_hostile_governorSECOND	Очорнити його	true
cdir_events_dilemma_choice_details_localised_choice_label_att_subject_politics_barb_nomad_secret_meetingsTHIRD	Зруйнувати плани	true
cdir_events_dilemma_choice_details_localised_choice_title_att_political_action_dilemma_diminish_popularity_reversalTHIRD	Ні той, ні інший, нас не цікавлять. У нас важливіші справи.	true
cdir_events_dilemma_choice_details_localised_choice_title_att_subject_domestic_civil_married_slavesTHIRD	Такі думки слід придушувати в зародку.	true
cdir_events_dilemma_choice_details_localised_choice_title_ollam_ri_A2FIRST	Він явно божевільний, а у короля тепер є риба.	true
cdir_events_dilemma_choice_details_localised_choice_title_ollam_ri_B2FIRST	Він бреше. Король знайде для нього підхоже покарання.	true
cdir_events_dilemma_choice_details_localised_choice_label_att_subject_politics_nomad_hostageFIRST	Прийняти його	true
cdir_events_dilemma_choice_details_localised_choice_title_att_subject_religious_hellenic_pilgrims_1SECOND	Розігнати язичників. Тих, хто не піде до сходу сонця, вбити.	true
cdir_events_dilemma_choice_details_localised_choice_label_political_event_blackmailSECOND	Ігнорувати	true
cdir_events_dilemma_choice_details_localised_choice_title_ollam_ri_BFIRST	Треба дати їм шанс виправдати себе.	true
cdir_events_dilemma_choice_details_localised_choice_title_att_political_action_dilemma_gather_support_oppositionSECOND	Зробимо їм пропозицію, від якої вони не зможуть відмовитися...	true
cdir_events_dilemma_choice_details_localised_choice_label_att_dilemma_religious_christian_the_council_of_toledo_1SECOND	Голосувати проти Присцилліана	true
cdir_events_dilemma_choice_details_localised_choice_label_att_subject_politics_barb_nomad_secret_meetingsFIRST	Вбити їх	true
cdir_events_dilemma_choice_details_localised_choice_label_att_bel_request_theodosia_pope_1SECOND	Нічого не робити	true
cdir_events_dilemma_choice_details_localised_choice_title_att_political_action_dilemma_diminish_popularity_reversalFIRST	Нехай всі знають, що це наклеп. Це просто непорозуміння!	true
cdir_events_dilemma_choice_details_localised_choice_label_att_subject_politics_barb_nomad_secret_meetingsSECOND	Зустрітися з ними	true
cdir_events_dilemma_choice_details_localised_choice_title_att_subject_domestic_civil_married_slavesFIRST	Хто ми такі, щоб заважати коханню?	true
cdir_events_dilemma_choice_details_localised_choice_title_att_dilemma_religious_christian_conference_of_carthage_1SECOND	Хіба не всі ми християни, діти всемогутнього Господа?	true
cdir_events_dilemma_choice_details_localised_choice_title_att_subject_religious_barb_stonesSECOND	Можливо, ми задобримо духів, запропонувавши їм їжу?	true
cdir_events_dilemma_choice_details_localised_choice_title_ollam_ri_A1FIRST	Мабуть, це відьма-перевертень з народу сидів!	true
cdir_events_dilemma_choice_details_localised_choice_title_ollam_ri_B1FIRST	Якщо це їх врятує, король так і вчинить.	true
cdir_events_dilemma_choice_details_localised_choice_title_att_bel_request_justinian_photius_1FIRST	Твої слова повернули мені розум. Я підкорюся.	true
cdir_events_dilemma_choice_details_localised_choice_title_att_subject_religious_hellenic_illegal_practice_1SECOND	Ми терпимо ставимося до чужих вірувань. Відпусти його.	true
cdir_events_dilemma_choice_details_localised_choice_title_ollam_ri_AFIRST	Навіть багатий і могутній друїд завжди служить іншим.	true
cdir_events_dilemma_choice_details_localised_choice_title_att_subject_religious_zoroastrian_corpseFIRST	Треба покарати його за цей жахливий злочин.	true
cdir_events_dilemma_choice_details_localised_choice_label_political_event_assassination_success_discoveredSECOND	Проявити милосердя	true
cdir_events_dilemma_choice_details_localised_choice_label_att_political_action_dilemma_embezzlement_caughtFOURTH	Неважливо	true
cdir_events_dilemma_choice_details_localised_choice_title_ollam_ri_ATHIRD	Король схопив рибу і втік. Старий не став переслідувати його.	true
cdir_events_dilemma_choice_details_localised_choice_title_att_subject_religious_germanic_illegal_practice_1SECOND	Ми вважаємо, що це - незначний проступок. Звільнити його.	true
cdir_events_dilemma_choice_details_localised_choice_title_att_subject_religious_zoroastrian_corpseTHIRD	Очевидно, що цей чоловік збожеволів від горя.	true
cdir_events_dilemma_choice_details_localised_choice_label_ybor_level_A_langobardiFIRST	Розкішний меч	true
cdir_events_dilemma_choice_details_localised_choice_label_att_political_action_dilemma_secure_loyalty_mutilationSECOND	Осліпити	true
cdir_events_dilemma_choice_details_localised_choice_label_att_dilemma_religious_christian_the_manichean_heresy_1SECOND	Жити в злагоді	true
cdir_events_dilemma_choice_details_localised_choice_label_cha_dilemma_mercia_1FIRST	Відпустити його	true
cdir_events_dilemma_choice_details_localised_choice_title_att_subject_religious_none_the_relic_seller_1FIRST	Ми не повинні займатися цією справою.	true
cdir_events_dilemma_choice_details_localised_choice_title_political_event_adoptionFIRST	Ми цього не допустимо.	true
cdir_events_dilemma_choice_details_localised_choice_title_att_political_action_dilemma_assassinate_caughtTHIRD	Вони самі можуть себе захистити. Не будемо втручатися в хід правосуддя.	true
cdir_events_dilemma_choice_details_localised_choice_title_att_subject_religious_celtic_pilgrims_1SECOND	Ці варвари повинні негайно покинути наші землі. Хто знає, що вони там замишляють.	true
cdir_events_dilemma_choice_details_localised_choice_title_att_subject_domestic_roman_slave_murdererFOURTH	Нічого доброго з цього не вийде.	true
cdir_events_dilemma_choice_details_localised_choice_title_att_subject_religious_none_the_relic_seller_1THIRD	Їхні мерзенні справи ображають Господа. Напевно, цей негідник - карфагенянин! Його потрібно якомога швидше віддати під суд.	true
cdir_events_dilemma_choice_details_localised_choice_title_att_subject_politics_barb_nomad_tribal_loyaltyFOURTH	Воїни не можуть жити в мирі. Навіщо втручатися в природний хід речей?	true
cdir_events_dilemma_choice_details_localised_choice_label_att_subject_religious_tengri_illegal_practice_1SECOND	Звільнити його	true
cdir_events_dilemma_choice_details_localised_choice_title_att_political_action_dilemma_assassinate_caughtFIRST	Вони просто опинилися не в тому місці, не в той час.	true
cdir_events_dilemma_choice_details_localised_choice_label_cha_dilemma_carloman_successionFOURTH	Не робити нічого	true
cdir_events_dilemma_choice_details_localised_choice_title_att_subject_domestic_none_foreign_migrants_1THIRD	Розселимо їх, щоб вони не жили в одному і тому ж місці. Так ми зменшимо їхній вплив на нашу культуру.	true
cdir_events_dilemma_choice_details_localised_choice_label_att_subject_nomadic_tribal_strife_1FIRST	Не звертати уваги	true
cdir_events_dilemma_choice_details_localised_choice_label_att_subject_politics_barb_nomad_challengerFIRST	Нехай говорить	true
cdir_events_dilemma_choice_details_localised_choice_label_att_subject_religious_zoroastrian_brazierSECOND	Вбити його	true
cdir_events_dilemma_choice_details_localised_choice_label_att_subject_military_none_the_gift_of_speed_1THIRD	Відправити їх в армію	true
cdir_events_dilemma_choice_details_localised_choice_title_att_subject_religious_manichaeism_pilgrims_1FIRST	Їхні справи нас не стосуються.	true
cdir_events_dilemma_choice_details_localised_choice_label_att_subject_religious_barb_stonesFIRST	Відправити мудреця	true
cdir_events_dilemma_choice_details_localised_choice_label_att_subject_domestic_roman_the_chariot_races_1FIRST	Не звертати уваги	true
cdir_events_dilemma_choice_details_localised_choice_label_att_subject_religious_tengri_pilgrims_1SECOND	Заборонити	true
cdir_events_dilemma_choice_details_localised_choice_label_att_eos_religious_event_rebellion_att_fact_himyar_att_rel_judaismSECOND	Підкупити його	true
cdir_events_dilemma_choice_details_localised_choice_title_att_subject_domestic_none_foreign_migrants_1FIRST	Від них шкоди не буде, нехай йдуть, куди їм заманеться.	true
cdir_events_dilemma_choice_details_localised_choice_label_att_subject_nomadic_tribal_strife_1THIRD	Відправити в заслання обидві групи	true
cdir_events_dilemma_choice_details_localised_choice_title_att_subject_domestic_civil_married_slavesSECOND	Обидва вірні тобі, але такого допускати просто не можна.	true
cdir_events_dilemma_choice_details_localised_choice_label_att_subject_politics_barb_nomad_challengerTHIRD	Вбити його	true
cdir_events_dilemma_choice_details_localised_choice_label_att_subject_military_none_the_gift_of_speed_1FIRST	Проігнорувати його	true
cdir_events_dilemma_choice_details_localised_choice_title_att_subject_religious_manichaeism_pilgrims_1THIRD	Це - священне свято для цього народу. Яка від нього шкода державі?	true
cdir_events_dilemma_choice_details_localised_choice_label_att_subject_religious_barb_stonesTHIRD	Кривава жертва	true
cdir_events_dilemma_choice_details_localised_choice_title_att_subject_religious_celtic_illegal_practice_1SECOND	Ми - доброзичливий народ і терпимо ставимося до чужих слабкостей. Звільнити її.	true
cdir_events_dilemma_choice_details_localised_choice_title_political_event_assassination_success_discoveredFIRST	За це він заплатить своїм життям!	true
cdir_events_dilemma_choice_details_localised_choice_label_att_subject_domestic_barb_nomad_hostile_disputeFOURTH	Не робити нічого	true
cdir_events_dilemma_choice_details_localised_choice_label_att_political_action_dilemma_seek_bride_successFIRST	Одружитися на ній	true
cdir_events_dilemma_choice_details_localised_choice_label_att_subject_domestic_roman_the_chariot_races_1THIRD	Поставити на зелених	true
cdir_events_dilemma_choice_details_localised_choice_label_att_subject_domestic_none_the_silk_trader_1FIRST	Проігнорувати його	true
cdir_events_dilemma_choice_details_localised_choice_title_att_subject_religious_zoroastrian_brazierFOURTH	Цією справою нехай займаються священники.	true
cdir_events_dilemma_choice_details_localised_choice_title_att_subject_religious_zoroastrian_pilgrims_1THIRD	Хто ми такі, щоб судити про чужу віру? На нашу віру їх погляди не вплинуть.	true
cdir_events_dilemma_choice_details_localised_choice_title_cha_dilemma_viking_1_cha_fact_merciaFIRST	Ми візьмемо ваші гроші і залишимо вас живими.	true
cdir_events_dilemma_choice_details_localised_choice_label_att_dilemma_religious_christian_the_manichean_heresy_1FIRST	Вони - єретики	true
cdir_events_dilemma_choice_details_localised_choice_label_att_political_action_dilemma_marriage_impedimentTHIRD	Неважливо	true
cdir_events_dilemma_choice_details_localised_choice_label_att_subject_diplomatic_none_turncoat_1THIRD	Дати йому притулок	true
cdir_events_dilemma_choice_details_localised_choice_title_ollam_ri_ebdaniFIRST	У його чорній гладі відбиваються всі таємниці людей.	true
cdir_events_dilemma_choice_details_localised_choice_title_att_subject_domestic_barb_nomad_hostile_disputeSECOND	Вигнати його на найвіддаленішу околицю! Нехай його доля послужить прикладом для всіх!	true
cdir_events_dilemma_choice_details_localised_choice_label_att_subject_domestic_none_the_silk_trader_1THIRD	Заключити під варту	true
cdir_events_dilemma_choice_details_localised_choice_title_att_subject_religious_christian_the_black_sheep_1SECOND	Якщо диякон хоче зберегти свою посаду, його сім'я повинна хреститися.	true
cdir_events_dilemma_choice_details_localised_choice_label_att_subject_domestic_civil_married_slavesFOURTH	Не робити нічого	true
cdir_events_dilemma_choice_details_localised_choice_title_att_subject_religious_zoroastrian_pilgrims_1FIRST	Справи паломників держави не стосуються.	true
cdir_events_dilemma_choice_details_localised_choice_title_cha_dilemma_viking_1_cha_fact_merciaTHIRD	Вважаєте нас дурнями? Коли ви всі помрете, ми і так заберемо ваші гроші, так навіщо торгуватися?	true
cdir_events_dilemma_choice_details_localised_choice_label_att_political_action_dilemma_seek_bride_successSECOND	Відкинути її	true
cdir_events_dilemma_choice_details_localised_choice_title_att_subject_diplomatic_none_turncoat_1SECOND	Зраду ми не схвалюємо, нехай навіть вона і могла б принести нам користь. Відведіть його геть, не варто ображати сусідів.	true
cdir_events_dilemma_choice_details_localised_choice_label_att_political_action_dilemma_marriage_impedimentFIRST	Підкуп	true
cdir_events_dilemma_choice_details_localised_choice_label_att_subject_domestic_none_the_festival_1SECOND	Народ	true
cdir_events_dilemma_choice_details_localised_choice_label_att_subject_diplomatic_none_turncoat_1FIRST	Проігнорувати його	true
cdir_events_dilemma_choice_details_localised_choice_title_att_dilemma_religious_orthodox_religious_sanctions_1FIRST	Для нас всі люди рівні. До православних християн потрібно ставитися так само, як і до всіх інших.	true
cdir_events_dilemma_choice_details_localised_choice_title_att_political_action_dilemma_diminish_popularity_reversalSECOND	Нехай всі знають, що подібні дії не залишаться безкарними.	true
cdir_events_dilemma_choice_details_localised_choice_title_att_subject_domestic_barb_temple_sacrilegeTHIRD	Покарати нечестивця і заслужити прихильність богів.	true
cdir_events_dilemma_choice_details_localised_choice_title_cha_dilemma_carloman_successionSECOND	Підтримати сина	true
cdir_events_dilemma_choice_details_localised_choice_title_cha_dilemma_carloman_successionFIRST	Заявити свої права	true
cdir_events_dilemma_choice_details_localised_choice_label_att_dilemma_military_none_war_child_1FIRST	Забрати дитину	true
cdir_events_dilemma_choice_details_localised_choice_label_att_subject_domestic_roman_slave_murdererSECOND	Видати його	true
cdir_events_dilemma_choice_details_localised_choice_title_att_subject_domestic_barb_temple_sacrilegeFIRST	Щедра пожертва на потреби храму допоможе вирішити цю проблему.	true
cdir_events_dilemma_choice_details_localised_choice_title_cha_dilemma_carloman_successionTHIRD	Фінансувати сепаратистів	true
cdir_events_dilemma_choice_details_localised_choice_label_att_subject_domestic_roman_slave_murdererFOURTH	Не робити нічого	true
cdir_events_dilemma_choice_details_localised_choice_title_cha_dilemma_mercia_1FIRST	Нам дуже гірко з тобою розлучатися, але ми не будемо тебе утримувати.	true
cdir_events_dilemma_choice_details_localised_choice_label_political_event_adoptionFIRST	Заборонити усиновлення	true
cdir_events_dilemma_choice_details_localised_choice_title_cha_dilemma_viking_1_cha_fact_northumbriaFIRST	Ми візьмемо ваші гроші і залишимо вас живими.	true
cdir_events_dilemma_choice_details_localised_choice_label_att_subject_religious_celtic_pilgrims_1SECOND	Заборонити	true
cdir_events_dilemma_choice_details_localised_choice_title_att_subject_religious_tengri_illegal_practice_1SECOND	Ми терпимо ставимося до чужих вірувань. Відпусти його.	true
cdir_events_dilemma_choice_details_localised_choice_title_cha_dilemma_viking_1_cha_fact_northumbriaTHIRD	Вважаєте нас дурнями? Коли ви всі помрете, ми і так заберемо ваші гроші, так навіщо торгуватися?	true
cdir_events_dilemma_choice_details_localised_choice_title_cha_dilemma_carloman_successionFOURTH	Не робити нічого	true
cdir_events_dilemma_choice_details_localised_choice_label_att_subject_domestic_none_withholding_taxes_1FIRST	Не звертати уваги	true
cdir_events_dilemma_choice_details_localised_choice_label_att_subject_domestic_none_foreign_migrants_1THIRD	Розсіяти їх	true
cdir_events_dilemma_choice_details_localised_choice_title_att_eos_religious_event_rebellion_att_fact_himyar_att_rel_judaismSECOND	Його народ достатньо страждав, зробимо виняток для нього, якщо це можливо.	true
cdir_events_dilemma_choice_details_localised_choice_label_att_subject_domestic_civil_married_slavesSECOND	Заборонити шлюб	true
cdir_events_dilemma_choice_details_localised_choice_title_att_subject_politics_barb_nomad_challengerTHIRD	Вбити цуценя!	true
cdir_events_dilemma_choice_details_localised_choice_title_att_dilemma_domestic_none_plentiful_harvest_1FIRST	Цей дар долі слід використовувати на благо народу.	true
cdir_events_dilemma_choice_details_localised_choice_label_att_subject_religious_manichaeism_pilgrims_1FIRST	Не робити нічого	true
cdir_events_dilemma_choice_details_localised_choice_title_ybor_level_C_1SECOND	Ібор вийшов назустріч ворогам і звернувся до них з промовою.	true
cdir_events_dilemma_choice_details_localised_choice_title_ybor_level_C_2SECOND	Відібрати життя може будь-хто, а ось повернути його під силу лише великим.	true
cdir_events_dilemma_choice_details_localised_choice_title_ybor_level_C_3SECOND	Ібор пішов до святилища просити допомоги у Годана.	true
cdir_events_dilemma_choice_details_localised_choice_title_ybor_level_C_4SECOND	Ібору не потрібна допомога богів - він стане радником.	true
cdir_events_dilemma_choice_details_localised_choice_title_ybor_level_B_1SECOND	Годан свідок, він буде помщений.	true
cdir_events_dilemma_choice_details_localised_choice_title_ybor_level_B_2SECOND	Владним голосом Ібор наказав селянам взятися за справу.	true
cdir_events_dilemma_choice_details_localised_choice_label_att_subject_domestic_none_the_festival_1FOURTH	Ритуал	true
cdir_events_dilemma_choice_details_localised_choice_title_att_subject_domestic_roman_the_chariot_races_1THIRD	Настав час зелених! Постав на них весь річний бюджет, виділений на каналізацію.	true
cdir_events_dilemma_choice_details_localised_choice_title_att_subject_religious_tengri_pilgrims_1SECOND	Розігнати мерзенних язичників. Тих, хто не піде до сходу сонця, вбити.	true
cdir_events_dilemma_choice_details_localised_choice_title_att_subject_domestic_roman_slave_murdererTHIRD	Те, що робив цей чоловік після того, як перестав служити тобі - не твоя справа.	true
cdir_events_dilemma_choice_details_localised_choice_label_att_subject_domestic_none_withholding_taxes_1THIRD	Вмовити їх	true
cdir_events_dilemma_choice_details_localised_choice_label_att_subject_domestic_none_foreign_migrants_1FIRST	Не звертати уваги	true
cdir_events_dilemma_choice_details_localised_choice_title_att_subject_politics_barb_nomad_challengerFIRST	Зухвалість його згубить.	true
cdir_events_dilemma_choice_details_localised_choice_title_att_subject_religious_zoroastrian_brazierSECOND	Це не якась дрібниця. Хлопця потрібно покарати.	true
cdir_events_dilemma_choice_details_localised_choice_label_att_subject_religious_manichaeism_pilgrims_1THIRD	Дозволити	true
cdir_events_dilemma_choice_details_localised_choice_label_political_event_assassination_success_discoveredFIRST	Стратити його	true
cdir_events_dilemma_choice_details_localised_choice_label_att_subject_religious_celtic_illegal_practice_1SECOND	Звільнити її	true
cdir_events_dilemma_choice_details_localised_choice_label_political_event_marriage_femaleFIRST	Втрутитися	true
cdir_events_dilemma_choice_details_localised_choice_title_att_subject_domestic_roman_the_chariot_races_1FIRST	Я не збираюся витрачати наші багатства на ці дурниці. Не говори зі мною більше про перегони і ставки.	true
cdir_events_dilemma_choice_details_localised_choice_title_att_subject_domestic_roman_slave_murdererFIRST	Найбезпечніше - змусити його замовкнути. Нехай замовкне назавжди.	true
cdir_events_dilemma_choice_details_localised_choice_title_att_subject_domestic_barb_nomad_hostile_disputeFOURTH	Такі ситуації неминучі. Все вирішиться само собою.	true
cdir_events_dilemma_choice_details_localised_choice_label_att_subject_religious_zoroastrian_pilgrims_1THIRD	Дозволити	true
cdir_events_dilemma_choice_details_localised_choice_label_cha_dilemma_viking_1_cha_fact_merciaFIRST	Забрати золото	true
cdir_events_dilemma_choice_details_localised_choice_label_att_subject_religious_christian_the_black_sheep_1SECOND	Хрестити її силою	true
cdir_events_dilemma_choice_details_localised_choice_title_att_subject_domestic_civil_married_slavesFOURTH	Тобі не варто витрачати на це час.	true
cdir_events_dilemma_choice_details_localised_choice_title_att_political_action_dilemma_marriage_impedimentTHIRD	Це нас не стосується. Ми займаємося більш важливими справами.	true
cdir_events_dilemma_choice_details_localised_choice_label_att_subject_domestic_barb_nomad_hostile_disputeSECOND	Відіслати його	true
cdir_events_dilemma_choice_details_localised_choice_title_att_subject_diplomatic_none_turncoat_1FIRST	Його благання мене не зворушують. Нехай зрадник сам про себе подбає.	true
cdir_events_dilemma_choice_details_localised_choice_label_att_eos_religious_event_rebellion_att_fact_himyar_att_rel_judaismFIRST	Вигнати його	true
cdir_events_dilemma_choice_details_localised_choice_label_att_subject_religious_zoroastrian_brazierFIRST	Оштрафувати його	true
cdir_events_dilemma_choice_details_localised_choice_label_att_subject_domestic_barb_nomad_hostile_disputeTHIRD	Засудити його суперника	true
cdir_events_dilemma_choice_details_localised_choice_label_att_subject_religious_zoroastrian_pilgrims_1FIRST	Проігнорувати його	true
cdir_events_dilemma_choice_details_localised_choice_label_cha_dilemma_viking_1_cha_fact_merciaTHIRD	Відмовитися	true
cdir_events_dilemma_choice_details_localised_choice_label_att_subject_religious_zoroastrian_brazierFOURTH	Не робити нічого	true
cdir_events_dilemma_choice_details_localised_choice_title_att_political_action_dilemma_seek_bride_successSECOND	Ні. Вона - не та, хто нам потрібна.	true
cdir_events_dilemma_choice_details_localised_choice_title_att_dilemma_religious_christian_the_manichean_heresy_1FIRST	Якщо не втрутитися, це вчення збиває з шляху добрих християн.	true
cdir_events_dilemma_choice_details_localised_choice_title_att_political_action_dilemma_marriage_impedimentFIRST	Може, це їх переконає?	true
cdir_events_dilemma_choice_details_localised_choice_title_att_subject_diplomatic_none_turncoat_1THIRD	Всі ці знання, звідки б вони не взялися, мають величезну цінність. Нехай він залишиться - хоча б до тих пір, поки може приносити користь...	true
cdir_events_dilemma_choice_details_localised_choice_label_att_subject_religious_zoroastrian_brazierTHIRD	Пробачити його	true
cdir_events_dilemma_choice_details_localised_choice_label_att_subject_domestic_barb_nomad_hostile_disputeFIRST	Покарати його	true
cdir_events_dilemma_choice_details_localised_choice_label_att_dilemma_religious_orthodox_religious_sanctions_1FIRST	Надати їм рівні права	true
cdir_events_dilemma_choice_details_localised_choice_title_att_subject_domestic_roman_slave_murdererSECOND	Твій обов'язок - повідомити владі про його злочини.	true
cdir_events_dilemma_choice_details_localised_choice_title_att_subject_military_none_war_child_1FIRST	Прикинемося, що ми нічого не чули. Яка дитина?	true
cdir_events_dilemma_choice_details_localised_choice_label_att_subject_domestic_barb_temple_sacrilegeFIRST	Відкупитися від храму	true
cdir_events_dilemma_choice_details_localised_choice_title_att_subject_politics_barb_nomad_tribal_loyaltySECOND	Нехай все плем'я вирішує, хто сильніший!	true
cdir_events_dilemma_choice_details_localised_choice_label_political_event_blackmailFIRST	Підкупити його	true
cdir_events_dilemma_choice_details_localised_choice_label_cha_dilemma_carloman_successionSECOND	Підтримати сина	true
cdir_events_dilemma_choice_details_localised_choice_title_att_subject_military_none_war_child_1THIRD	Він має право знати правду. Кожен чоловік повинен знати, хто його батьки.	true
cdir_events_dilemma_choice_details_localised_choice_label_att_political_action_dilemma_diminish_popularity_reversalSECOND	Засудити	true
cdir_events_dilemma_choice_details_localised_choice_label_att_subject_domestic_barb_temple_sacrilegeTHIRD	Покарати його самостійно	true
cdir_events_dilemma_choice_details_localised_choice_label_cha_dilemma_mercia_2_2SECOND	Залякати його	true
cdir_events_dilemma_choice_details_localised_choice_label_att_subject_domestic_roman_the_chariot_races_1SECOND	Поставити на синіх	true
cdir_events_dilemma_choice_details_localised_choice_title_att_subject_domestic_civil_master_agitatorFIRST	Ми спишемо всі борги.	true
cdir_events_dilemma_choice_details_localised_choice_title_att_political_action_dilemma_diminish_popularity_followup_mercifulTHIRD	Його репутація - не наша справа.	true
cdir_events_dilemma_choice_details_localised_choice_label_att_subject_politics_barb_nomad_tribal_loyaltyFOURTH	Не робити нічого	true
cdir_events_dilemma_choice_details_localised_choice_label_att_political_action_dilemma_assassinate_caughtFIRST	Виправдати	true
cdir_events_dilemma_choice_details_localised_choice_label_att_subject_military_none_the_lanista_1SECOND	Призначити наставником	true
cdir_events_dilemma_choice_details_localised_choice_title_att_subject_domestic_civil_master_agitatorTHIRD	Треба зірвати плани цього політика і звинуватити його в невдачі!	true
cdir_events_dilemma_choice_details_localised_choice_title_att_dilemma_military_none_war_child_1FIRST	Не можна залишати беззахисне немовля в цьому жахливому місці.	true
cdir_events_dilemma_choice_details_localised_choice_title_att_political_action_dilemma_diminish_popularity_followup_mercifulFIRST	Нехай всі знають, що цього разу його пробачили. Однак у майбутньому ми, можливо, не будемо настільки милосердними...	true
cdir_events_dilemma_choice_details_localised_choice_label_att_political_action_dilemma_assassinate_caughtTHIRD	Неважливо	true
cdir_events_dilemma_choice_details_localised_choice_title_att_eos_religious_event_rebellion_att_fact_axum_att_rel_semitic_paganismFIRST	Ми не будемо витрачати на цих єретиків ні час, ні гроші. Їхні погрози - порожні слова!	true
cdir_events_dilemma_choice_details_localised_choice_label_slav_dilemma_anteans_1FIRST	Відправити його до Риму	true
cdir_events_dilemma_choice_details_localised_choice_title_att_subject_domestic_none_excess_materials_1FIRST	Будівля добудована. Яке мені діло до каменю, що залишився?	true
cdir_events_dilemma_choice_details_localised_choice_title_att_subject_nomadic_tribal_strife_1THIRD	У нас немає часу на ці дурниці. Збирайтеся і йдіть.	true
cdir_events_dilemma_choice_details_localised_choice_title_att_subject_religious_zoroastrian_illegal_practice_1THIRD	Навряд чи хтось зможе переконати цього дурня. Нехай гниє в темниці.	true
cdir_events_dilemma_choice_details_localised_choice_label_slav_dilemma_anteans_2FIRST	Відпустити його	true
cdir_events_dilemma_choice_details_localised_choice_title_att_political_action_dilemma_seek_bride_successFIRST	Так! Ця красуня стане ідеальною дружиною.	true
cdir_events_dilemma_choice_details_localised_choice_label_att_dilemma_religious_hellenic_religious_sanctions_1FIRST	Дати їм рівні права	true
cdir_events_dilemma_choice_details_localised_choice_label_att_dilemma_religious_germanic_religious_sanctions_1FIRST	Дати їм рівні права	true
cdir_events_dilemma_choice_details_localised_choice_title_att_subject_domestic_nomadic_the_kassai_contest_1SECOND	Він повинен думати про війну, а не про ігри. У нас на нього інші плани.	true
cdir_events_dilemma_choice_details_localised_choice_title_att_subject_domestic_none_excess_materials_1THIRD	Якщо ці матеріали нам не знадобляться, потрібно постаратися виручити за них хоча б частину витрачених грошей.	true
cdir_events_dilemma_choice_details_localised_choice_title_att_subject_nomadic_tribal_strife_1FIRST	Рано чи пізно хвастощі не приведуть їх до добра.	true
cdir_events_dilemma_choice_details_localised_choice_title_att_subject_religious_zoroastrian_illegal_practice_1FIRST	Стратити його - прилюдно, для повчання іншим.	true
cdir_events_dilemma_choice_details_localised_choice_title_att_dilemma_religious_christian_council_of_ephesus_1FIRST	Ця людина вчить, що свята трійця - Бог-отець, Бог-син і Святий дух - не є неподільною.	true
cdir_events_dilemma_choice_details_localised_choice_title_att_eos_sassanid_insult_1SECOND	Спробувати якомога м'якше і ненав'язливо змінити тему.	true
cdir_events_dilemma_choice_details_localised_choice_title_att_eos_sassanid_insult_2SECOND	Не можна ставити особисту гордість вище безпеки всього народу.	true
cdir_events_dilemma_choice_details_localised_choice_title_att_eos_sassanid_insult_3SECOND	Піти назустріч цареві, ризикуючи зачепити гордість свого народу.	true
cdir_events_dilemma_choice_details_localised_choice_title_att_subject_domestic_none_the_festival_1SECOND	Нам потрібно прославляти тих, завдяки кому наше суспільство існує. Подібний захід пом'якшить удар від нового - і необхідного - податку.	true
cdir_events_dilemma_choice_details_localised_choice_label_ybor_level_C_4FIRST	Пропозиція жерця	true
cdir_events_dilemma_choice_details_localised_choice_label_att_subject_politics_civil_secret_meetingsTHIRD	Зруйнувати плани	true
cdir_events_dilemma_choice_details_localised_choice_title_att_subject_domestic_none_the_silk_trader_1THIRD	Торгуючи дешевими товарами, він завдасть збитків місцевим ремісникам. Проженемо його геть, поки він не розорив наших власних купців.	true
cdir_events_dilemma_choice_details_localised_choice_title_att_subject_religious_manichaeism_illegal_practice_1FIRST	Вбити цього мерзенного сектанта для повчання іншим.	true
cdir_events_dilemma_choice_details_localised_choice_title_att_subject_military_none_the_gift_of_speed_1THIRD	Це частково покриє наші витрати на вербування солдатів. Підготуй їх до військових дій!	true
cdir_events_dilemma_choice_details_localised_choice_label_att_political_action_dilemma_embezzlement_caughtTHIRD	Засудити	true
cdir_events_dilemma_choice_details_localised_choice_label_att_subject_diplomatic_none_turncoat_1SECOND	Відіслати його геть	true
cdir_events_dilemma_choice_details_localised_choice_title_att_subject_religious_none_the_golden_tongued_1SECOND	Якщо відправити його в чужі землі, він міг би принести світло істинної віри всім народам...	true
cdir_events_dilemma_choice_details_localised_choice_title_att_subject_religious_barb_stonesFIRST	Той, хто багато років тому перетворив цих воїнів на камінь, був мудрою людиною.	true
cdir_events_dilemma_choice_details_localised_choice_label_ybor_level_C_3FIRST	Покласти руки	true
cdir_events_dilemma_choice_details_localised_choice_label_att_dilemma_religious_catholic_religious_sanctions_1FIRST	Дати їм рівні права	true
cdir_events_dilemma_choice_details_localised_choice_label_att_subject_politics_civil_secret_meetingsFIRST	Вбити їх	true
cdir_events_dilemma_choice_details_localised_choice_title_att_subject_domestic_none_the_silk_trader_1FIRST	Молодець. У таких справах діє тільки один закон - закон попиту і пропозиції!	true
cdir_events_dilemma_choice_details_localised_choice_title_att_subject_religious_manichaeism_illegal_practice_1THIRD	Нехай вигаданий ним бог наставляє його в темниці. Більше не згадуй при мені про цього негідника.	true
cdir_events_dilemma_choice_details_localised_choice_title_att_subject_military_none_the_gift_of_speed_1FIRST	На даний момент це нас не цікавить.	true
cdir_events_dilemma_choice_details_localised_choice_label_att_political_action_dilemma_embezzlement_caughtFIRST	Приховування	true
cdir_events_dilemma_choice_details_localised_choice_title_att_subject_religious_barb_stonesTHIRD	Їм потрібна кров. Тільки вона поверне духів назад в інший світ.	true
cdir_events_dilemma_choice_details_localised_choice_label_ollam_ri_ebdaniFIRST	Він йде до озера.	true
cdir_events_dilemma_choice_details_localised_choice_label_ybor_level_B_2FIRST	Крок у вогонь	true
cdir_events_dilemma_choice_details_localised_choice_label_ybor_level_C_2FIRST	Шлях воїна	true
cdir_events_dilemma_choice_details_localised_choice_label_ollam_ri_ebdaniSECOND	Він йде в ліс.	true
cdir_events_dilemma_choice_details_localised_choice_label_cha_dilemma_pope_help_1SECOND	Прийняти сторону ломбардів	true
cdir_events_dilemma_choice_details_localised_choice_label_att_eos_religious_event_rebellion_att_fact_himyar_att_rel_semitic_paganismFIRST	Вигнати його	true
cdir_events_dilemma_choice_details_localised_choice_title_att_subject_domestic_nordic_the_flyting_1SECOND	Вони, немов боягузливі пси, втечуть геть, підібгавши хвости!	true
cdir_events_dilemma_choice_details_localised_choice_label_att_subject_religious_none_the_relic_seller_1FIRST	Не робити нічого	true
cdir_events_dilemma_choice_details_localised_choice_title_political_event_assassination_failure_discoveredFIRST	Відрубати йому голову!	true
cdir_events_dilemma_choice_details_localised_choice_label_att_subject_diplomatic_none_the_feast_1SECOND	Запроси сусідів	true
cdir_events_dilemma_choice_details_localised_choice_title_cha_dilemma_mercia_2_2FIRST	Пробач мою гордість, Алкуїне. Відправляйся в нові землі.	true
cdir_events_dilemma_choice_details_localised_choice_label_ybor_level_B_1FIRST	Скальд	true
cdir_events_dilemma_choice_details_localised_choice_label_ybor_level_C_1FIRST	Доблесний бій	true
cdir_events_dilemma_choice_details_localised_choice_label_cha_dilemma_carloman_successionTHIRD	Фінансувати сепаратистів	true
cdir_events_dilemma_choice_details_localised_choice_label_att_dilemma_religious_arian_religious_sanctions_1SECOND	Ввести санкції	true
cdir_events_dilemma_choice_details_localised_choice_label_att_subject_religious_none_the_relic_seller_1THIRD	Розкрити його злочини	true
cdir_events_dilemma_choice_details_localised_choice_label_cha_dilemma_carloman_successionFIRST	Забрати його землі	true
cdir_events_dilemma_choice_details_localised_choice_label_att_subject_military_none_war_child_1FIRST	Проігнорувати його	true
cdir_events_dilemma_choice_details_localised_choice_label_att_subject_domestic_civil_master_agitatorTHIRD	Зруйнувати плани	true
cdir_events_dilemma_choice_details_localised_choice_label_att_political_action_dilemma_diminish_popularity_followup_mercifulFIRST	Хіба я не милостивий?	true
cdir_events_dilemma_choice_details_localised_choice_title_political_event_blackmailFIRST	Може, це змусить його замовкнути?	true
cdir_events_dilemma_choice_details_localised_choice_title_slav_dilemma_anteans_1FIRST	Могутність Риму велика. Його гнів смертельно небезпечний, а дружба безцінна...	true
cdir_events_dilemma_choice_details_localised_choice_title_att_subject_military_none_the_lanista_1SECOND	Він зможе передати свій досвід молодим. Відправ його на арену.	true
cdir_events_dilemma_choice_details_localised_choice_label_att_subject_military_none_war_child_1THIRD	Сказати правду	true
cdir_events_dilemma_choice_details_localised_choice_label_att_subject_domestic_civil_master_agitatorFIRST	Пробачити борги	true
cdir_events_dilemma_choice_details_localised_choice_label_att_political_action_dilemma_diminish_popularity_followup_mercifulTHIRD	Неважливо	true
cdir_events_dilemma_choice_details_localised_choice_label_att_eos_religious_event_rebellion_att_fact_axum_att_rel_semitic_paganismFIRST	Вигнати його	true
cdir_events_dilemma_choice_details_localised_choice_label_att_subject_religious_zoroastrian_illegal_practice_1THIRD	Залишити його у в'язниці	true
cdir_events_dilemma_choice_details_localised_choice_label_att_eos_sassanid_insult_1SECOND	Погодитися з ним	true
cdir_events_dilemma_choice_details_localised_choice_label_att_eos_sassanid_insult_2SECOND	Вибачитися	true
cdir_events_dilemma_choice_details_localised_choice_label_att_eos_sassanid_insult_3SECOND	Сказати те, що він хоче	true
cdir_events_dilemma_choice_details_localised_choice_label_att_subject_domestic_nomadic_the_kassai_contest_1SECOND	Заборонити участь	true
cdir_events_dilemma_choice_details_localised_choice_label_att_subject_domestic_none_excess_materials_1FIRST	Не звертати уваги	true
cdir_events_dilemma_choice_details_localised_choice_title_political_event_marriage_femaleFIRST	Цей чоловік не гідний бути її чоловіком.	true
cdir_events_dilemma_choice_details_localised_choice_title_att_subject_religious_zoroastrian_brazierFIRST	Хлопчик повинен навчитися більш відповідально ставитися до своїх обов'язків.	true
cdir_events_dilemma_choice_details_localised_choice_title_att_eos_religious_event_rebellion_att_fact_himyar_att_rel_judaismFIRST	Ми не будемо витрачати на цих єретиків ні час, ні гроші. Їхні погрози - порожні слова!	true
cdir_events_dilemma_choice_details_localised_choice_title_ybor_level_C_4FIRST	Боги вище за смертних володарів. Ібор стане жерцем.	true
cdir_events_dilemma_choice_details_localised_choice_title_att_dilemma_religious_germanic_religious_sanctions_1FIRST	Для нас всі люди рівні. До язичників потрібно ставитися так само, як і до всіх інших.	true
cdir_events_dilemma_choice_details_localised_choice_title_att_dilemma_religious_hellenic_religious_sanctions_1FIRST	Для нас всі люди рівні. До язичників потрібно ставитися так само, як і до всіх інших.	true
cdir_events_dilemma_choice_details_localised_choice_label_att_dilemma_religious_christian_council_of_ephesus_1FIRST	Засудити Несторія	true
cdir_events_dilemma_choice_details_localised_choice_label_att_subject_religious_zoroastrian_illegal_practice_1FIRST	Стратити його	true
cdir_events_dilemma_choice_details_localised_choice_label_att_subject_domestic_none_excess_materials_1THIRD	Продати надлишки	true
cdir_events_dilemma_choice_details_localised_choice_title_slav_dilemma_anteans_2FIRST	Що зроблено, те зроблено. Не варто витрачати час на погоню за ним.	true
cdir_events_dilemma_choice_details_localised_choice_label_ybor_level_C_1SECOND	Поєдинок воль	true
cdir_events_dilemma_choice_details_localised_choice_label_ybor_level_C_2SECOND	Шлях цілителя	true
cdir_events_dilemma_choice_details_localised_choice_label_ybor_level_C_3SECOND	Шукати мудрості	true
cdir_events_dilemma_choice_details_localised_choice_label_ybor_level_C_4SECOND	Пропозиція правителя	true
cdir_events_dilemma_choice_details_localised_choice_label_ybor_level_B_1SECOND	Жриця	true
cdir_events_dilemma_choice_details_localised_choice_label_ybor_level_B_2SECOND	Загасити вогонь	true
cdir_events_dilemma_choice_details_localised_choice_title_att_subject_religious_zoroastrian_brazierTHIRD	Він молодий, але він ще навчиться.	true
cdir_events_dilemma_choice_details_localised_choice_title_att_subject_politics_civil_secret_meetingsFIRST	Такі зустрічі нічим добрим не закінчаться. Треба вбити всіх підозрюваних у змові.	true
cdir_events_dilemma_choice_details_localised_choice_title_att_subject_domestic_none_withholding_taxes_1FIRST	Зараз ми нічого не будемо робити, але колись ми з ними розрахуємося.	true
cdir_events_dilemma_choice_details_localised_choice_label_att_subject_religious_manichaeism_illegal_practice_1FIRST	Стратити його	true
cdir_events_dilemma_choice_details_localised_choice_label_att_dilemma_domestic_none_plentiful_harvest_1FIRST	Віддати народу	true
cdir_events_dilemma_choice_details_localised_choice_label_att_subject_religious_none_the_golden_tongued_1SECOND	Відправити його за кордон	true
cdir_events_dilemma_choice_details_localised_choice_title_att_political_action_dilemma_embezzlement_caughtTHIRD	Нехай всі знають, що подібні дії не залишаться безкарними.	true
cdir_events_dilemma_choice_details_localised_choice_title_att_subject_domestic_none_the_festival_1FOURTH	Ми повинні прославляти богів. Без їхнього благословення наш народ нічого б не досяг.	true
cdir_events_dilemma_choice_details_localised_choice_label_att_subject_domestic_roman_slave_murdererTHIRD	Прикинутися незнаючим	true
cdir_events_dilemma_choice_details_localised_choice_title_att_subject_domestic_barb_nomad_hostile_disputeFIRST	Треба публічно засудити його, щоб всі знали, що подібні витівки не залишаться безкарними.	true
cdir_events_dilemma_choice_details_localised_choice_title_ybor_level_B_2FIRST	Вірячи в заступництво Годана, Ібор зробив крок у вогонь.	true
cdir_events_dilemma_choice_details_localised_choice_title_ybor_level_C_2FIRST	Якщо вбити ворога до того, як він заподіє зло, цілителі не знадобляться.	true
cdir_events_dilemma_choice_details_localised_choice_title_att_dilemma_religious_catholic_religious_sanctions_1FIRST	Для нас всі люди рівні. До католиків потрібно ставитися так само, як і до всіх інших.	true
cdir_events_dilemma_choice_details_localised_choice_title_att_subject_politics_civil_secret_meetingsTHIRD	Ми кинемо відкритий виклик змовникам, щоб всі дізналися про їхні нечестиві задуми.	true
cdir_events_dilemma_choice_details_localised_choice_title_att_subject_domestic_none_withholding_taxes_1THIRD	Вирішимо справу в ході переговорів. Можливо, у них дійсно є привід для скарг.	true
cdir_events_dilemma_choice_details_localised_choice_label_att_subject_religious_manichaeism_illegal_practice_1THIRD	Залишити його у в'язниці	true
cdir_events_dilemma_choice_details_localised_choice_title_att_political_action_dilemma_embezzlement_caughtFIRST	Проходь, проходь. Немає тут на що дивитися...	true
cdir_events_dilemma_choice_details_localised_choice_title_ollam_ri_ebdaniSECOND	Вікові дерева несуть життя хоробрим і смерть необережним.	true
cdir_events_dilemma_choice_details_localised_choice_title_cha_dilemma_pope_help_1SECOND	Обіцянки давно померлих людей не повинні впливати на сучасні кордони.	true
cdir_events_dilemma_choice_details_localised_choice_label_att_subject_domestic_roman_slave_murdererFIRST	Змусити його замовкнути	true
cdir_events_dilemma_choice_details_localised_choice_title_att_subject_domestic_barb_nomad_hostile_disputeTHIRD	Кровне споріднення понад усе. Треба заступитися за сина.	true
cdir_events_dilemma_choice_details_localised_choice_title_ybor_level_C_3FIRST	Ібор пішов у село, щоб зцілити його жителів.	true
cdir_events_dilemma_choice_details_localised_choice_title_cha_dilemma_mercia_2_2SECOND	Ти смієш суперечити королю?! Подивимося, як далеко ти втечеш на зламаних ногах!	true
cdir_events_dilemma_choice_details_localised_choice_title_att_dilemma_religious_arian_religious_sanctions_1SECOND	Ми повинні прийняти закон, що обмежує права єретиків молитися.	true
cdir_events_dilemma_choice_details_localised_choice_title_att_subject_diplomatic_none_the_feast_1SECOND	Запросимо правителів сусідніх держав. Нехай вони побачать наше багатство і силу.	true
cdir_events_dilemma_choice_details_localised_choice_label_cha_dilemma_viking_1_cha_fact_northumbriaFIRST	Забрати золото	true
cdir_events_dilemma_choice_details_localised_choice_label_political_event_assassination_failure_discoveredFIRST	Стратити його	true
cdir_events_dilemma_choice_details_localised_choice_title_att_subject_domestic_roman_the_chariot_races_1SECOND	Мені здається, що новий вершник синьої команди - справжній талант. Вони переможуть, це очевидно.	true
cdir_events_dilemma_choice_details_localised_choice_title_att_eos_religious_event_rebellion_att_fact_himyar_att_rel_semitic_paganismFIRST	Ми не будемо витрачати на цих єретиків ні час, ні гроші. Їхні погрози - порожні слова!	true
cdir_events_dilemma_choice_details_localised_choice_label_att_subject_domestic_nordic_the_flyting_1SECOND	Взяти участь особисто	true
cdir_events_dilemma_choice_details_localised_choice_label_att_subject_politics_barb_nomad_tribal_loyaltySECOND	Влаштувати поєдинок	true
cdir_events_dilemma_choice_details_localised_choice_label_cha_dilemma_viking_1_cha_fact_northumbriaTHIRD	Відмовитися	true
cdir_events_dilemma_choice_details_localised_choice_label_cha_dilemma_mercia_2_2FIRST	Відпустити його	true
cdir_events_dilemma_choice_details_localised_choice_title_ybor_level_B_1FIRST	Слова здатні змінити розум і пронизати серце.	true
cdir_events_dilemma_choice_details_localised_choice_title_ybor_level_C_1FIRST	З лютими криками Ібор кинувся в саму гущу натовпу.	true
