key	text	tooltip
#Loc;1;text/db/character_trait_levels.loc		
character_trait_levels_onscreen_name_att_trait_general_personality_all_arse_1	Допитливий	true
character_trait_levels_onscreen_name_att_trait_general_personality_all_arse_3	І так зійде	true
character_trait_levels_onscreen_name_att_trait_general_personality_all_arse_2	Гордий	true
character_trait_levels_onscreen_name_att_trait_general_military_all_high_casualties_2	Кровожерливий	true
character_trait_levels_onscreen_name_att_trait_general_military_all_high_casualties_3	Полонених не брати!	true
character_trait_levels_onscreen_name_att_trait_general_military_all_high_casualties_1	Жорстокий	true
character_trait_levels_colour_text_att_trait_general_government_all_authoritarian_2	Мої руки зв'язані. Правила є правила.	true
character_trait_levels_colour_text_att_trait_general_government_all_authoritarian_3	Милосердний уряд - це оксюморон.	true
character_trait_levels_colour_text_att_trait_general_government_all_authoritarian_1	Уряд - суворий, люблячий батько для народу.	true
character_trait_levels_colour_text_att_trait_general_military_army_all_ambusher_bad_1	Незважаючи на всі старання, його засідки завжди проходять не так.	true
character_trait_levels_colour_text_att_trait_general_military_army_all_ambusher_bad_2	З таким же успіхом він міг би вивісити знак: «Попереду засідка».	true
character_trait_levels_colour_text_att_trait_general_military_army_all_ambusher_bad_3	Він неспроможний влаштувати навіть гульбище в таверні, не кажучи вже про раптовий наліт.	true
character_trait_levels_colour_text_att_trait_general_physical_all_innate_handsome_1	Я бачу, що ти дивишся. Так, я намагаюся.	true
character_trait_levels_colour_text_att_trait_general_military_army_all_siege_defender_bad_2	Про його оборонні здібності ходять легенди. У поганому сенсі.	true
character_trait_levels_colour_text_att_trait_general_military_army_all_siege_defender_bad_3	Горе спіткає будь-яке місто, залишене на цього чоловіка!	true
character_trait_levels_colour_text_att_trait_general_military_army_all_siege_defender_bad_1	Здавши ворогам не одне укріплене місто, він щоразу рятувався втечею.	true
character_trait_levels_onscreen_name_att_trait_general_ability_all_power_5	Натиснути на весла V	true
character_trait_levels_onscreen_name_att_trait_general_ability_all_power_4	Натиснути на весла IV	true
character_trait_levels_onscreen_name_att_trait_general_ability_all_power_1	Натиснути на весла I	true
character_trait_levels_onscreen_name_att_trait_general_ability_all_power_3	Натиснути на весла III	true
character_trait_levels_onscreen_name_att_trait_general_ability_all_power_2	Натиснути на весла II	true
character_trait_levels_onscreen_name_att_trait_all_personality_all_sober_1	Помірний у питті	true
character_trait_levels_onscreen_name_att_trait_all_personality_all_sober_2	Тверезник	true
character_trait_levels_onscreen_name_att_trait_all_personality_all_sober_3	Повний тверезник	true
character_trait_levels_onscreen_name_att_trait_general_personality_all_dishonest_2	Безчесний	true
character_trait_levels_onscreen_name_att_trait_general_personality_all_dishonest_3	Закоренілий брехун	true
character_trait_levels_onscreen_name_att_trait_general_personality_all_dishonest_1	Ненадійний	true
character_trait_levels_onscreen_name_att_trait_spy_actions_all_investigator_3	Головоріз	true
character_trait_levels_onscreen_name_att_trait_spy_actions_all_investigator_2	Шантажист	true
character_trait_levels_onscreen_name_att_trait_spy_actions_all_investigator_1	Дознавач	true
character_trait_levels_onscreen_name_att_trait_general_government_all_admin_good_3	Керівник	true
character_trait_levels_onscreen_name_att_trait_general_government_all_admin_good_2	Організатор	true
character_trait_levels_onscreen_name_att_trait_general_government_all_admin_good_1	Адміністратор	true
character_trait_levels_colour_text_att_trait_general_physical_all_eunuch_1	Він створений для квітів кохання, але не годиться для його плодів.	true
character_trait_levels_colour_text_att_trait_general_personality_roman_unpatriotic_1	Багато хто не схвалює чужі смаки цієї людини.	true
character_trait_levels_colour_text_att_trait_general_personality_roman_unpatriotic_2	Ця людина захоплюється нехристиянськими речами. Огидний тип.	true
character_trait_levels_colour_text_att_trait_general_personality_roman_unpatriotic_3	П'гомова цієї людини жахвива. І фін ще навиває фебе г'імлянином... Пг'авда!	true
character_trait_levels_onscreen_name_att_trait_all_personality_all_easily_trapped_1	Не помічає пасток	true
character_trait_levels_onscreen_name_att_trait_all_personality_all_innate_uncompromising_1	Непохитний	true
character_trait_levels_colour_text_att_trait_general_ability_all_inspire_4	У битві ця людина надихає воїнів на героїчні безумства.	true
character_trait_levels_colour_text_att_trait_general_ability_all_inspire_5	У битві ця людина надихає воїнів на героїчні безумства.	true
character_trait_levels_colour_text_att_trait_general_ability_all_inspire_1	У битві ця людина надихає воїнів на героїчні безумства.	true
character_trait_levels_colour_text_att_trait_general_ability_all_inspire_2	У битві ця людина надихає воїнів на героїчні безумства.	true
character_trait_levels_colour_text_att_trait_general_ability_all_inspire_3	У битві ця людина надихає воїнів на героїчні безумства.	true
character_trait_levels_onscreen_name_cha_trait_pope_1	Папа	true
character_trait_levels_colour_text_att_trait_general_military_navy_all_defender_sea_good_3	Морські боги наділили цю людину тактичною кмітливістю.	true
character_trait_levels_colour_text_att_trait_general_military_navy_all_defender_sea_good_2	Обороняючись на морі, ця людина зазвичай перемагає.	true
character_trait_levels_colour_text_att_trait_general_military_navy_all_defender_sea_good_1	Ця людина вміє оборонятися в морі.	true
character_trait_levels_colour_text_att_trait_general_personality_all_mad_3	Я простий звичайний казанок...	true
character_trait_levels_colour_text_att_trait_general_personality_all_mad_2	Мені подобаються твої очі. У тебе красиві очі. Дуже красиві очі. Так.	true
character_trait_levels_colour_text_att_trait_general_personality_all_mad_1	Хіба це важливо? Дж-дж-дж! Дж-дж-дж! Сьогодні я зібрав занадто мало меду! Дж-дж-дж!	true
character_trait_levels_colour_text_att_trait_all_personality_all_atheist_2	Молитися? А навіщо?	true
character_trait_levels_colour_text_att_trait_all_personality_all_atheist_3	Я схожий на ідіота, який вірить в бородатих сердитих дядьків на небі?	true
character_trait_levels_colour_text_att_trait_all_personality_all_atheist_1	Кожного разу, коли настає час молитви, я дивуюся: навіщо...	true
character_trait_levels_onscreen_name_att_trait_general_personality_all_feck_2	Чорноротий	true
character_trait_levels_onscreen_name_att_trait_general_status_all_unpopular_3	Зневажений усіма	true
character_trait_levels_onscreen_name_att_trait_general_personality_all_feck_3	Лихослів	true
character_trait_levels_onscreen_name_att_trait_general_status_all_unpopular_2	Непопулярний	true
character_trait_levels_onscreen_name_att_trait_general_status_all_unpopular_1	У немилості	true
character_trait_levels_onscreen_name_att_trait_general_personality_all_feck_1	Богохульник	true
character_trait_levels_onscreen_name_att_trait_general_military_all_fighter_3	Майстер бою	true
character_trait_levels_onscreen_name_att_trait_general_military_all_fighter_2	Відмінний боєць	true
character_trait_levels_onscreen_name_att_trait_general_military_all_fighter_1	Добрий боєць	true
character_trait_levels_colour_text_att_trait_all_personality_all_sanguine_1	За безтурботним виразом обличчя ховається великий розум.	true
character_trait_levels_colour_text_att_trait_all_personality_all_choleric_1	Цю людину легко розлютити. І вона не забуває своїх ворогів. О так...	true
character_trait_levels_colour_text_att_trait_all_personality_all_easily_deceived_1	Ця людина за своєю натурою довірлива. Багато хто цим зловживає.	true
character_trait_levels_colour_text_bel_character_trait_last_roman_1	У словах і вчинках цього чоловіка втілений справжній римський дух.	true
character_trait_levels_onscreen_name_att_trait_general_government_all_miner_3	Геній гірничої справи	true
character_trait_levels_onscreen_name_att_trait_general_government_all_miner_2	Гірничий інженер	true
character_trait_levels_onscreen_name_att_trait_general_government_all_miner_1	Землекоп	true
character_trait_levels_onscreen_name_att_trait_agent_personality_all_innate_stupid_1	Дурень	true
character_trait_levels_colour_text_att_trait_spy_actions_all_contaminator_1	Не їжте коржі. Здається, вони зіпсувалися.	true
character_trait_levels_colour_text_att_trait_spy_actions_all_contaminator_2	Є ймовірність наступу. У напрямку вбиралень...	true
character_trait_levels_colour_text_att_trait_spy_actions_all_contaminator_3	У найгіршому випадку? Їх пронесе. У кращому випадку? Вони помруть!	true
character_trait_levels_colour_text_att_trait_priest_rank_orthodox_bishop_1	Благочестива відданість справі Церкви, виявлена цією людиною, була гідно оцінена.	true
character_trait_levels_onscreen_name_att_trait_general_ability_all_recon_1	Розвідка I	true
character_trait_levels_onscreen_name_att_trait_general_ability_all_recon_3	Розвідка III	true
character_trait_levels_onscreen_name_att_trait_general_ability_all_recon_2	Розвідка II	true
character_trait_levels_onscreen_name_att_trait_general_ability_all_recon_5	Розвідка V	true
character_trait_levels_onscreen_name_att_trait_general_ability_all_recon_4	Розвідка IV	true
character_trait_levels_onscreen_name_att_trait_priest_actions_all_devout_1	Благочестивий	true
character_trait_levels_onscreen_name_att_trait_priest_actions_all_devout_2	Праведний	true
character_trait_levels_onscreen_name_att_trait_priest_actions_all_devout_3	Фанатичний	true
character_trait_levels_colour_text_att_trait_not_priest_personality_monotheist_religious_2	Бог допомагає тим, хто просить найменьше.	true
character_trait_levels_colour_text_att_trait_not_priest_personality_monotheist_religious_3	Ви знаєте, що таке справжня любов? Це жертва.	true
character_trait_levels_colour_text_att_trait_not_priest_personality_monotheist_religious_1	Можливо, Бога немає, але якщо Він є, мені потрібна Його допомога.	true
character_trait_levels_onscreen_name_att_trait_general_ability_all_presence_4	Натхнення IV	true
character_trait_levels_onscreen_name_att_trait_general_ability_all_presence_5	Натхнення V	true
character_trait_levels_onscreen_name_att_trait_general_ability_all_presence_2	Натхнення II	true
character_trait_levels_onscreen_name_att_trait_general_ability_all_presence_3	Натхнення III	true
character_trait_levels_onscreen_name_att_trait_general_ability_all_presence_1	Натхнення I	true
character_trait_levels_onscreen_name_att_trait_priest_actions_all_betray_1	Продажний	true
character_trait_levels_onscreen_name_att_trait_priest_actions_all_betray_3	Зрадницький	true
character_trait_levels_onscreen_name_att_trait_priest_actions_all_betray_2	Підступний	true
character_trait_levels_colour_text_att_trait_general_military_all_looter_1	Поле битви після бою належить мародерам.	true
character_trait_levels_colour_text_att_trait_general_military_all_looter_2	Ця людина не обмежується грабунком підкорених.	true
character_trait_levels_colour_text_att_trait_general_military_all_looter_3	Як щодо невеликого дружнього геноциду?	true
character_trait_levels_colour_text_att_trait_all_personality_all_innate_charismatic_1	Деякі люди від природи мають владний вигляд.	true
character_trait_levels_onscreen_name_att_trait_agent_status_not_roman_poor_1	Другий син	true
character_trait_levels_colour_text_att_trait_general_physical_all_innate_deformed_1	Я - не тварина!	true
character_trait_levels_onscreen_name_att_trait_general_ability_all_raise_3	Вище стяг III	true
character_trait_levels_onscreen_name_att_trait_general_ability_all_raise_2	Вище стяг II	true
character_trait_levels_onscreen_name_att_trait_general_ability_all_raise_1	Вище стяг I	true
character_trait_levels_onscreen_name_att_trait_general_ability_all_rally_4	Згуртувати ряди IV	true
character_trait_levels_onscreen_name_att_trait_general_ability_all_rally_5	Згуртувати ряди V	true
character_trait_levels_onscreen_name_att_trait_general_ability_all_rally_2	Згуртувати ряди II	true
character_trait_levels_onscreen_name_att_trait_general_ability_all_rally_3	Згуртувати ряди III	true
character_trait_levels_onscreen_name_att_trait_general_ability_all_raise_5	Вище стяг V	true
character_trait_levels_onscreen_name_att_trait_general_ability_all_raise_4	Вище стяг IV	true
character_trait_levels_onscreen_name_att_trait_general_ability_all_rally_1	Згуртувати ряди I	true
character_trait_levels_colour_text_bel_trait_mission_payload_supreme_commander_belisarius_1	Принцип єдиноначальності понад усе. Велісарій не має собі рівних.	true
character_trait_levels_onscreen_name_att_trait_agent_status_roman_wealthy_1	Зі старої знаті	true
character_trait_levels_colour_text_att_trait_general_military_navy_all_escort_bad_1	Так вже вийшло. Спочатку весла зламалися об скелі, а потім впала щогла.	true
character_trait_levels_colour_text_att_trait_general_military_navy_all_escort_bad_2	Цей чоловік не здатний захистити навіть власний корабель, не кажучи вже про флот.	true
character_trait_levels_colour_text_att_trait_general_military_navy_all_escort_bad_3	Це був конвой? Ми охороняли судна? Та невже?	true
character_trait_levels_onscreen_name_cha_trail_wife_influence	Впливова	true
character_trait_levels_colour_text_att_trait_priest_actions_all_firebrand_1	Коли я говорю, люди слухають. Ось.	true
character_trait_levels_colour_text_att_trait_priest_actions_all_firebrand_3	Повстаньте, брати! Разом ми побудуємо нове майбутнє!	true
character_trait_levels_colour_text_att_trait_priest_actions_all_firebrand_2	Так не повинно бути, брати мої!	true
character_trait_levels_onscreen_name_att_trait_priest_actions_all_doomsayer_3	Викривач	true
character_trait_levels_onscreen_name_att_trait_priest_actions_all_doomsayer_2	Провокатор	true
character_trait_levels_onscreen_name_att_trait_priest_actions_all_doomsayer_1	Настирливий	true
character_trait_levels_onscreen_name_att_trait_ruler_personality_all_unjust_1	Несправедливий	true
character_trait_levels_onscreen_name_att_trait_ruler_personality_all_unjust_2	Деспот	true
character_trait_levels_onscreen_name_att_trait_ruler_personality_all_unjust_3	Тиран	true
character_trait_levels_colour_text_att_trait_general_physical_all_fertile_2	Ця людина цілком може породити нове покоління. Самотужки.	true
character_trait_levels_colour_text_att_trait_general_physical_all_fertile_3	Цій людині достатньо лише поглянути на дівчину, щоб вона завагітніла.	true
character_trait_levels_colour_text_att_trait_general_physical_all_fertile_1	Ця людина вміє вибирати партнерів для ліжка. І знає, що з ними робити.	true
character_trait_levels_onscreen_name_att_trait_general_personality_all_cowardice_2	Малодушний	true
character_trait_levels_onscreen_name_att_trait_general_personality_all_cowardice_3	Відчайдушний боягуз	true
character_trait_levels_onscreen_name_att_trait_general_personality_all_cowardice_1	Боязкий	true
character_trait_levels_onscreen_name_att_trait_ruler_government_all_taxman_2	Оцінювач	true
character_trait_levels_onscreen_name_att_trait_ruler_government_all_taxman_3	Суворий інспектор	true
character_trait_levels_onscreen_name_att_trait_ruler_government_all_taxman_1	Збирач податків	true
character_trait_levels_colour_text_att_trait_spy_actions_all_investigator_1	Цього агента приваблюють змови і контрзмови.	true
character_trait_levels_colour_text_att_trait_spy_actions_all_investigator_2	У мене є листи. Ви навряд чи хочете, щоб їх хтось прочитав...	true
character_trait_levels_colour_text_att_trait_spy_actions_all_investigator_3	Люди дуже люб'язні, коли до їх горла приставлений ніж...	true
character_trait_levels_colour_text_att_trait_general_military_army_all_attacker_bad_2	У цієї людини проблеми з організацією нападів.	true
character_trait_levels_colour_text_att_trait_general_military_army_all_attacker_bad_3	Ця людина здатна перетворити навіть вірну перемогу в принизливу поразку!	true
character_trait_levels_colour_text_att_trait_general_military_army_all_attacker_bad_1	Ця людина в атаці втрачає будь-яку впевненість.	true
character_trait_levels_onscreen_name_att_trait_ollam_ri_obstinance_1	Стійкість короля-оллама	true
character_trait_levels_colour_text_cha_trait_pope_1	[UNSEEN]	true
character_trait_levels_onscreen_name_att_trait_all_personality_all_choleric_1	Холерик	true
character_trait_levels_onscreen_name_att_trait_all_personality_all_sanguine_1	Сангвінік	true
character_trait_levels_colour_text_att_trait_agent_status_not_roman_wealthy_1	Багатство - це влада, а цій людині влади не позичати.	true
character_trait_levels_onscreen_name_bel_character_trait_last_roman_1	Останні римляни	true
character_trait_levels_colour_text_att_trait_general_personality_all_feck_1	Ця людина відома тим, що лається як шевць.	true
character_trait_levels_colour_text_att_trait_general_status_all_unpopular_1	Деякі її дії залишають бажати кращого.	true
character_trait_levels_colour_text_att_trait_general_personality_all_feck_3	З язика цієї людини постійно зриваються жахливі речі.	true
character_trait_levels_colour_text_att_trait_general_status_all_unpopular_2	Цю людину намагаються уникати всі, хто зустрічався з нею хоча б один раз.	true
character_trait_levels_colour_text_att_trait_general_personality_all_feck_2	Вона не вміє розмовляти, не перемежовуючи мову найогиднішими лайками.	true
character_trait_levels_colour_text_att_trait_general_status_all_unpopular_3	Всі, хто знає цю людину, вважають, що вона нічим не краща за тхора.	true
character_trait_levels_colour_text_att_trait_general_military_all_fighter_1	Ця людина не губиться в бою.	true
character_trait_levels_colour_text_att_trait_general_military_all_fighter_2	Якщо почнеться війна, ви віддасте перевагу мати цю людину на своєму боці.	true
character_trait_levels_colour_text_att_trait_general_military_all_fighter_3	Про військову звитягу цього чоловіка складають легенди.	true
character_trait_levels_colour_text_att_trait_priest_rank_catholic_bishop_1	Благочестива відданість справі Церкви, виявлена цією людиною, була гідно оцінена.	true
character_trait_levels_removal_text_bel_character_trait_last_roman_1	 	true
character_trait_levels_onscreen_name_att_trait_general_government_all_authoritarian_1	Формаліст	true
character_trait_levels_onscreen_name_att_trait_general_government_all_authoritarian_3	Авторитарний	true
character_trait_levels_onscreen_name_att_trait_general_government_all_authoritarian_2	Суворий	true
character_trait_levels_colour_text_att_trait_general_military_army_all_besieger_bad_3	...Але ж вони 10 ліктів заввишки! І як ми через них поліземо?	true
character_trait_levels_colour_text_att_trait_general_military_army_all_besieger_bad_2	Ох, тут стіна! Яка висока... І що мені з нею робити?	true
character_trait_levels_colour_text_att_trait_general_military_army_all_besieger_bad_1	Може, треба було спробувати таран? Що скажете?	true
character_trait_levels_colour_text_att_trait_general_personality_all_arse_2	Це мені подобається.	true
character_trait_levels_colour_text_att_trait_general_personality_all_arse_3	Неважливо, хто або що. Важливо - як.	true
character_trait_levels_colour_text_att_trait_general_personality_all_arse_1	Є плотські задоволення, які подобаються не всім.	true
character_trait_levels_colour_text_att_trait_not_priest_personality_polytheist_religious_2	Боги тут, зараз, вони слухають нас. І нам не слід про це забувати.	true
character_trait_levels_onscreen_name_att_trait_ruler_personality_all_miser_1	Ощадливий	true
character_trait_levels_colour_text_att_trait_not_priest_personality_polytheist_religious_3	На коліна, і подякуйте богам!	true
character_trait_levels_onscreen_name_att_trait_ruler_personality_all_miser_3	Скнара	true
character_trait_levels_colour_text_att_trait_not_priest_personality_polytheist_religious_1	Дерево і камінь! Я шаную богів!	true
character_trait_levels_onscreen_name_att_trait_ruler_personality_all_miser_2	Скупий	true
character_trait_levels_colour_text_att_trait_general_military_all_high_casualties_1	Насолоджується видом крові, особливо - ворожої.	true
character_trait_levels_colour_text_att_trait_general_military_all_high_casualties_3	Полонені? Нахлібники! Зайві роти.	true
character_trait_levels_colour_text_att_trait_general_military_all_high_casualties_2	Цей чоловік насолоджується кровопролиттям.	true
character_trait_levels_onscreen_name_att_trait_general_military_army_all_siege_defender_bad_1	Не любить фортеці	true
character_trait_levels_onscreen_name_att_trait_general_military_army_all_siege_defender_bad_3	Боїться облог	true
character_trait_levels_onscreen_name_att_trait_general_military_army_all_siege_defender_bad_2	Тягар в обороні	true
character_trait_levels_onscreen_name_att_trait_general_physical_all_innate_handsome_1	Красень	true
character_trait_levels_onscreen_name_att_trait_theodosius_marker_1	Феодосій	true
character_trait_levels_onscreen_name_att_trait_all_personality_all_innate_boring_1	Нудний	true
character_trait_levels_colour_text_att_trait_general_physical_all_scar_disfiguring_1	Вигляд цього чоловіка лякає жінок і дітей.	true
character_trait_levels_colour_text_att_trait_general_status_not_roman_blood_feud_1	Не треба було тобі вбивати мого родича.	true
character_trait_levels_colour_text_att_trait_all_personality_all_unlucky_1	Не в тому місці, не в той час... І що тут зробиш?	true
character_trait_levels_colour_text_att_trait_all_personality_all_unlucky_2	Ох, добре. Ну, хоча б спробувати варто було...	true
character_trait_levels_colour_text_att_trait_all_personality_all_unlucky_3	Одним просто не щастить, а інших прокляли боги. Відчуйте різницю.	true
character_trait_levels_onscreen_name_att_trait_belisarius_marker_1	Велісарій	true
character_trait_levels_onscreen_name_att_trait_ybor_tongue_1	Язик Годана	true
character_trait_levels_onscreen_name_att_trait_general_physical_all_innate_deformed_1	Потворний	true
character_trait_levels_onscreen_name_bel_trait_mission_payload_supreme_commander_belisarius_1	Магістр армії	true
character_trait_levels_onscreen_name_att_trait_agent_personality_all_innate_sneaky_1	Пронира	true
character_trait_levels_colour_text_att_trait_general_military_navy_all_attacker_sea_good_1	Ця людина обіцяє стати чудовим флотоводцем.	true
character_trait_levels_colour_text_att_trait_general_military_navy_all_attacker_sea_good_3	Командування флотами зробило цю людину легендою.	true
character_trait_levels_colour_text_att_trait_general_military_navy_all_attacker_sea_good_2	Ця людина чудово володіє тактикою морського бою.	true
character_trait_levels_onscreen_name_att_trait_general_military_navy_all_escort_bad_3	Конвой? А що це?	true
character_trait_levels_onscreen_name_att_trait_general_military_navy_all_escort_bad_2	Не вміє супроводжувати судна	true
character_trait_levels_onscreen_name_att_trait_general_military_navy_all_escort_bad_1	Не любить супроводжувати судна	true
character_trait_levels_colour_text_bel_trait_mission_payload_battle_hardened_narses_1	Ця людина особисто обрана імператором, вона чудовий керівник.	true
character_trait_levels_colour_text_att_trait_general_military_army_all_defender_bad_1	В обороні цій людині бракує впевненості.	true
character_trait_levels_colour_text_att_trait_general_military_army_all_defender_bad_2	Ця людина не має особливих здібностей до оборони.	true
character_trait_levels_colour_text_att_trait_general_military_army_all_defender_bad_3	Ця людина не має жодних здібностей до оборони.	true
character_trait_levels_onscreen_name_att_trait_all_personality_all_lucky_1	Удачливий	true
character_trait_levels_onscreen_name_att_trait_all_personality_all_lucky_3	Благословенний	true
character_trait_levels_onscreen_name_att_trait_all_personality_all_lucky_2	Везучий	true
character_trait_levels_colour_text_att_trait_priest_rank_roman_high_priest_1	Завдяки віку і досвіду ця людина стала лідером своїх одновірців.	true
character_trait_levels_colour_text_att_trait_all_personality_all_innate_intelligent_1	Розум може завести людину далі, ніж сильні ноги.	true
character_trait_levels_colour_text_cha_trail_wife_influence	Вона настільки ж мудра, наскільки і прекрасна. Тільки дурень не прислухається до її думки.	true
character_trait_levels_onscreen_name_att_trait_priest_actions_all_firebrand_2	Явний лідер	true
character_trait_levels_onscreen_name_att_trait_priest_actions_all_firebrand_3	Вождь народу	true
character_trait_levels_onscreen_name_att_trait_priest_actions_all_firebrand_1	Центр уваги	true
character_trait_levels_onscreen_name_att_trait_priest_rank_mobedan_mobed_1	Мобедан мобед	true
character_trait_levels_onscreen_name_att_trait_general_physical_all_fertile_1	Фертильний	true
character_trait_levels_onscreen_name_att_trait_general_physical_all_fertile_3	Плодовитий	true
character_trait_levels_onscreen_name_att_trait_general_physical_all_fertile_2	Продуктивний	true
character_trait_levels_colour_text_att_trait_priest_actions_all_doomsayer_1	Ця людина відчуває нездоровий інтерес до справ, які її абсолютно не стосуються.	true
character_trait_levels_colour_text_att_trait_priest_actions_all_doomsayer_2	Слова дієвіші за каміння.	true
character_trait_levels_colour_text_att_trait_priest_actions_all_doomsayer_3	Все скінчено. Ми приречені!	true
character_trait_levels_colour_text_att_trait_ruler_personality_all_spender_1	Щедрість радує богів - і мене.	true
character_trait_levels_colour_text_att_trait_ruler_personality_all_spender_2	Гроші абсолютно марні, коли лежать у моєму гаманці.	true
character_trait_levels_colour_text_att_trait_ruler_personality_all_spender_3	Цей хлопець - душа-людина, коли у нього в кишені дзвенять гроші!	true
character_trait_levels_onscreen_name_att_trait_priest_actions_all_seeds_of_doubt_1	Сумніви і сварки	true
character_trait_levels_onscreen_name_att_trait_priest_actions_all_seeds_of_doubt_2	Шепіт у темряві	true
character_trait_levels_onscreen_name_att_trait_priest_actions_all_seeds_of_doubt_3	Провокатор	true
character_trait_levels_colour_text_att_trait_ruler_personality_all_unjust_3	Гей, ТИ! Швидше прикінчи їх! Досить ніжності!	true
character_trait_levels_colour_text_att_trait_ruler_personality_all_unjust_2	Я розглянув це прохання. Данину ще раз, і тобі знадобиться заповіт.	true
character_trait_levels_colour_text_att_trait_ruler_personality_all_unjust_1	Твій позов відхилено. А хабар залиш біля входу.	true
character_trait_levels_onscreen_name_att_trait_spy_actions_all_contaminator_3	Нібито інтендант	true
character_trait_levels_onscreen_name_att_trait_spy_actions_all_contaminator_2	Нібито забезпечувач	true
character_trait_levels_onscreen_name_att_trait_spy_actions_all_contaminator_1	Нібито постачальник	true
character_trait_levels_colour_text_att_trait_general_government_all_miner_1	Називайте мене, як хочете. Я ж радію багатствам своїх копалень.	true
character_trait_levels_colour_text_att_trait_general_government_all_miner_2	Під землею ще багато багатств.	true
character_trait_levels_colour_text_att_trait_general_government_all_miner_3	Мати-земля віддає свої багатства тим, хто вміє їх знаходити.	true
character_trait_levels_onscreen_name_att_trait_agent_physical_all_innate_very_very_inbred_1	Виродок 	true
character_trait_levels_onscreen_name_att_trait_ruler_personality_all_harsh_1	Суворий	true
character_trait_levels_onscreen_name_att_trait_ruler_personality_all_harsh_2	Жорстокий	true
character_trait_levels_onscreen_name_att_trait_ruler_personality_all_harsh_3	Безсердечний	true
character_trait_levels_onscreen_name_att_trait_anastasius_marker_1	Анастазій	true
character_trait_levels_onscreen_name_att_trait_all_personality_all_drink_3	Раб вина	true
character_trait_levels_onscreen_name_att_trait_all_personality_all_drink_2	П'яниця	true
character_trait_levels_onscreen_name_att_trait_all_personality_all_drink_1	Випивоха	true
character_trait_levels_colour_text_att_trait_general_ability_all_presence_5	Видатний військовий вождь, якого поважають навіть вороги.	true
character_trait_levels_colour_text_att_trait_general_ability_all_presence_4	Видатний військовий вождь, якого поважають навіть вороги.	true
character_trait_levels_colour_text_att_trait_general_ability_all_presence_1	Видатний військовий вождь, якого поважають навіть вороги.	true
character_trait_levels_colour_text_att_trait_general_ability_all_presence_3	Видатний військовий вождь, якого поважають навіть вороги.	true
character_trait_levels_colour_text_att_trait_general_ability_all_presence_2	Видатний військовий вождь, якого поважають навіть вороги.	true
character_trait_levels_onscreen_name_att_trait_general_personality_roman_patriotic_3	Зразок досконалості	true
character_trait_levels_onscreen_name_att_trait_general_personality_roman_patriotic_2	Патріот	true
character_trait_levels_onscreen_name_att_trait_general_personality_roman_patriotic_1	Лояльний	true
character_trait_levels_onscreen_name_att_trait_general_ability_all_brace_3	Готовність III	true
character_trait_levels_onscreen_name_att_trait_general_ability_all_brace_2	Готовність II	true
character_trait_levels_onscreen_name_att_trait_general_ability_all_brace_1	Готовність I	true
character_trait_levels_onscreen_name_att_trait_general_ability_all_brace_5	Готовність V	true
character_trait_levels_onscreen_name_att_trait_general_ability_all_brace_4	Готовність IV	true
character_trait_levels_colour_text_att_trait_agent_status_all_slave_1	Я розумію, як працює рабський розум...	true
character_trait_levels_onscreen_name_att_trait_priest_rank_orthodox_bishop_1	Єпископ	true
character_trait_levels_colour_text_att_trait_agent_personality_all_innate_stupid_1	Вибач, старий, але, боюся, у мене між вухами трохи порожньо!	true
character_trait_levels_colour_text_att_trait_narses_marker_1	Нарсес	true
character_trait_levels_colour_text_att_trait_agent_physical_all_innate_very_inbred_1	Коли діти народжуються від близьких родичів, результат може бути сумним.	true
character_trait_levels_onscreen_name_att_trait_not_priest_personality_monotheist_religious_2	Побожний	true
character_trait_levels_onscreen_name_att_trait_not_priest_personality_monotheist_religious_3	Благочестивий	true
character_trait_levels_onscreen_name_att_trait_not_priest_personality_monotheist_religious_1	Віруючий	true
character_trait_levels_onscreen_name_att_trait_general_status_all_spurned_1	Відкинутий	true
character_trait_levels_colour_text_att_trait_ruler_scourge_of_god_1	Я буду дивитися, як горить ваш світ.	true
character_trait_levels_onscreen_name_att_trait_general_military_all_looter_1	Грабіжник	true
character_trait_levels_onscreen_name_att_trait_general_military_all_looter_2	М'ясник	true
character_trait_levels_onscreen_name_att_trait_general_military_all_looter_3	Руйнівник	true
character_trait_levels_onscreen_name_bel_trait_mission_payload_influence_negative_1	Не при справах	true
character_trait_levels_onscreen_name_att_trait_ruler_personality_all_kind_3	Благодійник	true
character_trait_levels_onscreen_name_att_trait_ruler_personality_all_kind_2	Милосердний	true
character_trait_levels_onscreen_name_att_trait_ruler_personality_all_kind_1	Добрий	true
character_trait_levels_colour_text_att_trait_agent_status_not_roman_poor_1	Аристократ, всіма улюблений і шанований, але залишений без спадку.	true
character_trait_levels_colour_text_att_trait_all_personality_all_phlegmatic_1	Ця людина холодна й позбавлена чарівності. Її важко полюбити.	true
character_trait_levels_onscreen_name_att_trait_general_military_barbarian_berserker_1	Варязька кров	true
character_trait_levels_onscreen_name_att_trait_general_military_barbarian_berserker_2	Досвідчений дружинник	true
character_trait_levels_onscreen_name_att_trait_general_military_barbarian_berserker_3	Дружинний голова	true
character_trait_levels_colour_text_bel_trait_mission_payload_illegitimate_children_1	Навіть найспостережливіший воєначальник може не помітити ворога у своєму ліжку.	true
character_trait_levels_onscreen_name_att_trait_general_status_all_popular_3	Всеобожнюваний	true
character_trait_levels_onscreen_name_att_trait_general_status_all_popular_2	Популярний	true
character_trait_levels_onscreen_name_att_trait_general_status_all_popular_1	Фаворит	true
character_trait_levels_onscreen_name_att_trait_general_military_navy_all_defender_sea_bad_1	Поганий морський захисник	true
character_trait_levels_onscreen_name_att_trait_general_military_navy_all_defender_sea_bad_2	Слабкий морський захисник	true
character_trait_levels_onscreen_name_att_trait_general_military_navy_all_defender_sea_bad_3	Невмілий морський захисник	true
character_trait_levels_colour_text_att_trait_ruler_personality_all_paranoid_1	За мною стежать. Скрізь. І це не мої слуги.	true
character_trait_levels_colour_text_att_trait_ruler_personality_all_paranoid_2	Там! За гобеленом! І он там! Скрізь!	true
character_trait_levels_colour_text_att_trait_ruler_personality_all_paranoid_3	У мене є вороги. Їх не злічити. І це тільки в цих стінах!	true
character_trait_levels_onscreen_name_att_trait_ruler_personality_all_mad_2	Неспокійна натура	true
character_trait_levels_onscreen_name_att_trait_ruler_personality_all_mad_3	Князь лунатиків	true
character_trait_levels_onscreen_name_att_trait_ruler_personality_all_mad_1	Трохи дивний	true
character_trait_levels_colour_text_att_trait_general_military_all_military_heritage_1	Цей чоловік виріс у походах зі своїм батьком, серед солдатів, і добре розуміє їх.	true
character_trait_levels_colour_text_att_trait_general_government_all_military_admin_1	Мечі й взуття потрібні, але військами керують накази.	true
character_trait_levels_colour_text_att_trait_general_government_all_military_admin_2	Буде у вас зброя. Надайте це мені...	true
character_trait_levels_colour_text_att_trait_general_government_all_military_admin_3	Армія марширує на шлунках солдатів, але керують нею папери.	true
character_trait_levels_colour_text_att_trait_ruler_government_all_taxman_2	У хорошого правителя завжди є витрати. Тому й потрібні податки.	true
character_trait_levels_colour_text_att_trait_ruler_government_all_taxman_3	Я люблю податки. І людей, які платять податки - відразу і повністю.	true
character_trait_levels_colour_text_att_trait_ruler_government_all_taxman_1	Люди чомусь вважають гроші своєю власністю. Але на них моє обличчя!	true
character_trait_levels_colour_text_att_trait_general_personality_all_honest_1	Його вчинки так само чесні, як і його обличчя.	true
character_trait_levels_colour_text_att_trait_general_personality_all_honest_2	Чесність у відносинах принесла цій людині заздрісну репутацію	true
character_trait_levels_colour_text_att_trait_general_personality_all_honest_3	Ім'я цієї людини - символ чесності і прямоти.	true
character_trait_levels_onscreen_name_att_trait_all_physical_all_unhealthy_1	Слабкий	true
character_trait_levels_onscreen_name_att_trait_all_physical_all_unhealthy_2	Хворий	true
character_trait_levels_onscreen_name_att_trait_all_physical_all_unhealthy_3	Немічний	true
character_trait_levels_onscreen_name_att_trait_general_physical_all_blind_1	Сліпий	true
character_trait_levels_colour_text_att_trait_general_personality_all_innate_stupid_1	Ця людина тупіша за варварську палицю.	true
character_trait_levels_onscreen_name_att_trait_champion_actions_all_callous_2	Безсердечний	true
character_trait_levels_onscreen_name_att_trait_champion_actions_all_callous_3	Бездушний	true
character_trait_levels_onscreen_name_att_trait_champion_actions_all_callous_1	Безжалісний	true
character_trait_levels_onscreen_name_att_trait_champion_actions_all_violent_1	Брудний клинок	true
character_trait_levels_onscreen_name_att_trait_champion_actions_all_violent_3	По коліна в крові	true
character_trait_levels_onscreen_name_att_trait_champion_actions_all_violent_2	Залитий кров'ю	true
character_trait_levels_colour_text_att_trait_general_military_navy_all_escort_good_1	Цей моряк не раз супроводжував торгові та вантажні судна в безпечну гавань.	true
character_trait_levels_colour_text_att_trait_general_military_navy_all_escort_good_2	Якщо ви хочете, щоб ваш конвой прибув до порту, доручіть справу цій людині.	true
character_trait_levels_colour_text_att_trait_general_military_navy_all_escort_good_3	Я не втратив жодного вантажу! Жодного!	true
character_trait_levels_onscreen_name_bel_trait_mission_payload_attrition_immunity_1	Багатоводний	true
character_trait_levels_colour_text_att_trait_all_personality_all_innate_irresolute_1	Так. Ні. Можливо. Не знаю!	true
character_trait_levels_colour_text_att_trait_general_military_army_all_siege_defender_good_1	Ця людина може захистити поселення. Наодинці, якщо це необхідно.	true
character_trait_levels_colour_text_att_trait_general_military_army_all_siege_defender_good_3	Дайте цій людині стіну, і вона захистить її навіть від богів!	true
character_trait_levels_colour_text_att_trait_general_military_army_all_siege_defender_good_2	Цей чоловік досконало опанував майстерність оборони фортець.	true
character_trait_levels_onscreen_name_att_trait_general_physical_all_eunuch_1	Євнух	true
character_trait_levels_colour_text_att_trait_photius_marker_1	Фотій	true
character_trait_levels_colour_text_att_trait_eos_dam_repair_1	Спина, яка не хоче гнутися, просить батога.	true
character_trait_levels_onscreen_name_att_trait_general_military_navy_all_attacker_sea_bad_2	Поганий флотоводець	true
character_trait_levels_onscreen_name_att_trait_general_military_navy_all_attacker_sea_bad_3	Усі в море	true
character_trait_levels_onscreen_name_att_trait_general_military_navy_all_attacker_sea_bad_1	Гідрофоб	true
character_trait_levels_onscreen_name_bel_trait_mission_payload_missionary_1	Захисник віри	true
character_trait_levels_onscreen_name_att_trait_general_ability_all_inspire_1	Натхнення I	true
character_trait_levels_onscreen_name_att_trait_general_ability_all_inspire_2	Натхнення II	true
character_trait_levels_onscreen_name_att_trait_general_ability_all_inspire_3	Натхнення III	true
character_trait_levels_onscreen_name_att_trait_general_ability_all_inspire_4	Натхнення IV	true
character_trait_levels_onscreen_name_att_trait_general_ability_all_inspire_5	Натхнення V	true
character_trait_levels_colour_text_att_trait_priest_rank_tengri_high_priest_1	Нехай береже тебе Тенгрі.	true
character_trait_levels_onscreen_name_att_trait_general_ability_all_second_5	Друге дихання V	true
character_trait_levels_onscreen_name_att_trait_general_ability_all_second_4	Друге дихання IV	true
character_trait_levels_onscreen_name_att_trait_general_ability_all_second_1	Друге дихання I	true
character_trait_levels_onscreen_name_att_trait_general_ability_all_second_3	Друге дихання III	true
character_trait_levels_onscreen_name_att_trait_general_ability_all_second_2	Друге дихання II	true
character_trait_levels_onscreen_name_att_trait_general_military_navy_all_defender_sea_good_3	Чудовий морський захисник	true
character_trait_levels_onscreen_name_att_trait_general_military_navy_all_defender_sea_good_2	Відмінний морський захисник	true
character_trait_levels_onscreen_name_att_trait_general_military_navy_all_defender_sea_good_1	Добрий морський захисник	true
character_trait_levels_colour_text_att_trait_priest_rank_manichaean_leader_1	Обраний наступник самого Мані.	true
character_trait_levels_onscreen_name_att_trait_champion_actions_all_cruel_1	Лякаючий	true
character_trait_levels_onscreen_name_att_trait_champion_actions_all_cruel_3	Жахаючий	true
character_trait_levels_onscreen_name_att_trait_champion_actions_all_cruel_2	Страхітливий	true
character_trait_levels_onscreen_name_att_trait_champion_actions_all_arson_3	Піроманьяк	true
character_trait_levels_onscreen_name_att_trait_champion_actions_all_arson_2	Підпалювач	true
character_trait_levels_onscreen_name_att_trait_champion_actions_all_arson_1	Розпалювач	true
character_trait_levels_onscreen_name_att_trait_all_personality_all_atheist_2	Невіруючий	true
character_trait_levels_onscreen_name_att_trait_all_personality_all_atheist_3	Відкритий атеїст	true
character_trait_levels_onscreen_name_att_trait_all_personality_all_atheist_1	Агностик	true
character_trait_levels_onscreen_name_att_trait_general_personality_all_mad_3	Божевільний	true
character_trait_levels_onscreen_name_att_trait_general_personality_all_mad_2	Навіжений	true
character_trait_levels_onscreen_name_att_trait_general_personality_all_mad_1	Трохи не в собі	true
character_trait_levels_colour_text_att_trait_general_physical_all_infertile_2	Схоже, ця людина не може залишити потомство.	true
character_trait_levels_colour_text_att_trait_general_physical_all_infertile_3	Чресла цього чоловіка ні на що не здатні.	true
character_trait_levels_colour_text_att_trait_general_physical_all_infertile_1	Ця людина не вміє вибирати партнерів для ліжка. У цьому вся справа.	true
character_trait_levels_colour_text_att_trait_general_government_all_farmer_1	Набитому череву не подобається пояс з мечем.	true
character_trait_levels_colour_text_att_trait_general_government_all_farmer_2	Невикористана земля так само марна, як морське дно.	true
character_trait_levels_colour_text_att_trait_general_government_all_farmer_3	Правильно оброблена земля - основа багатства.	true
character_trait_levels_colour_text_cha_trait_leader_influence	Ця людина - природжений полководець у всіх відношеннях. Якщо він говорить, люди слухають.	true
character_trait_levels_onscreen_name_att_trait_all_personality_all_easily_deceived_1	Легковірний	true
character_trait_levels_colour_text_att_trait_agent_personality_all_innate_sneaky_1	У цієї людини підступний розум, прихований під маскою ввічливості.	true
character_trait_levels_onscreen_name_att_trait_general_military_navy_all_attacker_sea_good_1	Морський вовк	true
character_trait_levels_onscreen_name_att_trait_general_military_navy_all_attacker_sea_good_3	Великий флотоводець	true
character_trait_levels_onscreen_name_att_trait_general_military_navy_all_attacker_sea_good_2	Добрий капітан	true
character_trait_levels_colour_text_att_trait_general_military_barbarian_berserker_3	Якщо побачиш його поблизу, біжи. Просто біжи. Швидко!	true
character_trait_levels_colour_text_att_trait_general_military_barbarian_berserker_2	Потрібно бачити, як ця людина махає сокирою в нападі шаленої люті.	true
character_trait_levels_colour_text_att_trait_general_military_barbarian_berserker_1	Р-р-р-р! Червоний туман! Я з'їм їх живцем!	true
character_trait_levels_onscreen_name_att_trait_general_personality_not_barbarian_likes_barbarians_1	Шанувальник східних слов'ян	true
character_trait_levels_onscreen_name_att_trait_general_personality_not_nomad_likes_nomads_1	Любить кочівників	true
character_trait_levels_onscreen_name_att_trait_general_personality_not_roman_likes_romans_1	Шанувальник західних європейців	true
character_trait_levels_onscreen_name_att_trait_ybor_blade_1	Клинок Годана	true
character_trait_levels_colour_text_att_trait_general_military_all_tactician_1	Ця людина має великі знання в справі управління військами.	true
character_trait_levels_colour_text_att_trait_general_military_all_tactician_2	Вивчаючи класичні битви, він досконало осягнув секрети тактики.	true
character_trait_levels_colour_text_att_trait_general_military_all_tactician_3	Він переважає інших завдяки знанням праць з тактики.	true
character_trait_levels_colour_text_att_trait_general_personality_all_innate_humble_1	Я всього лише гвинтик у величезній машині. Нічого більше.	true
character_trait_levels_colour_text_att_trait_spy_actions_all_scout_1	Багато людей. Пересуваються швидко. Троє кульгали...	true
character_trait_levels_colour_text_att_trait_spy_actions_all_scout_3	Ворог не може сховатися від пронизливого погляду.	true
character_trait_levels_colour_text_att_trait_spy_actions_all_scout_2	Кожна прим'ята травинка може щось розповісти.	true
character_trait_levels_onscreen_name_att_trait_ybor_touch_1	Дотик Годана	true
character_trait_levels_colour_text_att_trait_all_personality_all_energetic_3	Посплю в могилі!	true
character_trait_levels_colour_text_att_trait_all_personality_all_energetic_2	Сьогодні у мене повно справ! Чудово!	true
character_trait_levels_colour_text_att_trait_all_personality_all_energetic_1	Відпочинок? Навіщо? Я ж не слабак!	true
character_trait_levels_onscreen_name_att_trait_agent_personality_all_mad_3	Божевільний	true
character_trait_levels_onscreen_name_att_trait_agent_personality_all_mad_2	Навіжений	true
character_trait_levels_onscreen_name_att_trait_agent_personality_all_mad_1	Трохи не в собі	true
character_trait_levels_onscreen_name_att_trait_general_personality_not_barbarian_hates_barbarians_1	Ворог східних слов'ян	true
character_trait_levels_onscreen_name_att_trait_general_personality_not_nomad_hates_nomads_1	Ворог кочівників	true
character_trait_levels_onscreen_name_att_trait_general_personality_not_roman_hates_romans_1	Ворог західних європейців	true
character_trait_levels_colour_text_att_trait_ruler_personality_all_harsh_1	Доброта - це слабкість.	true
character_trait_levels_colour_text_att_trait_ruler_personality_all_harsh_2	Використовуй затискачі. Маленькі затискачі. З зубчиками.	true
character_trait_levels_colour_text_att_trait_ruler_personality_all_harsh_3	Твій біль, твій відчай... для мене вони як підсолоджене вино.	true
character_trait_levels_onscreen_name_att_trait_spy_actions_all_infiltrate_2	Непримітний	true
character_trait_levels_onscreen_name_att_trait_spy_actions_all_infiltrate_3	Безликий	true
character_trait_levels_onscreen_name_att_trait_spy_actions_all_infiltrate_1	Чесне обличчя	true
character_trait_levels_onscreen_name_att_trait_ollam_ri_judgement_1	Правосуддя короля-оллама	true
character_trait_levels_onscreen_name_att_trait_ruler_scourge_of_god_1	Цар-воїн	true
character_trait_levels_onscreen_name_att_trait_general_government_all_government_heritage_1	Син губернатора	true
character_trait_levels_colour_text_att_trait_general_personality_roman_patriotic_3	Він зразок християнської доброчесності та гордовитості. В першу чергу гордовитості.	true
character_trait_levels_colour_text_att_trait_general_personality_roman_patriotic_2	Його любов до Господа і батьківщини можна порівняти лише з його цілком зрозумілою недовірою до чужинців.	true
character_trait_levels_colour_text_att_trait_general_personality_roman_patriotic_1	Вірність цього чоловіка короні та державі не викликає сумнівів.	true
character_trait_levels_colour_text_att_trait_general_military_all_survivor_3	Камені і стріли жорстокої долі жодного разу не влучили в цю людину.	true
character_trait_levels_colour_text_att_trait_general_military_all_survivor_2	Ця людина відчуває небезпеку і відразу розуміє, коли щось не так.	true
character_trait_levels_colour_text_att_trait_general_military_all_survivor_1	Уміння уникати смерті - особливий дар.	true
character_trait_levels_colour_text_att_trait_all_personality_all_easily_distracted_1	Дивись, он та хмара схожа на Саладіна! Ні, правда!	true
character_trait_levels_colour_text_att_trait_spy_actions_all_poison_1	Мені здається, ця вода пахне трохи... ну, розумієте? Тухлячком.	true
character_trait_levels_colour_text_att_trait_spy_actions_all_poison_3	Позбавлені води люди стають дивно поступливими.	true
character_trait_levels_colour_text_att_trait_spy_actions_all_poison_2	Можна кинути дохлу коняку у воду, але інших звідти пити не змусиш.	true
character_trait_levels_onscreen_name_att_trait_general_personality_not_roman_unpatriotic_1	Любить чужеземне	true
character_trait_levels_onscreen_name_att_trait_general_personality_not_roman_unpatriotic_2	Цінує чужеземне	true
character_trait_levels_onscreen_name_att_trait_general_personality_not_roman_unpatriotic_3	Обожнює чужеземне	true
character_trait_levels_colour_text_att_trait_ollam_ri_obstinance_1	Його хребет подібний до дуба, здатного витримати бурю.	true
character_trait_levels_onscreen_name_att_trait_general_personality_not_barbarian_fears_barbarians_1	Боїться східних слов'ян	true
character_trait_levels_onscreen_name_att_trait_general_personality_not_nomad_fears_nomads_1	Боїться кочівників	true
character_trait_levels_onscreen_name_att_trait_general_personality_not_roman_fears_romans_1	Боїться західних європейців	true
character_trait_levels_colour_text_att_trait_ruler_government_all_spymaster_1	Ніщо не приносить йому стільки задоволення, як чужі таємниці.	true
character_trait_levels_colour_text_att_trait_ruler_government_all_spymaster_3	Всевидюче око завжди стане в нагоді мудрому правителю.	true
character_trait_levels_colour_text_att_trait_ruler_government_all_spymaster_2	У цієї людини очі і вуха всюди.	true
character_trait_levels_colour_text_att_trait_priest_rank_celtic_high_druid_1	Дуби говорять моїми устами.	true
character_trait_levels_onscreen_name_att_trait_priest_rank_catholic_bishop_1	Єпископ	true
character_trait_levels_colour_text_att_trait_general_government_all_trader_1	Торгуйте, дурні, і зможете заплатити за все!	true
character_trait_levels_colour_text_att_trait_general_government_all_trader_3	Давай поторгуємося! Це не варте таких грошей!	true
character_trait_levels_colour_text_att_trait_general_government_all_trader_2	Ця людина знає всьому ціну, але не знає цінності.	true
character_trait_levels_colour_text_att_trait_ruler_personality_all_miser_1	Гроші не ростуть на деревах і не плавають в морях!	true
character_trait_levels_onscreen_name_att_trait_not_priest_personality_polytheist_religious_2	Побожний	true
character_trait_levels_onscreen_name_att_trait_not_priest_personality_polytheist_religious_3	Глибоко віруючий	true
character_trait_levels_colour_text_att_trait_ruler_personality_all_miser_3	Не люблю витрачати гроші. Це марнотратство!	true
character_trait_levels_colour_text_att_trait_ruler_personality_all_miser_2	З якого дива я повинен відкривати свій гаманець? Навіщо мені це?	true
character_trait_levels_onscreen_name_att_trait_not_priest_personality_polytheist_religious_1	Віруючий	true
character_trait_levels_onscreen_name_bel_trait_mission_payload_influence_positive_1	Впливовий	true
character_trait_levels_colour_text_att_trait_general_personality_all_girls_2	Давай, давай! Ти зможеш!	true
character_trait_levels_colour_text_att_trait_general_personality_all_girls_3	Ну, привіт. Дзень. Дон. Пощастило тобі, дівчисько, е?	true
character_trait_levels_colour_text_att_trait_general_personality_all_girls_1	Оволодів нею. Оволодів. Двічі. І її матір’ю...	true
character_trait_levels_colour_text_att_trait_champion_actions_all_violent_2	Деякі воїни просто не вміють зупинятися.	true
character_trait_levels_colour_text_att_trait_champion_actions_all_violent_3	Заради всього святого! Він уже зовсім мертвий!	true
character_trait_levels_colour_text_att_trait_champion_actions_all_violent_1	Навіщо його чистити?	true
character_trait_levels_onscreen_name_att_trait_general_status_not_roman_blood_feud_1	Кривава помста	true
character_trait_levels_colour_text_att_trait_champion_actions_all_callous_1	Чуже горе не торкає цю людину.	true
character_trait_levels_colour_text_att_trait_champion_actions_all_callous_3	Хто-небудь, заткніть це верескливе дитя...	true
character_trait_levels_colour_text_att_trait_champion_actions_all_callous_2	У деяких просто немає серця.	true
character_trait_levels_onscreen_name_att_trait_all_personality_all_unlucky_1	Невдаха	true
character_trait_levels_onscreen_name_att_trait_all_personality_all_unlucky_2	Нещасний	true
character_trait_levels_onscreen_name_att_trait_all_personality_all_unlucky_3	Проклятий	true
character_trait_levels_colour_text_att_trait_ybor_tongue_1	Язик має владу над життям і смертю; хто любить його, той пожне плоди цієї влади.	true
character_trait_levels_colour_text_bel_trait_mission_payload_harmony_1	Збереження миру - найкраще служіння Богу.	true
character_trait_levels_colour_text_att_trait_general_personality_not_barbarian_likes_barbarians_1	Їхні слова не розходяться з ділом. Я поважаю їх за це. Хоча миються вони рідко...	true
character_trait_levels_colour_text_att_trait_general_personality_not_nomad_likes_nomads_1	Вони не такі вже й погані. Ну, дикі і смердючі - зате які люди!	true
character_trait_levels_colour_text_att_trait_general_personality_not_roman_likes_romans_1	Прекрасні церкви, приголомшлива їжа... А яке вино!	true
character_trait_levels_colour_text_att_trait_ybor_blade_1	Сталь, загартована у полум'ї божественного гніву.	true
character_trait_levels_onscreen_name_att_trait_general_personality_not_roman_patriotic_1	Лояльний	true
character_trait_levels_onscreen_name_att_trait_general_personality_not_roman_patriotic_3	Шовініст	true
character_trait_levels_onscreen_name_att_trait_general_personality_not_roman_patriotic_2	Відданий справі	true
character_trait_levels_colour_text_att_trait_general_military_navy_all_blockader_bad_3	У послужному списку цієї людини немає жодної успішної блокади.	true
character_trait_levels_colour_text_att_trait_general_military_navy_all_blockader_bad_2	Треба було триматися міцніше! Ех, ну добре...	true
character_trait_levels_colour_text_att_trait_general_military_navy_all_blockader_bad_1	Ця людина вже кілька разів провалювала блокаду портів.	true
character_trait_levels_onscreen_name_att_trait_general_military_all_tactician_1	Тактик	true
character_trait_levels_onscreen_name_att_trait_general_military_all_tactician_2	Добрий тактик	true
character_trait_levels_onscreen_name_att_trait_general_military_all_tactician_3	Відмінний тактик	true
character_trait_levels_onscreen_name_att_trait_general_military_army_all_ambusher_good_2	Майстер маскування	true
character_trait_levels_onscreen_name_att_trait_general_military_army_all_ambusher_good_3	Геній маскування	true
character_trait_levels_onscreen_name_att_trait_general_military_army_all_ambusher_good_1	Маскувальник	true
character_trait_levels_colour_text_att_trait_ybor_touch_1	Плоть, створена богом, підвладна лише його руці.	true
character_trait_levels_colour_text_att_trait_general_personality_not_barbarian_hates_barbarians_1	Смердючі, зарослі бородами пародії на людей. Виродки!	true
character_trait_levels_colour_text_att_trait_general_personality_not_nomad_hates_nomads_1	Я чув, вони п'ють кров своїх коней. Яке варварство!	true
character_trait_levels_colour_text_att_trait_general_personality_not_roman_hates_romans_1	Західні європейці з їх «Господь те, Господь се» надто його дратують.	true
character_trait_levels_onscreen_name_att_trait_all_personality_all_melancholic_1	Меланхолік	true
character_trait_levels_colour_text_att_trait_belisarius_marker_1	Велісарій	true
character_trait_levels_onscreen_name_att_trait_general_military_army_all_besieger_good_3	Напролом!	true
character_trait_levels_onscreen_name_att_trait_general_military_army_all_besieger_good_2	На стіни!	true
character_trait_levels_onscreen_name_att_trait_general_military_army_all_besieger_good_1	Майстер облог	true
character_trait_levels_onscreen_name_att_trait_general_physical_all_scar_disfiguring_1	Потворний шрам	true
character_trait_levels_colour_text_att_trait_ollam_ri_judgement_1	Його клинок подібний до ночі, що наступає швидко і нещадно.	true
character_trait_levels_onscreen_name_att_trait_ybor_eye_1	Око Годана	true
character_trait_levels_colour_text_att_trait_spy_actions_all_infiltrate_2	Ця людина може загубитися на будь-якому тлі.	true
character_trait_levels_colour_text_att_trait_spy_actions_all_infiltrate_3	Я змінюю своє обличчя, як інші змінюють одяг.	true
character_trait_levels_colour_text_att_trait_spy_actions_all_infiltrate_1	Людина з чесним обличчям не викликає підозр.	true
character_trait_levels_colour_text_att_trait_all_personality_all_innate_boring_1	Краще відрізати собі ногу, ніж перебувати поруч з цією людиною.	true
character_trait_levels_colour_text_att_trait_ollam_ri_pillage_1	Його хватка подібна до терну, що рве плащ необережного мандрівника.	true
character_trait_levels_colour_text_att_trait_theodosius_marker_1	Феодосій	true
character_trait_levels_onscreen_name_att_trait_general_government_all_pacifist_2	Противник війни	true
character_trait_levels_onscreen_name_att_trait_general_government_all_pacifist_3	Пацифіст	true
character_trait_levels_onscreen_name_att_trait_general_government_all_pacifist_1	Засуджує війну	true
character_trait_levels_onscreen_name_att_trait_general_military_army_all_defender_good_2	Добрий захисник	true
character_trait_levels_onscreen_name_att_trait_general_military_army_all_defender_good_3	Великий захисник	true
character_trait_levels_onscreen_name_att_trait_general_military_army_all_defender_good_1	Надійний захисник	true
character_trait_levels_colour_text_att_trait_general_government_all_government_heritage_1	Ця людина з дитинства стежила за тим, як її батько керував провінціями.	true
character_trait_levels_colour_text_att_trait_priest_actions_all_seeds_of_doubt_1	Ви впевнені, що це розумно?	true
character_trait_levels_colour_text_att_trait_priest_actions_all_seeds_of_doubt_2	З надійних джерел я дізнався, що...	true
character_trait_levels_colour_text_att_trait_priest_actions_all_seeds_of_doubt_3	Хіба я став би тобі брехати, друже мій?	true
character_trait_levels_onscreen_name_att_trait_ruler_personality_all_spender_1	Щедрий	true
character_trait_levels_onscreen_name_att_trait_ruler_personality_all_spender_2	Занадто щедрий	true
character_trait_levels_onscreen_name_att_trait_ruler_personality_all_spender_3	Марнотратний	true
character_trait_levels_onscreen_name_att_trait_spy_actions_all_poison_1	Постачальник отрут	true
character_trait_levels_onscreen_name_att_trait_spy_actions_all_poison_3	Фахівець з отрут	true
character_trait_levels_onscreen_name_att_trait_spy_actions_all_poison_2	Отруйник	true
character_trait_levels_onscreen_name_att_trait_general_military_navy_all_blockade_defender_good_1	Проривач блокад	true
character_trait_levels_onscreen_name_att_trait_general_military_navy_all_blockade_defender_good_2	Захисник портів	true
character_trait_levels_onscreen_name_att_trait_general_military_navy_all_blockade_defender_good_3	Гроза блокад	true
character_trait_levels_colour_text_att_trait_priest_rank_mobedan_mobed_1	Жрець серед жерців і захисник священного полум'я.	true
character_trait_levels_onscreen_name_att_trait_general_personality_all_innate_arrogant_1	Зарозумілий	true
character_trait_levels_onscreen_name_att_trait_general_military_navy_all_blockader_good_3	Геній блокади	true
character_trait_levels_onscreen_name_att_trait_general_military_navy_all_blockader_good_2	Майстер блокади	true
character_trait_levels_onscreen_name_att_trait_general_military_navy_all_blockader_good_1	Експерт з блокади	true
character_trait_levels_onscreen_name_att_trait_priest_rank_roman_high_priest_1	Верховний жрець	true
character_trait_levels_colour_text_att_trait_all_personality_all_lucky_1	Деякі люди просто народжуються в сорочці.	true
character_trait_levels_colour_text_att_trait_all_personality_all_lucky_3	Духи стежать за мною.	true
character_trait_levels_colour_text_att_trait_all_personality_all_lucky_2	Хтось може назвати це везінням, а я називаю це майстерністю.	true
character_trait_levels_colour_text_att_trait_general_personality_not_barbarian_fears_barbarians_1	Уві сні ця людина часто бачить сокири і бороди.	true
character_trait_levels_colour_text_att_trait_general_personality_not_nomad_fears_nomads_1	Кажуть, вони вбивають всіх полонених. Як на мене, то краще смерть на полі бою.	true
character_trait_levels_colour_text_att_trait_general_personality_not_roman_fears_romans_1	Одне лише слово «Франк» викликає в цього чоловіка холодний піт.	true
character_trait_levels_onscreen_name_att_trait_ruler_government_all_spymaster_1	Потаємний	true
character_trait_levels_onscreen_name_att_trait_ruler_government_all_spymaster_3	Майстер таємниць	true
character_trait_levels_onscreen_name_att_trait_ruler_government_all_spymaster_2	Шпигун-майстер	true
character_trait_levels_colour_text_att_trait_general_military_navy_all_blockade_defender_bad_2	— Як це — ми не повинні дозволити їм висадитися, перж ніж атакувати?	true
character_trait_levels_colour_text_att_trait_general_military_navy_all_blockade_defender_bad_3	Я туди не піду, мене там вб'ють!	true
character_trait_levels_colour_text_att_trait_general_military_navy_all_blockade_defender_bad_1	Нумо, підпустимо їх ближче... Прокляття, їх занадто багато! Тримайтеся!	true
character_trait_levels_colour_text_att_trait_general_ability_all_brace_3	Тримайтеся, воїни, вони йдуть!	true
character_trait_levels_colour_text_att_trait_general_ability_all_brace_2	Тримайтеся, воїни, вони йдуть!	true
character_trait_levels_colour_text_att_trait_general_ability_all_brace_1	Тримайтеся, воїни, вони йдуть!	true
character_trait_levels_colour_text_att_trait_general_ability_all_brace_5	Тримайтеся, воїни, вони йдуть!	true
character_trait_levels_colour_text_att_trait_general_ability_all_brace_4	Тримайтеся, воїни, вони йдуть!	true
character_trait_levels_colour_text_bel_trait_mission_payload_influence_positive_1	Велісарій на голову вище за інших полководців.	true
character_trait_levels_colour_text_att_trait_priest_rank_germanic_high_priest_1	Завдяки віку і досвіду ця жінка стала лідером своїх одновірців.	true
character_trait_levels_colour_text_att_trait_all_personality_all_drink_3	Пийте! Пийте! Чому ви не п'єте, виродки?	true
character_trait_levels_colour_text_att_trait_all_personality_all_drink_2	Смійся, і світ засміється, коли ти проллєш своє вино.	true
character_trait_levels_colour_text_att_trait_all_personality_all_drink_1	Крапелька вина нікому не зашкодить.	true
character_trait_levels_colour_text_att_trait_anastasius_marker_1	Анастазій	true
character_trait_levels_colour_text_att_trait_general_government_all_admin_bad_1	Може, вип'ємо? Тут за тиждень не розберешся...	true
character_trait_levels_colour_text_att_trait_general_government_all_admin_bad_3	Ця людина занадто горда, щоб визнати свою некомпетентність.	true
character_trait_levels_colour_text_att_trait_general_government_all_admin_bad_2	Поняття не маю, куди поділася ця штука...	true
character_trait_levels_onscreen_name_att_trait_spy_actions_all_corrupt_2	Розкрадач	true
character_trait_levels_onscreen_name_att_trait_spy_actions_all_corrupt_3	Нахабний злодій	true
character_trait_levels_onscreen_name_att_trait_spy_actions_all_corrupt_1	Хабарник	true
character_trait_levels_onscreen_name_att_trait_agent_status_all_slave_1	Звільнений раб	true
character_trait_levels_onscreen_name_att_trait_eos_queen_mavia_1	Цариця танухідів	true
character_trait_levels_colour_text_att_trait_general_personality_all_dishonest_2	Речі такі, як вони є. Вода мокра. Ця людина ненадійна.	true
character_trait_levels_colour_text_att_trait_general_personality_all_dishonest_3	Ця людина брехлива до мозку кісток.	true
character_trait_levels_colour_text_att_trait_general_personality_all_dishonest_1	Цій людині не можна довіряти. Ні на копійку.	true
character_trait_levels_onscreen_name_att_trait_general_status_roman_blood_feud_1	Вендетта	true
character_trait_levels_colour_text_att_trait_all_personality_all_sober_1	Вино буває прекрасним, але він цього ніколи не дізнається.	true
character_trait_levels_colour_text_att_trait_all_personality_all_sober_2	Ця людина на все дивиться тверезим поглядом.	true
character_trait_levels_colour_text_att_trait_all_personality_all_sober_3	У моєму домі немає місця розпусним п'яницям, що плавають у власній блювотині.	true
character_trait_levels_colour_text_att_trait_ybor_eye_1	Одне око стежить за сьогоденням, друге дивиться в майбутнє.	true
character_trait_levels_colour_text_att_trait_general_ability_all_power_5	А ну, напружтеся як слід, якщо жити хочете!	true
character_trait_levels_colour_text_att_trait_general_ability_all_power_4	А ну, напружтеся як слід, якщо жити хочете!	true
character_trait_levels_colour_text_att_trait_general_ability_all_power_1	А ну, напружтеся як слід, якщо жити хочете!	true
character_trait_levels_colour_text_att_trait_general_ability_all_power_3	А ну, напружтеся як слід, якщо жити хочете!	true
character_trait_levels_colour_text_att_trait_general_ability_all_power_2	А ну, напружтеся як слід, якщо жити хочете!	true
character_trait_levels_onscreen_name_att_trait_ollam_ri_pillage_1	Жадібність короля-оллама	true
character_trait_levels_colour_text_bel_trait_mission_payload_influence_negative_1	Велісарій помічає ослаблення своєї влади.	true
character_trait_levels_colour_text_att_trait_general_status_all_spurned_1	Втративши становище, він став озлобленим, заздрісним і сердитим.	true
character_trait_levels_colour_text_att_trait_ruler_personality_all_kind_3	Я вирішив бути добрим до свого народу. Це зміцнює вірність.	true
character_trait_levels_colour_text_att_trait_ruler_personality_all_kind_2	Страждання може заподіяти будь-який дурень. Я вирішив не бути дурнем.	true
character_trait_levels_colour_text_att_trait_ruler_personality_all_kind_1	Доброта - це не слабкість. Доброта - це сила.	true
character_trait_levels_colour_text_att_trait_general_personality_civilised_adulterer_3	Його дружина, дружина командира, дружина правителя. Всі здалися легко...	true
character_trait_levels_colour_text_att_trait_general_personality_civilised_adulterer_2	Не варто ставитися до цих речей так провінційно.	true
character_trait_levels_colour_text_att_trait_general_personality_civilised_adulterer_1	Гарна сукня. Вона буде краще виглядати на підлозі моєї спальні.	true
character_trait_levels_onscreen_name_att_trait_all_personality_all_phlegmatic_1	Флегматик	true
character_trait_levels_onscreen_name_att_trait_general_government_civilised_politician_1	Політикан	true
character_trait_levels_onscreen_name_att_trait_general_government_civilised_politician_3	Геній політики	true
character_trait_levels_onscreen_name_att_trait_general_government_civilised_politician_2	Політик	true
character_trait_levels_colour_text_att_trait_champion_actions_all_guerrilla_activity_1	Я борюся там, де ворог не може відповісти.	true
character_trait_levels_colour_text_att_trait_champion_actions_all_guerrilla_activity_3	Темрява приховує безліч кинджалів.	true
character_trait_levels_colour_text_att_trait_champion_actions_all_guerrilla_activity_2	Я борюся не з силою ворога, а з його слабкістю.	true
character_trait_levels_colour_text_att_trait_general_status_all_popular_3	Його добрий характер і чарівність легко завойовують серця людей.	true
character_trait_levels_colour_text_att_trait_general_status_all_popular_2	Ця людина — справжня сіль землі. Народ має про нього дуже гарну думку.	true
character_trait_levels_colour_text_att_trait_general_status_all_popular_1	У цієї людини слово ніколи не розходиться з ділом.	true
character_trait_levels_colour_text_att_trait_general_military_navy_all_defender_sea_bad_1	Ця людина викинула книгу з тактики морського бою за борт. Дурень.	true
character_trait_levels_colour_text_att_trait_general_military_navy_all_defender_sea_bad_2	Ця людина не змогла б захистити честь своєї матері, не кажучи вже про флот.	true
character_trait_levels_colour_text_att_trait_general_military_navy_all_defender_sea_bad_3	Послід морської чайки захищає краще.	true
character_trait_levels_onscreen_name_att_trait_ruler_personality_all_paranoid_1	Нервовий	true
character_trait_levels_onscreen_name_att_trait_ruler_personality_all_paranoid_2	Тривожний	true
character_trait_levels_colour_text_att_trait_all_personality_all_innate_uncompromising_1	Я не приймаю відмов.	true
character_trait_levels_onscreen_name_att_trait_ruler_personality_all_paranoid_3	Заляканий	true
character_trait_levels_onscreen_name_att_trait_general_personality_roman_unpatriotic_1	Любитель чужого	true
character_trait_levels_onscreen_name_att_trait_general_personality_roman_unpatriotic_2	Шанувальник чужого	true
character_trait_levels_onscreen_name_att_trait_general_personality_roman_unpatriotic_3	Обожнювач чужого	true
character_trait_levels_colour_text_att_trait_general_military_all_disciplinarian_bad_1	Добрими словами битву не виграєш.	true
character_trait_levels_colour_text_att_trait_general_military_all_disciplinarian_bad_3	Солдатам потрібна сталь, а не ласкаві слова.	true
character_trait_levels_colour_text_att_trait_general_military_all_disciplinarian_bad_2	Спокійний характер хороший доти, доки вороги не оголили мечі.	true
character_trait_levels_onscreen_name_att_trait_general_military_all_military_heritage_1	Син командира	true
character_trait_levels_colour_text_att_trait_agent_status_roman_poor_1	Аристократ, всіма улюблений і шанований, але залишений без спадку.	true
character_trait_levels_colour_text_att_trait_general_government_all_admin_good_3	У нього всі справи вирішуються. Ось людина!	true
character_trait_levels_colour_text_att_trait_general_government_all_admin_good_2	Хороше управління - як повітря. Його відсутність відразу помічаєш.	true
character_trait_levels_colour_text_att_trait_general_government_all_admin_good_1	Ця людина об'єднує зусилля багатьох і здатна домогтися майже всього.	true
character_trait_levels_onscreen_name_att_trait_general_personality_all_bravery_1	Хоробрий	true
character_trait_levels_onscreen_name_att_trait_general_military_all_strategist_1	Стратег	true
character_trait_levels_onscreen_name_att_trait_general_military_all_strategist_2	Добрий стратег	true
character_trait_levels_onscreen_name_att_trait_general_personality_all_bravery_3	Безстрашний	true
character_trait_levels_onscreen_name_att_trait_general_military_all_strategist_3	Відмінний стратег	true
character_trait_levels_onscreen_name_att_trait_general_personality_all_bravery_2	Відважний	true
character_trait_levels_onscreen_name_att_trait_general_personality_all_fervour_3	Без тями від битви!	true
character_trait_levels_onscreen_name_att_trait_general_personality_all_fervour_2	Палкий воїн	true
character_trait_levels_onscreen_name_att_trait_general_personality_all_fervour_1	Войовничий	true
character_trait_levels_onscreen_name_att_trait_general_military_army_all_attacker_good_1	Надійний атакуючий	true
character_trait_levels_onscreen_name_att_trait_general_military_army_all_attacker_good_2	Добрий атакуючий	true
character_trait_levels_onscreen_name_att_trait_general_military_army_all_attacker_good_3	Чудовий атакуючий	true
character_trait_levels_colour_text_att_trait_ollam_ri_wisdom_1	Його розум подібний до океану, стародавнього і неприборканого.	true
character_trait_levels_colour_text_att_trait_ruler_government_all_negotiator_1	Йому завжди було притаманне почуття такту і розуміння дипломатичних тонкощів.	true
character_trait_levels_colour_text_att_trait_ruler_government_all_negotiator_2	Ця людина переконлива і здатна на розумні компроміси.	true
character_trait_levels_colour_text_att_trait_ruler_government_all_negotiator_3	Такт, підступність і володіння чужими мовами роблять його ідеальним дипломатом.	true
character_trait_levels_colour_text_att_trait_priest_actions_all_betray_1	Деякі готові продати рідну матір заради підвищення.	true
character_trait_levels_colour_text_att_trait_priest_actions_all_betray_3	Все хороше пішло, залишилася тільки зрада.	true
character_trait_levels_colour_text_att_trait_priest_actions_all_betray_2	Не можна вірити тим, чиє основне заняття - брехня.	true
character_trait_levels_onscreen_name_att_trait_general_personality_all_honest_1	Надійний	true
character_trait_levels_onscreen_name_att_trait_general_personality_all_honest_2	Чесний	true
character_trait_levels_onscreen_name_att_trait_general_personality_all_honest_3	Непідкупний	true
character_trait_levels_onscreen_name_att_trait_priest_rank_germanic_high_priest_1	Верховна жриця	true
character_trait_levels_colour_text_att_trait_all_physical_all_unhealthy_1	Дитяча хвороба залишила слід на цій людині.	true
character_trait_levels_colour_text_att_trait_all_physical_all_unhealthy_2	Як казала мама, за здоров'ям потрібно стежити...	true
character_trait_levels_colour_text_att_trait_all_physical_all_unhealthy_3	Цьому бідоласі не під силу навіть підняти меч.	true
character_trait_levels_colour_text_att_trait_general_physical_all_blind_1	Цей нещасний втратив зір і назавжди занурився в темряву.	true
character_trait_levels_colour_text_bel_trait_mission_payload_attrition_immunity_1	З добре налагодженим постачанням армія не загине навіть у найсуворішій пустелі.	true
character_trait_levels_onscreen_name_att_trait_general_government_all_admin_bad_2	Неумілий адміністратор	true
character_trait_levels_onscreen_name_att_trait_general_government_all_admin_bad_3	Поганий адміністратор	true
character_trait_levels_onscreen_name_att_trait_general_government_all_admin_bad_1	Слабкий адміністратор	true
character_trait_levels_colour_text_att_trait_priest_actions_all_devout_1	Бог, народ, предки, родичі. Саме в такому порядку.	true
character_trait_levels_colour_text_att_trait_priest_actions_all_devout_2	І слово Його принесе смерть всім, хто стане на шляху праведних.	true
character_trait_levels_colour_text_att_trait_priest_actions_all_devout_3	Бо в руці демона буде меч з дев'ятьма лезами! Дев'ятьма! Не двома, не п'ятьма, не сімома!	true
character_trait_levels_colour_text_att_trait_champion_actions_all_instructor_1	Важко в навчанні - легко в бою.	true
character_trait_levels_colour_text_att_trait_champion_actions_all_instructor_3	Люди ненавидять його, але роблять те, що їм сказано.	true
character_trait_levels_colour_text_att_trait_champion_actions_all_instructor_2	У мене тут немає ніякої дискримінації. Ви всі тут однаково нікчемні.	true
character_trait_levels_colour_text_att_trait_general_ability_all_recon_1	Я знаю, де ворог.	true
character_trait_levels_colour_text_att_trait_general_ability_all_recon_3	Я знаю, де ворог.	true
character_trait_levels_colour_text_att_trait_general_ability_all_recon_2	Я знаю, де ворог.	true
character_trait_levels_colour_text_att_trait_general_ability_all_recon_5	Я знаю, де ворог.	true
character_trait_levels_colour_text_att_trait_general_ability_all_recon_4	Я знаю, де ворог.	true
character_trait_levels_colour_text_att_trait_general_physical_all_maimed_arm_1	Тепер йому доводиться командувати боєм з боку.	true
character_trait_levels_colour_text_att_trait_general_physical_all_maimed_leg_1	Тепер йому доводиться командувати боєм з боку.	true
character_trait_levels_colour_text_att_trait_priest_actions_all_propagandist_2	Вся справа в тому, щоб змусити людей зрозуміти...	true
character_trait_levels_colour_text_att_trait_priest_actions_all_propagandist_3	Ви говорите «бійня». Я кажу - «звичайна сутичка».	true
character_trait_levels_colour_text_att_trait_priest_actions_all_propagandist_1	Уміння говорити - потужна зброя.	true
character_trait_levels_colour_text_att_trait_general_personality_all_cowardice_2	У битві цій людині заважає страх. Страх перед битвою.	true
character_trait_levels_colour_text_att_trait_general_personality_all_cowardice_3	Боягузтво цієї людини в бою добре відоме.	true
character_trait_levels_colour_text_att_trait_general_personality_all_cowardice_1	Він тікає з поля бою, навіть коли для цього немає жодного приводу.	true
character_trait_levels_colour_text_att_trait_general_military_navy_all_blockade_defender_good_3	Кожен, хто кине йому виклик на морі, піде на дно.	true
character_trait_levels_colour_text_att_trait_general_military_navy_all_blockade_defender_good_2	Вони не ступлять на цей берег, поки живий хоч один з нас!	true
character_trait_levels_colour_text_att_trait_general_military_navy_all_blockade_defender_good_1	Та тут всього пара жалюгідних посудин, яким нізащо нас не наздогнати!	true
character_trait_levels_onscreen_name_att_trait_general_ability_all_war_5	Бойовий клич V	true
character_trait_levels_onscreen_name_att_trait_general_ability_all_war_4	Бойовий клич IV	true
character_trait_levels_onscreen_name_att_trait_eos_dam_repair_1	Старший наглядач	true
character_trait_levels_onscreen_name_att_trait_general_ability_all_war_3	Бойовий клич III	true
character_trait_levels_onscreen_name_att_trait_general_ability_all_war_2	Бойовий клич II	true
character_trait_levels_onscreen_name_att_trait_general_ability_all_war_1	Бойовий клич I	true
character_trait_levels_colour_text_att_trait_general_military_navy_all_blockader_good_1	Якщо хтось спробує прорватися, зробіть з нього решето! Все ясно?	true
character_trait_levels_onscreen_name_att_trait_photius_marker_1	Фотій	true
character_trait_levels_colour_text_att_trait_general_military_navy_all_blockader_good_2	Досвідчений морський капітан і справжній майстер блокади.	true
character_trait_levels_colour_text_att_trait_general_military_navy_all_blockader_good_3	З цього порту вже ніхто не вирветься.	true
character_trait_levels_colour_text_bel_trait_mission_payload_missionary_1	Справжня віра буде жити, поки я дихаю.	true
character_trait_levels_colour_text_att_trait_general_military_navy_all_attacker_sea_bad_2	Мати цього чоловіка переважає його в мистецтві війни на морі.	true
character_trait_levels_colour_text_att_trait_general_military_navy_all_attacker_sea_bad_3	Командування на морі принесло цьому чоловікові блискучий шолом. І більше нічого.	true
character_trait_levels_colour_text_att_trait_general_military_navy_all_attacker_sea_bad_1	Цей чоловік нерішучий на воді. І в битві.	true
character_trait_levels_onscreen_name_att_trait_priest_rank_tengri_high_priest_1	Верховний жрець	true
character_trait_levels_colour_text_att_trait_ioannina_marker_1	Іоанніна	true
character_trait_levels_colour_text_att_trait_ollam_ri_bounty_1	Його дотик подібний до сонця, що пробуджує паростки життя.	true
character_trait_levels_colour_text_att_trait_champion_actions_all_cruel_1	Іноді достатньо мати славу жорстокої людини.	true
character_trait_levels_colour_text_att_trait_champion_actions_all_cruel_3	Йому достатньо підняти брову, щоб його співрозмовника прошибло наскрізь.	true
character_trait_levels_colour_text_att_trait_champion_actions_all_cruel_2	Не бійся, я не зроблю тобі боляче. Занадто боляче.	true
character_trait_levels_colour_text_att_trait_champion_actions_all_arson_3	Полум'я - це красиво.	true
character_trait_levels_colour_text_att_trait_champion_actions_all_arson_2	Пекучі питання потрібно вирішувати.	true
character_trait_levels_colour_text_att_trait_champion_actions_all_arson_1	Як ви змушуєте раба вимовляти «ух»?	true
character_trait_levels_colour_text_att_trait_general_ability_all_second_5	Дурниця! Кістка не зачеплена! Хто наступний?!	true
character_trait_levels_colour_text_att_trait_general_ability_all_second_4	Дурниця! Кістка не зачеплена! Хто наступний?!	true
character_trait_levels_colour_text_att_trait_general_ability_all_second_1	Дурниця! Кістка не зачеплена! Хто наступний?!	true
character_trait_levels_colour_text_att_trait_general_ability_all_second_3	Дурниця! Кістка не зачеплена! Хто наступний?!	true
character_trait_levels_colour_text_att_trait_general_ability_all_second_2	Дурниця! Кістка не зачеплена! Хто наступний?!	true
character_trait_levels_colour_text_att_trait_general_ability_all_raise_3	Справжній герой ніколи не ухиляється від битви.	true
character_trait_levels_colour_text_att_trait_general_ability_all_raise_2	Справжній герой ніколи не ухиляється від битви.	true
character_trait_levels_colour_text_att_trait_general_ability_all_raise_1	Справжній герой ніколи не ухиляється від битви.	true
character_trait_levels_colour_text_att_trait_general_ability_all_rally_4	Виняткова хоробрість цієї людини вселяє відвагу в його прихильників.	true
character_trait_levels_colour_text_att_trait_general_ability_all_rally_5	Виняткова хоробрість цієї людини вселяє відвагу в його прихильників.	true
character_trait_levels_colour_text_att_trait_general_ability_all_rally_2	Виняткова хоробрість цієї людини вселяє відвагу в її прихильників.	true
character_trait_levels_colour_text_att_trait_general_ability_all_rally_3	Виняткова хоробрість цієї людини вселяє відвагу в її прихильників.	true
character_trait_levels_colour_text_att_trait_general_ability_all_raise_5	Справжній герой ніколи не ухиляється від битви.	true
character_trait_levels_colour_text_att_trait_general_ability_all_raise_4	Справжній герой ніколи не ухиляється від битви.	true
character_trait_levels_colour_text_att_trait_general_ability_all_rally_1	Виняткова хоробрість цієї людини вселяє відвагу в її прихильників.	true
character_trait_levels_onscreen_name_att_trait_general_physical_all_infertile_2	Убогий 	true
character_trait_levels_onscreen_name_att_trait_general_physical_all_infertile_3	Безплідний	true
character_trait_levels_colour_text_att_trait_antonina_marker_1	Антоніна	true
character_trait_levels_onscreen_name_att_trait_general_physical_all_infertile_1	Слабкий	true
character_trait_levels_onscreen_name_cha_trait_leader_influence	Впливовий	true
character_trait_levels_colour_text_att_trait_general_military_all_noctophobia_1	У темряві лунали дивні звуки. Ця людина пам'ятає їх усі.	true
character_trait_levels_colour_text_att_trait_general_military_all_noctophobia_3	У цієї людини — страх перед довгими, довгими нічними годинами.	true
character_trait_levels_colour_text_att_trait_general_military_all_noctophobia_2	Темрява мені не друг. Навпаки.	true
character_trait_levels_colour_text_att_trait_general_personality_all_innate_arrogant_1	Я незрівнянний! Ні, серйозно, ти просто не розумієш...	true
character_trait_levels_onscreen_name_att_trait_general_military_army_all_attacker_bad_2	Не хоче нападати	true
character_trait_levels_onscreen_name_att_trait_general_military_army_all_attacker_bad_3	Не вміє нападати	true
character_trait_levels_onscreen_name_att_trait_general_military_army_all_attacker_bad_1	Не любить нападати	true
character_trait_levels_onscreen_name_att_trait_spy_actions_all_scout_1	Розвідник	true
character_trait_levels_onscreen_name_att_trait_spy_actions_all_scout_3	Соколине око	true
character_trait_levels_onscreen_name_att_trait_spy_actions_all_scout_2	Досвідчений розвідник	true
character_trait_levels_onscreen_name_att_trait_general_physical_all_scar_distinguishing_1	Незвичайний шрам	true
character_trait_levels_onscreen_name_att_trait_general_personality_all_innate_humble_1	Скромний	true
character_trait_levels_onscreen_name_att_trait_general_personality_all_bereaved_1	Розбите серце	true
character_trait_levels_onscreen_name_att_trait_general_personality_all_bereaved_2	Засмучений	true
character_trait_levels_onscreen_name_att_trait_general_personality_all_bereaved_3	Все втрачено	true
character_trait_levels_onscreen_name_att_trait_agent_status_not_roman_wealthy_1	Заможний	true
character_trait_levels_colour_text_att_trait_all_physical_all_healthy_1	Міцний хлопець, сильний як бик!	true
character_trait_levels_colour_text_att_trait_all_physical_all_healthy_3	Ця людина наділена божественною статурою!	true
character_trait_levels_colour_text_att_trait_all_physical_all_healthy_2	Хвороба - це те, що трапляється з іншими.	true
character_trait_levels_onscreen_name_att_trait_general_military_navy_all_blockade_defender_bad_2	Поганий в блокаді	true
character_trait_levels_onscreen_name_att_trait_general_military_navy_all_blockade_defender_bad_3	Боїться блокад	true
character_trait_levels_onscreen_name_att_trait_general_military_navy_all_blockade_defender_bad_1	Не любить блокад	true
character_trait_levels_onscreen_name_att_trait_all_personality_all_easily_distracted_1	Легко відволікається	true
character_trait_levels_onscreen_name_att_trait_general_military_all_survivor_3	Невразливий	true
character_trait_levels_onscreen_name_att_trait_general_military_army_all_besieger_bad_3	Боїться стін	true
character_trait_levels_onscreen_name_att_trait_general_military_all_survivor_2	Майже невразливий	true
character_trait_levels_onscreen_name_att_trait_general_military_army_all_besieger_bad_2	Не вміє вести облогу	true
character_trait_levels_onscreen_name_att_trait_general_military_all_survivor_1	Живучий	true
character_trait_levels_onscreen_name_att_trait_general_military_army_all_besieger_bad_1	Не любить облоги	true
character_trait_levels_colour_text_att_trait_general_military_all_noctophilia_3	Ця людина народилася опівночі, і її засмучує прихід зорі....	true
character_trait_levels_colour_text_att_trait_general_military_all_noctophilia_2	Спускається ніч і знаходить його в самоті, мріючим про світ, повний тіней.	true
character_trait_levels_colour_text_att_trait_general_military_all_noctophilia_1	Багато хто боїться темряви. Але тільки не він.	true
character_trait_levels_onscreen_name_att_trait_general_personality_not_eastern_fears_easterners_1	Боїться Сходу	true
character_trait_levels_colour_text_att_trait_spy_actions_all_corrupt_2	Це золото просто лежало в моєму гаманці.	true
character_trait_levels_colour_text_att_trait_spy_actions_all_corrupt_3	Добро і зло: дві сторони однієї - золотої - витратної монети.	true
character_trait_levels_colour_text_att_trait_spy_actions_all_corrupt_1	Я шукаю вигоди. Хто її не шукає?	true
character_trait_levels_colour_text_att_trait_agent_personality_all_mad_3	Я простий звичайний казанок...	true
character_trait_levels_colour_text_att_trait_agent_personality_all_mad_2	Мені подобаються твої очі. У тебе красиві очі. Дуже красиві очі. Так.	true
character_trait_levels_colour_text_att_trait_agent_personality_all_mad_1	Хіба це важливо? Дж-дж-дж! Дж-дж-дж! Сьогодні я зібрав занадто мало меду! Дж-дж-дж!	true
character_trait_levels_onscreen_name_att_trait_all_personality_all_energetic_3	Повний життя	true
character_trait_levels_onscreen_name_att_trait_all_personality_all_energetic_2	Енергійний	true
character_trait_levels_onscreen_name_att_trait_all_personality_all_energetic_1	Жвавий	true
character_trait_levels_onscreen_name_att_trait_general_government_all_architect_3	Архітектор	true
character_trait_levels_onscreen_name_att_trait_general_government_all_architect_2	Інженер	true
character_trait_levels_onscreen_name_att_trait_general_government_all_architect_1	Будівельник	true
character_trait_levels_onscreen_name_bel_trait_mission_payload_harmony_1	Захисник гармонії	true
character_trait_levels_colour_text_att_trait_agent_physical_all_innate_clumsy_1	З кривими руками краще, ніж взагалі без рук.	true
character_trait_levels_onscreen_name_att_trait_priest_rank_celtic_high_druid_1	Верховний друїд	true
character_trait_levels_onscreen_name_att_trait_general_personality_not_eastern_hates_easterners_1	Ненавидить Схід	true
character_trait_levels_colour_text_att_trait_general_personality_not_roman_patriotic_1	Через вроджене почуття справедливості ця людина залишатиметься вірною до кінця, яким би гірким він не був.	true
character_trait_levels_colour_text_att_trait_general_personality_not_roman_patriotic_3	Ось що я скажу: вони зовсім не такі, як ми. А ще мені не подобається, як вони фарбують очі.	true
character_trait_levels_colour_text_att_trait_general_personality_not_roman_patriotic_2	Кожну хвилину кожного дня ця людина присвячує справі. Вона ніколи не підведе.	true
character_trait_levels_colour_text_att_trait_priest_rank_arian_bishop_1	Благочестива відданість справі Церкви, виявлена цією людиною, була гідно оцінена.	true
character_trait_levels_onscreen_name_bel_trait_mission_payload_battle_hardened_narses_1	Відбірний	true
character_trait_levels_onscreen_name_att_trait_general_military_army_all_defender_bad_1	Неумілий захисник	true
character_trait_levels_onscreen_name_att_trait_general_military_army_all_defender_bad_2	Слабкий захисник	true
character_trait_levels_onscreen_name_att_trait_general_military_army_all_defender_bad_3	Поганий захисник	true
character_trait_levels_onscreen_name_att_trait_general_military_navy_all_blockader_bad_3	Жалюгідний при блокаді	true
character_trait_levels_onscreen_name_att_trait_general_military_navy_all_blockader_bad_2	Поганий при блокаді	true
character_trait_levels_onscreen_name_att_trait_general_military_navy_all_blockader_bad_1	Слабкий при блокаді	true
character_trait_levels_colour_text_att_trait_general_military_army_all_ambusher_good_2	Люди, що потрапили в засідку, навіть не встигають зрозуміти, що їх вбило!	true
character_trait_levels_colour_text_att_trait_general_military_army_all_ambusher_good_3	Ця людина - втілення благородного мистецтва раптового нападу.	true
character_trait_levels_colour_text_att_trait_general_military_army_all_ambusher_good_1	Нападаючи з засідки, він завдає страшних ударів. Мало хто врятувався від нього.	true
character_trait_levels_colour_text_att_trait_general_personality_not_roman_unpatriotic_1	Ця людина відчуває «здоровий інтерес» до чужих культур.	true
character_trait_levels_colour_text_att_trait_general_personality_not_roman_unpatriotic_2	Показний інтерес, за яким слідує смертельна нудьга.	true
character_trait_levels_colour_text_att_trait_general_personality_not_roman_unpatriotic_3	Те, що подобається цій людині, більшість вважає вершиною несмаку.	true
character_trait_levels_onscreen_name_att_trait_all_personality_all_innate_intelligent_1	Розумний	true
character_trait_levels_onscreen_name_att_trait_general_personality_all_gambling_3	Раб удачі	true
character_trait_levels_onscreen_name_att_trait_general_personality_all_gambling_2	Запеклий гравець	true
character_trait_levels_onscreen_name_att_trait_general_personality_all_gambling_1	Любитель гри	true
character_trait_levels_onscreen_name_att_trait_general_military_all_disciplinarian_good_1	Тверда рука	true
character_trait_levels_onscreen_name_att_trait_general_military_all_disciplinarian_good_2	Вольовий лідер	true
character_trait_levels_onscreen_name_att_trait_general_military_all_disciplinarian_good_3	Гнобитель	true
character_trait_levels_onscreen_name_att_trait_agent_physical_all_innate_inbred_1	Плід інцесту	true
character_trait_levels_onscreen_name_att_trait_general_personality_not_eastern_likes_easterners_1	Шанувальник Сходу	true
character_trait_levels_colour_text_att_trait_agent_physical_all_innate_very_very_inbred_1	Зберігати чистоту крові - не завжди хороша ідея.	true
character_trait_levels_colour_text_att_trait_all_personality_all_melancholic_1	Посмішка дається йому нелегко, навіть якщо він радіє чужому горю.	true
character_trait_levels_colour_text_att_trait_all_personality_all_lazy_1	Навіщо робити сьогодні те, що можна відкласти до наступного тижня?	true
character_trait_levels_colour_text_att_trait_general_ability_all_fear_4	Ні. Ти цього не переживеш.	true
character_trait_levels_colour_text_att_trait_general_ability_all_fast_1	Хто хоче жити вічно? В атаку!!!	true
character_trait_levels_colour_text_att_trait_general_ability_all_fear_5	Ні. Ти цього не переживеш.	true
character_trait_levels_colour_text_att_trait_all_personality_all_lazy_3	Знайшовши когось, хто ходив би за нього в туалет, він позбувся б і цієї роботи.	true
character_trait_levels_colour_text_att_trait_general_ability_all_fast_2	Хто хоче жити вічно? В атаку!!!	true
character_trait_levels_colour_text_att_trait_all_personality_all_lazy_2	Чому я? Он там раби байдикують.	true
character_trait_levels_colour_text_att_trait_general_ability_all_fast_3	Хто хоче жити вічно? В атаку!!!	true
character_trait_levels_colour_text_att_trait_all_personality_all_lewd_1	Нескінченні збочення, реальні та уявні, зрештою набридають.	true
character_trait_levels_colour_text_att_trait_general_ability_all_fast_4	Хто хоче жити вічно? В атаку!!!	true
character_trait_levels_colour_text_att_trait_general_ability_all_fast_5	Хто хоче жити вічно? В атаку!!!	true
character_trait_levels_colour_text_att_trait_general_ability_all_fear_1	Ні. Ти цього не переживеш.	true
character_trait_levels_colour_text_att_trait_all_personality_all_lewd_3	Навіть після короткої зустрічі з цим мерзенним розпусником більшість людей біжать до лазні, щоб швидше відмитися.	true
character_trait_levels_colour_text_att_trait_general_ability_all_fear_2	Ні. Ти цього не переживеш.	true
character_trait_levels_colour_text_att_trait_all_personality_all_lewd_2	Від цієї зіпсованої людини відвернулися навіть повії.	true
character_trait_levels_colour_text_att_trait_general_ability_all_fear_3	Ні. Ти цього не переживеш.	true
character_trait_levels_onscreen_name_att_trait_general_personality_all_girls_2	Ненаситний	true
character_trait_levels_onscreen_name_att_trait_general_personality_all_girls_3	Заклопотаний	true
character_trait_levels_onscreen_name_att_trait_general_personality_all_girls_1	Велелюбний	true
character_trait_levels_colour_text_att_trait_general_military_army_all_besieger_good_3	Про облогове мистецтво цієї людини ходять легенди.	true
character_trait_levels_colour_text_att_trait_general_military_army_all_besieger_good_2	Ця людина - видатний фахівець зі штурму стін.	true
character_trait_levels_colour_text_att_trait_general_military_army_all_besieger_good_1	Ця людина помічає слабкості і знає, як ними скористатися.	true
character_trait_levels_colour_text_att_trait_general_government_all_pacifist_2	Я не буду забирати чужі життя. Не можу - і все.	true
character_trait_levels_colour_text_att_trait_general_government_all_pacifist_3	Стільки смертей - і заради чого?	true
character_trait_levels_colour_text_att_trait_general_government_all_pacifist_1	Навіщо потрібна війна? У ній немає нічого хорошого!	true
character_trait_levels_colour_text_att_trait_general_military_army_all_defender_good_2	Досвід цієї людини в обороні додає її людям впевненості.	true
character_trait_levels_colour_text_att_trait_general_military_army_all_defender_good_3	Він майстерний в обороні і зазвичай бере верх над нападниками.	true
character_trait_levels_colour_text_att_trait_general_military_army_all_defender_good_1	В обороні у цієї людини ясний розум і тверда рука.	true
character_trait_levels_onscreen_name_att_trait_general_government_all_warmonger_1	Схвалює війну	true
character_trait_levels_onscreen_name_att_trait_general_government_all_warmonger_2	Прихильник війни	true
character_trait_levels_onscreen_name_att_trait_general_government_all_warmonger_3	Мріє про геноцид	true
character_trait_levels_colour_text_att_trait_general_physical_all_innate_ugly_1	Моя мати любила мене. Напевно...	true
character_trait_levels_onscreen_name_att_trait_general_government_all_trader_1	Торговець	true
character_trait_levels_onscreen_name_att_trait_general_government_all_trader_3	Експерт у торгівлі	true
character_trait_levels_onscreen_name_att_trait_general_government_all_trader_2	Ділова людина	true
character_trait_levels_colour_text_att_trait_general_personality_all_bravery_1	Битва - стара подруга, вона така ж бажана, як добре вино.	true
character_trait_levels_colour_text_att_trait_general_military_all_strategist_1	Він розбирається в основах стратегії і знає, що йому потрібно вчитися далі.	true
character_trait_levels_colour_text_att_trait_general_military_all_strategist_2	Ця людина - знавець стратегії та історії військової справи.	true
character_trait_levels_colour_text_att_trait_general_personality_all_bravery_3	Він безстрашний воїн, і його люди завжди йдуть за ним, незважаючи на небезпеку.	true
character_trait_levels_colour_text_att_trait_general_military_all_strategist_3	Знанням цієї людини у військовій справі заздрять усі.	true
character_trait_levels_colour_text_att_trait_general_personality_all_bravery_2	Відвага цієї людини спонукає багатьох на великі подвиги.	true
character_trait_levels_colour_text_att_trait_general_personality_all_fervour_3	Люблю запах мертвечини вранці. Пахне... перемогою!	true
character_trait_levels_colour_text_att_trait_general_personality_all_fervour_2	Вперед! Вперед! У задніх рядах не відсиджуйтеся!	true
character_trait_levels_colour_text_att_trait_general_personality_all_fervour_1	Відвага - це прекрасно, але...	true
character_trait_levels_onscreen_name_att_trait_ollam_ri_wisdom_1	Мудрість короля-оллама	true
character_trait_levels_colour_text_att_trait_general_military_army_all_attacker_good_1	В атаці ця людина показує ознаки величі.	true
character_trait_levels_colour_text_att_trait_general_military_army_all_attacker_good_2	Перевага в тактичних здібностях надихає людей.	true
character_trait_levels_colour_text_att_trait_general_military_army_all_attacker_good_3	Цю людину майже неможливо перевершити в мистецтві нападу.	true
character_trait_levels_onscreen_name_att_trait_ruler_government_all_negotiator_1	Переговорник	true
character_trait_levels_onscreen_name_att_trait_ruler_government_all_negotiator_2	Дипломат	true
character_trait_levels_onscreen_name_att_trait_ruler_government_all_negotiator_3	Геній дипломатії	true
character_trait_levels_onscreen_name_att_trait_general_military_army_all_ambusher_bad_1	Невезучий	true
character_trait_levels_onscreen_name_att_trait_general_military_army_all_ambusher_bad_2	Передбачуваний	true
character_trait_levels_onscreen_name_att_trait_general_military_army_all_ambusher_bad_3	Не годиться для засідок	true
character_trait_levels_onscreen_name_att_trait_agent_physical_all_innate_very_inbred_1	Погана кров	true
character_trait_levels_colour_text_att_trait_general_personality_not_eastern_fears_easterners_1	Вони влили йому в горло розплавлене золото. Я ледь не наклав у штани!	true
character_trait_levels_onscreen_name_att_trait_general_military_all_noctophilia_1	Любитель темряви	true
character_trait_levels_onscreen_name_att_trait_general_military_all_noctophilia_2	Нічна сова	true
character_trait_levels_onscreen_name_att_trait_general_military_all_noctophilia_3	Обожнювач темряви	true
character_trait_levels_onscreen_name_att_trait_narses_marker_1	Нарсес	true
character_trait_levels_colour_text_att_trait_general_government_all_architect_1	Величезні будівлі, що зникають у небі, дещо говорять про їхнього будівельника.	true
character_trait_levels_colour_text_att_trait_general_government_all_architect_2	Мене пам'ятатимуть як будівельника, а не як вбивцю!	true
character_trait_levels_colour_text_att_trait_general_government_all_architect_3	Мої ідеї переживуть тисячоліття!	true
character_trait_levels_onscreen_name_att_trait_champion_actions_all_instructor_1	Зануда	true
character_trait_levels_onscreen_name_att_trait_champion_actions_all_instructor_3	Прискіпливий начальник	true
character_trait_levels_onscreen_name_att_trait_champion_actions_all_instructor_2	Солдафон	true
character_trait_levels_onscreen_name_att_trait_priest_actions_all_propagandist_2	Оповідач	true
character_trait_levels_onscreen_name_att_trait_priest_actions_all_propagandist_3	Пропагандист	true
character_trait_levels_onscreen_name_att_trait_priest_actions_all_propagandist_1	Казкар	true
character_trait_levels_onscreen_name_att_trait_general_physical_all_maimed_arm_1	Покалічена рука	true
character_trait_levels_onscreen_name_att_trait_general_physical_all_maimed_leg_1	Покалічена нога	true
character_trait_levels_onscreen_name_att_trait_general_government_all_military_admin_1	Військовий писар	true
character_trait_levels_onscreen_name_att_trait_general_government_all_military_admin_2	Військовий чиновник	true
character_trait_levels_onscreen_name_att_trait_general_government_all_military_admin_3	Військовий секретар	true
character_trait_levels_onscreen_name_att_trait_general_military_all_noctophobia_2	Нічні жахи	true
character_trait_levels_onscreen_name_att_trait_general_military_all_noctophobia_3	Ніктофоб	true
character_trait_levels_onscreen_name_att_trait_general_military_all_noctophobia_1	Страх темряви	true
character_trait_levels_colour_text_att_trait_general_ability_all_war_3	Його жага до битви невгамовна, і неважливо, скільки життів це буде коштувати.	true
character_trait_levels_colour_text_att_trait_general_ability_all_war_2	Його жага до битви невгамовна, і неважливо, скільки життів це буде коштувати.	true
character_trait_levels_colour_text_att_trait_general_ability_all_war_1	Його жага до битви невгамовна, і неважливо, скільки життів це буде коштувати.	true
character_trait_levels_colour_text_att_trait_general_ability_all_war_5	Його жага до битви невгамовна, і неважливо, скільки життів це буде коштувати.	true
character_trait_levels_colour_text_att_trait_general_ability_all_war_4	Його жага до битви невгамовна, і неважливо, скільки життів це буде коштувати.	true
character_trait_levels_colour_text_att_trait_general_physical_all_scar_distinguishing_1	Ну, не знаю, дівчатам це подобається!	true
character_trait_levels_colour_text_att_trait_ruler_personality_all_mad_2	Гризти свої нігті погано, але гризти чужі нігті...	true
character_trait_levels_colour_text_att_trait_ruler_personality_all_mad_3	Схиліться переді мною, жалюгідні людиська, або я нацькую на вас свою міль!	true
character_trait_levels_colour_text_att_trait_ruler_personality_all_mad_1	Не брешіть мені. Мої очі ВИПАДУТЬ, якщо я перестану дивитися вгору.	true
character_trait_levels_colour_text_att_trait_all_personality_all_easily_trapped_1	Ця людина не помітить пастку, навіть якщо її штовхнути в неї носом.	true
character_trait_levels_onscreen_name_att_trait_ioannina_marker_1	Іоанніна	true
character_trait_levels_onscreen_name_att_trait_ollam_ri_bounty_1	Благословення короля-оллама	true
character_trait_levels_colour_text_att_trait_general_personality_all_bereaved_3	Ця людина втратила все, що було їй дороге.	true
character_trait_levels_onscreen_name_bel_trait_mission_payload_illegitimate_children_1	Рогоносець	true
character_trait_levels_colour_text_att_trait_general_personality_all_bereaved_2	Його серце розбите назавжди.	true
character_trait_levels_colour_text_att_trait_general_personality_all_bereaved_1	З тих пір, як ця людина втратила все, її серцем заволоділа печаль.	true
character_trait_levels_onscreen_name_att_trait_antonina_marker_1	Антоніна	true
character_trait_levels_onscreen_name_att_trait_all_physical_all_healthy_2	Сяє здоров’ям	true
character_trait_levels_onscreen_name_att_trait_all_physical_all_healthy_3	Здоровий як бик	true
character_trait_levels_onscreen_name_att_trait_all_physical_all_healthy_1	Здоровий	true
character_trait_levels_colour_text_att_trait_eos_queen_mavia_1	[Unseen]	true
character_trait_levels_colour_text_att_trait_general_personality_not_eastern_likes_easterners_1	Прямодушні мужи. Красиві жінки. А який у них шербет...	true
character_trait_levels_colour_text_att_trait_general_status_roman_blood_feud_1	Помста - звичне рішення нинішніх проблем.	true
character_trait_levels_onscreen_name_att_trait_all_personality_all_innate_irresolute_1	Нерішучий	true
character_trait_levels_onscreen_name_att_trait_general_military_navy_all_escort_good_1	Вміє супроводжувати судна	true
character_trait_levels_onscreen_name_att_trait_general_military_navy_all_escort_good_2	Спеціаліст з конвоїв	true
character_trait_levels_onscreen_name_att_trait_general_military_navy_all_escort_good_3	Експерт з конвоїв	true
character_trait_levels_onscreen_name_att_trait_all_personality_all_lazy_2	Лінивий	true
character_trait_levels_onscreen_name_att_trait_general_ability_all_fast_3	Швидкий натиск III	true
character_trait_levels_onscreen_name_att_trait_all_personality_all_lazy_3	Байдикуватий	true
character_trait_levels_onscreen_name_att_trait_general_ability_all_fast_2	Швидкий натиск II	true
character_trait_levels_onscreen_name_att_trait_general_ability_all_fast_1	Швидкий натиск I	true
character_trait_levels_onscreen_name_att_trait_general_ability_all_fear_5	Страх V	true
character_trait_levels_onscreen_name_att_trait_all_personality_all_lazy_1	Неспішний	true
character_trait_levels_onscreen_name_att_trait_general_ability_all_fear_4	Страх IV	true
character_trait_levels_onscreen_name_att_trait_all_personality_all_lewd_2	Розпусник	true
character_trait_levels_onscreen_name_att_trait_general_ability_all_fear_3	Страх III	true
character_trait_levels_onscreen_name_att_trait_all_personality_all_lewd_3	Вкрай хтивий	true
character_trait_levels_onscreen_name_att_trait_general_ability_all_fear_2	Страх II	true
character_trait_levels_onscreen_name_att_trait_general_ability_all_fast_5	Швидкий натиск V	true
character_trait_levels_onscreen_name_att_trait_general_ability_all_fear_1	Страх I	true
character_trait_levels_onscreen_name_att_trait_all_personality_all_lewd_1	Непристойник	true
character_trait_levels_onscreen_name_att_trait_general_ability_all_fast_4	Швидкий натиск IV	true
character_trait_levels_onscreen_name_att_trait_general_personality_all_innate_stupid_1	Дурень	true
character_trait_levels_colour_text_att_trait_general_government_all_warmonger_3	Саме їхнє існування - загроза для нас. Ми повинні стерти їх з лиця землі!	true
character_trait_levels_colour_text_att_trait_general_government_all_warmonger_2	Думаю, скоро ти переконаєшся, що війна хороша в усіх ставленнях!	true
character_trait_levels_colour_text_att_trait_general_government_all_warmonger_1	Ми будемо переслідувати їх до кінця!	true
character_trait_levels_onscreen_name_att_trait_all_personality_all_innate_charismatic_1	Чарівний	true
character_trait_levels_onscreen_name_att_trait_general_physical_all_innate_ugly_1	Непривабливий	true
character_trait_levels_onscreen_name_att_trait_general_personality_civilised_adulterer_3	Ховайте жінок!	true
character_trait_levels_onscreen_name_att_trait_general_personality_civilised_adulterer_2	Звабник	true
character_trait_levels_onscreen_name_att_trait_general_personality_civilised_adulterer_1	Спокусник	true
character_trait_levels_colour_text_att_trait_general_personality_not_eastern_hates_easterners_1	Хороший житель Сходу - мертвий житель Сходу.	true
character_trait_levels_onscreen_name_att_trait_general_government_all_farmer_1	Огородник	true
character_trait_levels_onscreen_name_att_trait_general_government_all_farmer_2	Власник маєтку	true
character_trait_levels_onscreen_name_att_trait_general_government_all_farmer_3	Латифундист	true
character_trait_levels_colour_text_att_trait_agent_status_roman_wealthy_1	А що, якщо у мене хороші зв'язки по крові і через шлюб?	true
character_trait_levels_onscreen_name_att_trait_agent_physical_all_innate_clumsy_1	Незграбний	true
character_trait_levels_onscreen_name_att_trait_champion_actions_all_guerrilla_activity_1	Повстанець	true
character_trait_levels_onscreen_name_att_trait_champion_actions_all_guerrilla_activity_3	Нічний жах	true
character_trait_levels_onscreen_name_att_trait_champion_actions_all_guerrilla_activity_2	Партизан	true
character_trait_levels_onscreen_name_att_trait_priest_rank_manichaean_leader_1	Вождь	true
character_trait_levels_colour_text_att_trait_general_government_civilised_politician_1	Любить політику і досягає в ній успіху.	true
character_trait_levels_colour_text_att_trait_general_government_civilised_politician_3	Переконання і щирість - потужна зброя.	true
character_trait_levels_colour_text_att_trait_general_government_civilised_politician_2	Ця людина народжена для влади і насолоджується нею.	true
character_trait_levels_onscreen_name_att_trait_priest_rank_arian_bishop_1	Єпископ	true
character_trait_levels_colour_text_att_trait_general_personality_all_gambling_1	Ну, потроху, чисто заради інтересу...	true
character_trait_levels_colour_text_att_trait_general_personality_all_gambling_2	Ця людина не бачить особливої різниці між перемогою і поразкою.	true
character_trait_levels_colour_text_att_trait_general_personality_all_gambling_3	Мені скоро пощастить. Повинно пощастити!	true
character_trait_levels_onscreen_name_att_trait_general_military_all_disciplinarian_bad_1	Розслаблений	true
character_trait_levels_onscreen_name_att_trait_general_military_all_disciplinarian_bad_3	Безхребетний	true
character_trait_levels_onscreen_name_att_trait_general_military_all_disciplinarian_bad_2	М'якотілий	true
character_trait_levels_onscreen_name_att_trait_agent_status_roman_poor_1	Другий син	true
character_trait_levels_onscreen_name_att_trait_general_military_army_all_siege_defender_good_1	Страж воріт	true
character_trait_levels_onscreen_name_att_trait_general_military_army_all_siege_defender_good_3	Ніхто не пройде!	true
character_trait_levels_onscreen_name_att_trait_general_military_army_all_siege_defender_good_2	Стовп оборони	true
character_trait_levels_colour_text_att_trait_general_military_all_disciplinarian_good_3	Я сказав стрибати, невдячні віслюки!	true
character_trait_levels_colour_text_att_trait_general_military_all_disciplinarian_good_2	Вирийте туалети до заходу сонця. Ви ж не хочете копати вночі?	true
character_trait_levels_colour_text_att_trait_general_military_all_disciplinarian_good_1	Кажуть, що єдине, чого варто боятися, це сам страх. Ти скоро переконаєшся, що це не так!	true
character_trait_levels_colour_text_att_trait_agent_physical_all_innate_inbred_1	В одних предків менше, ніж в інших.	true
