key	text	tooltip
#Loc;1;text/db/character_skills.loc		
character_skills_localised_name_att_skill_background_champion_elite_nomadic	Великий воїн	true
character_skills_localised_name_cha_skill_general_motivator	Натхненник	true
character_skills_localised_description_att_skill_background_general_merchant_roman	Його не хвилює батьківщина, дружба чи віра. Для нього важливі тільки гроші.	true
character_skills_localised_name_att_trad_army_roman_4_nomad_hunters	Кочові мисливці	true
character_skills_localised_description_att_skill_background_spy_agriculture_nomadic	Деякі тварини рівніші за інших.	true
character_skills_localised_name_mk_skill_priest_belief_islam	Віра	true
character_skills_localised_description_att_trad_navy_roman_1_coastal_patrol	У рідних водах ці мореплавці не мають рівних.	true
character_skills_localised_name_att_skill_background_champion_marine_eastern	Пірат	true
character_skills_localised_name_mk_skill_priest_belief_pagan	Віра	true
character_skills_localised_description_att_skill_background_priest_militarist_eastern	Ну, думаю, що мир можливий, але ж можлива і війна!	true
character_skills_localised_description_cha_trad_army_cavalry_training	Кращі полководці походять тільки з найзнатніших родин.	true
character_skills_localised_name_att_skill_background_champion_scout_nomadic	Слідопит	true
character_skills_localised_name_cha_skill_priest_back_elder	Старійшина	true
character_skills_localised_description_cha_trad_army_looters	Не залишати по собі нічого, окрім поживи для воронів.	true
character_skills_localised_name_cha_skill_spy_local_agents	Місцеві агенти	true
character_skills_localised_description_att_agent_skills_champion_skirmishing	Під безперервним градом стріл могутність ворогів швидко перетворюється на попіл.	true
character_skills_localised_description_att_skill_background_champion_standard_bearer_eastern	Він з гордістю несе прапор великої і переможної держави.	true
character_skills_localised_name_att_skill_background_wife_roman_noble	Знатна	true
character_skills_localised_description_bel_trad_army_roman_3_attacking_enemy	Наблизившись впритул до ворога, можна виграти битву ще до першого удару.	true
character_skills_localised_name_att_skill_background_champion_aide_camp_roman	Військовий трибун	true
character_skills_localised_description_att_skill_background_priest_benefactor_eastern	Ця людина простежить, щоб миші не бешкетували навіть за відсутності кішки.	true
character_skills_localised_description_att_trad_army_eastern_4_savaran_regime	Море вершників, очолюваних знаттю, затопить весь світ.	true
character_skills_localised_name_att_skill_background_general_handler_eastern	Приборкувач	true
character_skills_localised_name_att_trad_army_roman_4_heavy_training	Тренування важких військ	true
character_skills_localised_description_att_trad_army_barbarian_4_bane_east	Блискучі вежі впадуть перед мечем присягнутого.	true
character_skills_localised_description_cha_trad_navy_double_planking	Дві дошки міцніші за одну, чи не так?	true
character_skills_localised_description_att_skill_background_spy_agriculture_barbarian	Деякі тварини рівніші за інших.	true
character_skills_localised_name_att_trad_navy_barbarian_3_dauntless_navigators	Безстрашні мореплавці	true
character_skills_localised_description_att_trad_army_nomadic_5_scourge_world	Поглянь на них і побач свою долю.	true
character_skills_localised_name_att_agent_skills_champion_marauding	Наліт	true
character_skills_localised_description_att_skill_background_general_scholar_eastern	Книги - найвеличніша зброя у війні з невіглаством.	true
character_skills_localised_description_cha_skill_general_tactician	Хороший тактик завжди думає на багато ходів вперед.	true
character_skills_localised_description_cha_skill_priest_spiritual_leadership	Сліпий прозріє! Глухий почує!	true
character_skills_localised_name_att_skill_background_wife_civilised_educated	Освічена	true
character_skills_localised_description_att_skill_background_priest_spiritual_leader_nomadic	Зверни погляд на свої гріхи; ніч темна і сповнена кошмарів.	true
character_skills_localised_description_att_skill_background_general_merchant_eastern	Його не хвилює батьківщина, дружба чи віра. Для нього важливі тільки гроші.	true
character_skills_localised_description_att_skill_background_wife_roman_sharp_tongue	Чому всі так носяться з цим товстим боровим - Флатом Максимом? А-а, нехай слухає.	true
character_skills_localised_description_cha_skill_general_back_supply	Війни виграють не тільки солдати, але і зброя. І ще продовольство.	true
character_skills_localised_description_cha_skill_general_back_patron	Це прекрасна споруда. Так. Красива. Дайте десять.	true
character_skills_localised_name_att_trad_army_eastern_2_nomad_hunters	Кочові мисливці	true
character_skills_localised_description_att_trad_navy_roman_2_naval_logistics	Все повинно бути в порядку і готове до відплиття.	true
character_skills_localised_description_att_agent_skills_champion_ruse	Дивіться! Триголова мавпа!	true
character_skills_localised_name_mk_skill_general_back_scholar	Вчений	true
character_skills_localised_description_att_skill_background_champion_assassin_nomadic	Я стану твоїм захисником.	true
character_skills_localised_name_att_agent_skills_spy_military_infiltration	Проникнення у війська	true
character_skills_localised_name_att_skill_background_wife_roman_sharp_tongue	Гострий язик	true
character_skills_localised_description_att_skill_background_champion_scout_eastern	Дорога попереду ховається в темряві. Я освітлю її.	true
character_skills_localised_name_cha_skill_general_back_entrepeneur	Підприємець	true
character_skills_localised_name_mk_skill_general_tactician	Хороший тактик	true
character_skills_localised_name_att_skill_background_priest_spiritual_leader_nomadic	Духовний лідер	true
character_skills_localised_name_att_skill_background_general_administrator_eastern	Адміністратор	true
character_skills_localised_name_att_skill_background_general_scholar_eastern	Вчений	true
character_skills_localised_description_att_skill_background_wife_civilised_educated	Чоловіки, мій дорогий, не відразу звертають увагу на розум жінки. А я досить розумна...	true
character_skills_localised_name_att_trad_navy_barbarian_5_scourge_seas	Бич морів	true
character_skills_localised_name_cha_skill_assassin_back_scout	Розвідник	true
character_skills_localised_name_att_skill_background_general_leader_barbarian	Вождь	true
character_skills_localised_description_att_agent_skills_champion_provision	Армією рухає шлунок.	true
character_skills_localised_description_att_trad_army_roman_4_heavy_training	Правильно навчений і екіпірований солдат здатний впоратися з будь-яким ворогом.	true
character_skills_localised_description_att_skill_background_wife_barbarian_uncanny	Я йшла до тебе, мій коханий. Дерева шепотіли мені про тебе...	true
character_skills_localised_description_att_skill_background_champion_elite_eastern	Цей вірний слуга і безстрашний воїн заслуговує на найглибшу повагу.	true
character_skills_localised_description_att_skill_background_general_handler_eastern	Цей чесний і справедливий чоловік завжди готовий поділитися мудрою порадою.	true
character_skills_localised_name_att_trad_army_roman_2_barbarian_subjugators	Варвари-загарбники	true
character_skills_localised_description_att_skill_background_champion_officer_nomadic	Ватажки. Воїни. Покриті кров'ю, війною і славою.	true
character_skills_localised_description_mk_skill_general_bureaucrat	Так, війна - це чудово. Але потрібно оформити деякі папери...	true
character_skills_localised_name_att_skill_background_champion_elite_barbarian	Ополченець	true
character_skills_localised_description_att_skill_background_priest_accountant_nomadic	Людина, яка вміє рахувати, високо цінується в будь-якій армії.	true
character_skills_localised_name_att_skill_background_wife_civilised_efficient	Працьовита	true
character_skills_localised_name_att_trad_army_eastern_3_parthian_horsemanship	Парф'янська кіннота	true
character_skills_localised_description_att_general_skills_nomadic_1_lightning	Бо я побачив його, що впав з неба, ЯК БЛИСКАВКА!	true
character_skills_localised_name_cha_skill_spy_eyes_and_ears	Очі та вуха	true
character_skills_localised_name_att_skill_background_wife_civilised_goddess	Богиня домашнього вогнища	true
character_skills_localised_name_att_skill_background_general_melee_nomadic	Боєць	true
character_skills_localised_description_cha_skill_spy_sapping	Ця людина точно знає, що під будь-якою стіною можна вирити підкоп.	true
character_skills_localised_name_att_skill_background_general_rider_nomadic	Прославлений вершник	true
character_skills_localised_description_mk_skill_assassin_fear	Я не підкоряюся нікому!	true
character_skills_localised_name_att_trad_army_eastern_4_barbarian_subjugators	Варвари-загарбники	true
character_skills_localised_name_att_trad_navy_roman_3_military_escorts	Військовий ескорт	true
character_skills_localised_description_att_skill_background_champion_marine_eastern	Перемагати на суші, перемагати на морі. Перемога понад усе!	true
character_skills_localised_description_att_skill_background_general_attacker_roman	Цей войовничий догматик не зупиниться, поки не знищить усіх своїх ворогів.	true
character_skills_localised_description_mk_skill_priest_belief_pagan	Земля не належить нам. Ми належимо Землі.	true
character_skills_localised_description_att_skill_background_wife_civilised_wealthy	Одні одружуються заради золота, а інші заздрять їм.	true
character_skills_localised_description_mk_skill_priest_belief_islam	Віра передбачає обов'язки. Той, хто виконує їх, зміцнює віру.	true
character_skills_localised_name_att_trad_navy_roman_1_coastal_patrol	Доки	true
character_skills_localised_name_att_skill_background_spy_agriculture_nomadic	Пастух	true
character_skills_localised_name_att_skill_background_spy_informant_nomadic	Подвійний агент	true
character_skills_localised_name_att_trad_army_barbarian_2_ruin_rome	Руйнівники Риму	true
character_skills_localised_description_mk_trad_army_infantry_training	Навіть простий ремісник з належною підготовкою може захистити своє місто від ворожої армії.	true
character_skills_localised_name_att_skill_background_wife_barbarian_priestess	Жриця	true
character_skills_localised_name_att_skill_background_general_taskmaster_roman	Організатор	true
character_skills_localised_name_att_trad_army_barbarian_5_inexorable_warband	Неприборканий загін	true
character_skills_localised_name_att_skill_background_champion_medic_eastern	Лікар	true
character_skills_localised_description_att_skill_background_spy_mole_eastern	Людина, яка опинилася в потрібному місці і почула потрібні слова, цінніша за тисячі «Безсмертних».	true
character_skills_localised_name_att_trad_navy_barbarian_2_ruin_rome	Руйнівники Риму	true
character_skills_localised_name_att_skill_background_general_warrior_eastern	Безстрашний воїн	true
character_skills_localised_name_att_skill_background_spy_racketeer_nomadic	Злочинець	true
character_skills_localised_description_att_skill_background_general_warrior_barbarian	Я не підкоряюся нікому!	true
character_skills_localised_name_att_skill_background_general_politician_roman	Політикан	true
character_skills_localised_description_att_skill_background_spy_conspirator_nomadic	Підступність, хитрість і трохи обману.	true
character_skills_localised_name_att_trad_army_barbarian_1_guerrilla_warfare	Партизанська війна	true
character_skills_localised_description_att_skill_background_general_entrepreneur_barbarian	Якщо ця людина вважає щось важливим, з нею погоджується весь світ.	true
character_skills_localised_description_att_skill_background_general_defender_nomadic	Об цю неприступну стіну розбилося безліч ворогів.	true
character_skills_localised_name_cha_trad_navy_placed_shots	Точний приціл	true
character_skills_localised_name_cha_trad_army_placed_shots	Точний приціл	true
character_skills_localised_description_att_skill_background_wife_all_faithful	Мій пане, мій володар, моя любов. Назавжди.	true
character_skills_localised_description_att_skill_background_wife_all_arrogant	Ти хто такий, щоб говорити з МОЇМ чоловіком?	true
character_skills_localised_name_att_trad_army_eastern_3_border_defenders	Вартові кордонів	true
character_skills_localised_name_mk_skill_spy_smuggler	Контрабандист	true
character_skills_localised_name_att_skill_background_wife_roman_conservative	Консервативна	true
character_skills_localised_name_cha_skill_spy_surveillance	Стеження	true
character_skills_localised_name_att_trad_navy_roman_4_barbarian_subjugators	Варвари-загарбники	true
character_skills_localised_description_att_skill_background_wife_barbarian_midwife	Випий-но. А тепер затисни зубами цю штуку і тужся...	true
character_skills_localised_description_cha_skill_assassin_determined	Боротися і шукати, знайти і не здаватися!	true
character_skills_localised_description_mk_skill_priest_back_militant	Я готовий битися з усіма. З тобою. З твоєю собакою. З самим собою!	true
character_skills_localised_name_att_skill_background_champion_scout_barbarian	Першопроходець	true
character_skills_localised_name_att_skill_background_wife_barbarian_swordmaid	Мечниця	true
character_skills_localised_name_att_skill_background_champion_quartermaster_barbarian	Постачальник	true
character_skills_localised_name_att_skill_background_wife_civilised_political	Інтриганка	true
character_skills_localised_description_mk_trad_army_ferocious	Виття, скрегіт зубів, слина на губах... Всі ознаки люті.	true
character_skills_localised_description_mk_skill_priest_belief	Будьте насторожі. Будьте тверді у вірі. Будьте відважні. Будьте сильні.	true
character_skills_localised_description_att_skill_background_champion_quartermaster_eastern	Цей чоловік чудово розбирається у всьому, що стосується поставок і спорядження.	true
character_skills_localised_description_mk_trad_navy_boarders	Ці воїни кидаються на палуби ворожих суден, немов нестримна штормова хвиля.	true
character_skills_localised_name_att_general_skills_nomadic_2_hunter	Мисливець	true
character_skills_localised_description_att_skill_background_priest_scholar_barbarian	Стій і послухай.	true
character_skills_localised_name_att_skill_background_general_marksman_roman	Влучний стрілець	true
character_skills_localised_description_att_skill_background_wife_civilised_superior	Нам що, знову розважати цих нікчемних людей? Як я не хочу перераховувати після них серветки...	true
character_skills_localised_name_att_trad_army_roman_2_light_training	Тренування легких військ	true
character_skills_localised_description_att_trad_army_barbarian_2_domestic_devotion	Відданість роду і богам.	true
character_skills_localised_description_att_general_skills_nomadic_4_warmaster	Війна - його життя. Він любить битися і завжди шукає бою. У цьому його сила.	true
character_skills_localised_description_att_general_skills_eastern_3_marzban	Міські стіни не впадуть, якщо їх охороняє ця людина.	true
character_skills_localised_description_att_trad_army_nomadic_1_raider_band	Ми грабуємо заради виживання... і розваги!	true
character_skills_localised_description_att_trad_army_roman_2_light_training	Ви навчитеся воювати, бігати й ніколи не потрапляти до рук ворога.	true
character_skills_localised_name_att_skill_background_wife_civilised_superior	Зарозуміла	true
character_skills_localised_description_att_skill_background_general_marksman_eastern	Його постріли завжди досягають мети - всупереч вогню, вітру і навіть самій смерті.	true
character_skills_localised_description_mk_trad_navy_steady	Тримайтеся міцніше, і ми доживемо до кінця дня!	true
character_skills_localised_name_att_general_skills_eastern_3_marzban	Вартовий кордонів	true
character_skills_localised_name_att_skill_background_champion_medic_barbarian	Цілитель	true
character_skills_localised_description_att_skill_background_champion_war_hero_eastern	Цей чоловік живе війною. Його термін минув, його битви виграні, але він ще живий.	true
character_skills_localised_description_att_skill_background_wife_civilised_unsuitable	Деякі одружуються з кохання. Таких називають дурнями.	true
character_skills_localised_description_att_skill_background_champion_watchman_nomadic	Він чекає. Це його справа.	true
character_skills_localised_name_att_skill_background_priest_elder_barbarian	Старійшина	true
character_skills_localised_description_mk_trad_army_supplies	Без належних запасів не може бути війни.	true
character_skills_localised_description_att_skill_background_champion_medic_nomadic	Лікар, вилікуй себе сам!	true
character_skills_localised_description_att_skill_background_wife_all_fertile	Діти - благословення небес!	true
character_skills_localised_description_att_skill_background_priest_advisor_barbarian	Ця рука побудує все, що забажає цар.	true
character_skills_localised_description_att_trad_navy_barbarian_4_bane_east	У жителів Сходу занадто багато піску в голові, щоб битися з нами на морі.	true
character_skills_localised_description_mk_trad_navy_stores	Лук без стріл — усього лише дуже дорога дерев’яшка.	true
character_skills_localised_description_att_skill_background_wife_roman_conservative	Що може бути краще, ніж вірна берегиня вогнища при доблесному чоловікові?	true
character_skills_localised_name_att_agent_skills_priest_dogma	Догма	true
character_skills_localised_description_att_skill_background_spy_conspirator_barbarian	Підступність, хитрість і трохи обману.	true
character_skills_localised_name_mk_skill_assassin_opportunism	Опортунізм	true
character_skills_localised_description_att_skill_background_spy_mole_roman	Людина, яка опинилася в потрібному місці і почула потрібні слова, цінніша за тисячі армій.	true
character_skills_localised_description_mk_skill_priest_dogma	Я досягну успіху, тому що я вірю.	true
character_skills_localised_name_att_skill_background_champion_quartermaster_nomadic	Постачальник	true
character_skills_localised_name_cha_skill_general_commander	Командир	true
character_skills_localised_name_cha_skill_spy_misdirection	Введення в оману	true
character_skills_localised_description_att_skill_background_champion_horse_vet_roman	Відкрий рот і скажи: "Іго-го!"	true
character_skills_localised_description_att_skill_background_general_attacker_eastern	Цей войовничий догматик не зупиниться, поки не розтрощить усіх своїх ворогів.	true
character_skills_localised_name_att_skill_background_spy_conspirator_nomadic	Змовник	true
character_skills_localised_name_att_skill_background_spy_spymaster_nomadic	Досвідчений підглядник	true
character_skills_localised_description_att_trad_army_eastern_3_border_defenders	Хтось же повинен наглядати за кордонами, поки ви ходите в свої походи.	true
character_skills_localised_description_att_skill_background_champion_engineer_eastern	Полководець бачить в облогових машинах зброю, а ця людина - витвори мистецтва.	true
character_skills_localised_description_att_skill_background_general_warrior_eastern	Я не підкоряюся нікому!	true
character_skills_localised_description_cha_trad_navy_scourge_pirates	Ті, хто ходить під чорним вітрилом, розсудливо уникають зустрічі з цими моряками.	true
character_skills_localised_description_att_skill_background_general_defender_roman	Об цю неприступну стіну розбилося безліч ворогів.	true
character_skills_localised_description_att_general_skills_roman_2_infantry_commander	Під керівництвом цього командира бійці зможуть пройти довгий шлях і перемогти безліч ворогів.	true
character_skills_localised_description_att_trad_army_barbarian_5_inexorable_warband	Розбивайте ворогів і дивіться, як вони тікають!	true
character_skills_localised_description_mk_skill_priest_provocation	Мечі безсилі. Мене охороняє небесне військо!	true
character_skills_localised_description_att_skill_background_spy_courier_roman	Швидкі ноги і добре підвішений язик.	true
character_skills_localised_description_att_agent_skills_champion_intimidation	Вони вміють розв'язувати язики. О, так...	true
character_skills_localised_name_mk_skill_general_back_warrior	Воїн	true
character_skills_localised_description_att_skill_background_champion_elite_nomadic	Цей вірний слуга і безстрашний воїн заслуговує найглибшої поваги.	true
character_skills_localised_description_att_skill_background_general_handler_nomadic	Цей чесний і справедливий чоловік завжди готовий поділитися мудрою порадою.	true
character_skills_localised_description_cha_skill_general_motivator	Я вірю в вас. Не вірте в себе, вірте в МЕНЕ, який вірить у вас!	true
character_skills_localised_description_att_skill_background_champion_officer_eastern	Вожді. Воїни. Вкриті кров'ю, війною і славою.	true
character_skills_localised_description_att_trad_army_roman_4_nomad_hunters	Вбити орду вершників одним ударом - що може бути ефективніше?	true
character_skills_localised_name_att_skill_background_general_merchant_roman	Купець	true
character_skills_localised_name_att_skill_background_champion_marine_roman	Лібурнарій	true
character_skills_localised_description_att_agent_skills_spy_coercion	Який сенс у посланні, якщо ти не можеш говорити?	true
character_skills_localised_name_cha_trad_navy_stores	Сховища	true
character_skills_localised_description_att_skill_background_priest_public_speaker_barbarian	Друзі, брати, співвітчизники! Слухайте мене!	true
character_skills_localised_description_att_general_skills_roman_3_logistician	Він здатний розгадати найскладніший і хитрий план, склавши його, немов мозаїку.	true
character_skills_localised_description_att_skill_background_priest_accountant_eastern	Людина, яка вміє рахувати, високо цінується в будь-якій армії.	true
character_skills_localised_description_cha_skill_priest_back_elder	Солодкі слова і гострий розум дають ідеальний смак мудрості.	true
character_skills_localised_description_att_skill_background_champion_scout_nomadic	Дорога попереду ховається в темряві. Я освітлю її.	true
character_skills_localised_name_att_skill_background_priest_spiritual_leader_eastern	Даствар	true
character_skills_localised_name_att_general_skills_barbarian_celts_rigfennid	Рігфенід	true
character_skills_localised_name_mk_skill_spy_eyes_and_ears	Очі та вуха	true
character_skills_localised_name_cha_trad_navy_steady	Твердий	true
character_skills_localised_name_att_agent_skills_champion_subversion	Підривна діяльність	true
character_skills_localised_name_att_skill_background_general_administrator_nomadic	Сановник	true
character_skills_localised_name_att_skill_background_general_scholar_nomadic	Мудрець	true
character_skills_localised_description_att_skill_background_priest_strategy_gaming_barbarian	Хороший гравець не прораховує на п'ять ходів вперед. Він перемагає на першому ході.	true
character_skills_localised_description_att_trad_navy_eastern_1_persian_naval_heritage	Східні народи мають багаті традиції мореплавства.	true
character_skills_localised_description_att_skill_background_spy_builder_roman	Цеглинка, ще цеглинка... Найвеличніші будівлі починаються з малого.	true
character_skills_localised_name_att_skill_background_general_patron_barbarian	Патрон	true
character_skills_localised_description_att_trad_army_nomadic_3_unconventional_warfare	Воїни б'ються не заради краси, а заради перемоги.	true
character_skills_localised_description_att_skill_background_champion_marine_nomadic	Перемагати на суші, перемагати на морі. Перемога понад усе!	true
character_skills_localised_description_att_skill_background_priest_progressive_roman	Якщо стояти на скелі занадто довго, тебе змиє хвиля.	true
character_skills_localised_name_att_skill_background_spy_informant_eastern	Подвійний агент	true
character_skills_localised_name_cha_skill_priest_provocation	Провокація	true
character_skills_localised_description_att_general_skills_barbarian_celts_plunderer	Навіть якщо річ розбита, зламана або обгоріла, їй знайдеться застосування.	true
character_skills_localised_name_att_skill_background_spy_agriculture_eastern	Вастреш	true
character_skills_localised_name_att_trad_army_barbarian_4_bane_east	Гроза Сходу	true
character_skills_localised_description_att_skill_background_wife_all_drunkard	Вино приносить мені більше радості, ніж ти, виродку!	true
character_skills_localised_name_att_general_skills_roman_3_fleet_commander	Командир флоту	true
character_skills_localised_name_att_skill_background_general_strategist_roman	Майстер планування	true
character_skills_localised_name_att_skill_background_spy_hunter_roman	Венатор	true
character_skills_localised_description_cha_skill_priest_back_militant	Я готовий битися з усіма. З тобою. З твоєю собакою. З самим собою!	true
character_skills_localised_name_att_skill_background_priest_spiritual_leader_roman	Понтифекс	true
character_skills_localised_description_att_agent_skills_champion_marauding	Нальотник отримує все, не залишаючи жертві нічого.	true
character_skills_localised_name_att_agent_skills_priest_spiritual_leadership	Духовне лідерство	true
character_skills_localised_name_cha_skill_spy_back_rumours	Чутки	true
character_skills_localised_name_cha_skill_general_tactician	Хороший тактик	true
character_skills_localised_name_att_agent_skills_spy_civilian_infiltration	Проникнення в поселення	true
character_skills_localised_name_att_skill_background_general_melee_eastern	Боєць	true
character_skills_localised_name_att_skill_background_general_rider_eastern	Прославлений вершник	true
character_skills_localised_name_cha_skill_back_dice_roller	Гравець в кості	true
character_skills_localised_description_cha_trad_navy_boarders	Ці воїни кидаються на палуби ворожих суден, немов нестримна штормова хвиля.	true
character_skills_localised_name_att_trad_army_nomadic_3_barbarian_subjugators	Варвари-загарбники	true
character_skills_localised_name_mk_skill_assassin_back_master	Майстер	true
character_skills_localised_description_att_trad_navy_roman_5_defenders_mediterranean	Середземне море підкоряється тільки сильним. Ці люди його підкорили.	true
character_skills_localised_name_att_general_skills_eastern_2_spahbod	Головнокомандувач	true
character_skills_localised_description_att_general_skills_nomadic_2_thunder	Він нападає на ворога, немов небесний грім на хмари.	true
character_skills_localised_name_mk_skill_spy_back_conspirator	Змовник	true
character_skills_localised_name_att_trad_navy_barbarian_2_seafaring_traditions	Традиції мореплавства	true
character_skills_localised_description_cha_trad_navy_raiders	Успіх на морі не завжди пов'язаний з перемогою в битві.	true
character_skills_localised_description_att_skill_background_champion_standard_bearer_nomadic	Він з гордістю несе прапор великої і переможної держави.	true
character_skills_localised_name_att_skill_background_champion_scout_eastern	Розвідник	true
character_skills_localised_description_att_trad_navy_eastern_5_defence_fleet	Немає такого порту, який неможливо захистити.	true
character_skills_localised_description_att_agent_skills_priest_spiritual_leadership	Сліпий прозріє! Глухий почує!	true
character_skills_localised_description_att_skill_background_spy_artisan_roman	Мої руки - ось мої знаряддя. Ними я створюю прекрасні і чудові речі.	true
character_skills_localised_description_att_skill_background_priest_benefactor_nomadic	Ця людина простежить, щоб миші не бешкетували навіть за відсутності кішки.	true
character_skills_localised_name_att_general_skills_nomadic_2_thunder	Грім	true
character_skills_localised_description_att_general_skills_eastern_2_spahbod	Вождь воїнів і гроза ворогів, ця людина по праву займає свою посаду.	true
character_skills_localised_description_att_skill_background_wife_barbarian_shieldmaid	Ну... я була дівчиною... поки не зустріла його.	true
character_skills_localised_description_att_general_skills_nomadic_3_wind	Вітер нестримний, будь то легкий бриз або лютий буревій.	true
character_skills_localised_description_cha_skill_priest_provocation	Мечі безсилі. Мене оберігає небесне військо!	true
character_skills_localised_name_att_agent_skills_champion_provision	Провізія	true
character_skills_localised_description_att_skill_background_spy_agriculture_eastern	Деякі тварини рівніші за інших.	true
character_skills_localised_name_att_general_skills_barbarian_celts_plunderer	Грабіжник	true
character_skills_localised_name_att_skill_background_champion_elite_eastern	Асваран	true
character_skills_localised_name_att_skill_background_wife_barbarian_uncanny	Покладається на чуття	true
character_skills_localised_description_att_trad_army_roman_2_barbarian_subjugators	Кому потрібні ці жалюгідні халупи?	true
character_skills_localised_description_cha_skill_general_back_leader	Сміливість - це не відсутність страху, а перемога над ним.	true
character_skills_localised_name_att_skill_background_champion_marine_nomadic	Матрос	true
character_skills_localised_description_att_agent_skills_spy_tracking	Вистежити ворога можна і за зламаною травинкою. Хоча великі чіткі сліди, безсумнівно, зручніші.	true
character_skills_localised_name_mk_skill_general_bureaucrat	Бюрократ	true
character_skills_localised_description_att_skill_background_priest_militarist_nomadic	Ну, думаю, що мир можливий, але ж можлива і війна!	true
character_skills_localised_description_cha_trad_army_supplies	Без належних запасів не може бути війни.	true
character_skills_localised_description_att_skill_background_general_scholar_barbarian	Книги - найвеличніша зброя у війні з невіглаством.	true
character_skills_localised_name_att_skill_background_general_supply_barbarian	Досвідчений логіст	true
character_skills_localised_description_att_skill_background_wife_civilised_unfaithful	Так, я підморгувала йому. І не тільки. Звичайно! Я думала, це допоможе тобі в справах.	true
character_skills_localised_name_att_trad_navy_roman_1_mediterranean_seamanship	Знання Середземного моря	true
character_skills_localised_description_att_skill_background_general_scholar_nomadic	Книги - найвеличніша зброя у війні з невіглаством.	true
character_skills_localised_name_mk_skill_priest_back_elder	Старійшина	true
character_skills_localised_description_cha_trad_navy_steady	Тримайтеся міцніше, і ми доживемо до кінця дня!	true
character_skills_localised_description_cha_skill_spy_eyes_and_ears	Він все бачить, все чує і нічого не пропускає.	true
character_skills_localised_description_att_skill_background_wife_civilised_goddess	О-о-о... так! Крем...	true
character_skills_localised_description_att_agent_skills_champion_subversion	Шлях до серця людини лежить через її розум.	true
character_skills_localised_description_att_skill_background_general_merchant_nomadic	Його не хвилює батьківщина, дружба чи віра. Для нього важливі тільки гроші.	true
character_skills_localised_description_att_general_skills_barbarian_celts_rigfennid	Деякі народжуються, щоб правити не тільки воїнами, а й цілими народами.	true
character_skills_localised_description_att_skill_background_priest_spiritual_leader_eastern	Зверни погляд на свої гріхи; ніч темна і сповнена кошмарів.	true
character_skills_localised_description_att_agent_skills_spy_violence	Вбивство теж може бути захоплюючим.	true
character_skills_localised_name_att_general_skills_barbarian_2_hunter	Мисливець	true
character_skills_localised_description_cha_skill_priest_dogma	Я досягну успіху, тому що я вірю.	true
character_skills_localised_description_mk_skill_back_watchman	Він чекає і спостерігає, ретельно оцінюючи кожен крок...	true
character_skills_localised_description_att_skill_background_champion_assassin_eastern	Я стану твоїм захисником.	true
character_skills_localised_name_mk_skill_spy_tracking	Переслідування	true
character_skills_localised_description_att_general_skills_nomadic_3_despoiler	Ні п'яді землі, ні акра власності не сховається від його жадібного погляду.	true
character_skills_localised_name_mk_skill_general_sweet_talker	Красномовність	true
character_skills_localised_name_mk_skill_general_motivator	Натхненник	true
character_skills_localised_description_cha_skill_priest_back_advisor	Ця рука побудує все, що забажає цар.	true
character_skills_localised_name_att_skill_background_priest_public_speaker_barbarian	Оратор	true
character_skills_localised_name_att_skill_background_general_attacker_roman	Неприборканий агресор	true
character_skills_localised_name_att_skill_background_wife_civilised_wealthy	Багата	true
character_skills_localised_description_cha_trad_navy_stores	Лук без стріл — усього лише дуже дорога дерев’яшка.	true
character_skills_localised_name_att_skill_background_general_handler_nomadic	Наставник	true
character_skills_localised_description_att_trad_army_barbarian_2_ruin_rome	Ми перетворимо їх яскраві прапори на подерті ганчірки!	true
character_skills_localised_name_att_skill_background_wife_roman_former_vestal	Колишня весталка	true
character_skills_localised_description_att_trad_army_nomadic_4_terror	Попереду них йде страх, позаду - смерть.	true
character_skills_localised_name_att_trad_navy_barbarian_1_master_shipwrights	Майстри-корабели	true
character_skills_localised_name_att_trad_army_barbarian_4_berserkers	Берсерки	true
character_skills_localised_description_att_skill_background_champion_medic_eastern	Лікар, вилікуй себе сам!	true
character_skills_localised_name_cha_skill_general_bureaucrat	Бюрократ	true
character_skills_localised_description_att_trad_navy_barbarian_2_ruin_rome	Їхні будинки спалені, а міста зруйновані. Рим має всі підстави їх побоюватися.	true
character_skills_localised_description_mk_trad_army_cavalry_training	Кращі полководці походять тільки з найзнатніших родин.	true
character_skills_localised_description_att_trad_army_nomadic_3_defenders_camp	Простеж, щоб після бою нам було куди повернутися.	true
character_skills_localised_name_att_trad_navy_eastern_1_naval_support	Підтримка на морі	true
character_skills_localised_name_cha_skill_priest_belief_islam	Віра	true
character_skills_localised_name_cha_skill_priest_belief_pagan	Віра	true
character_skills_localised_description_att_trad_army_barbarian_1_guerrilla_warfare	Воювати можна не тільки в строю.	true
character_skills_localised_name_att_skill_background_general_entrepreneur_barbarian	Наглядач	true
character_skills_localised_name_mk_skill_general_commander	Командир	true
character_skills_localised_name_att_agent_skills_spy_bribery	Підкуп	true
character_skills_localised_description_att_general_skills_barbarian_2_raven	Темні крила приховують темні думки і несуть темні слова.	true
character_skills_localised_description_att_skill_background_general_marksman_nomadic	Його постріли завжди досягають мети - всупереч вогню, вітру і навіть самій смерті.	true
character_skills_localised_description_att_skill_background_wife_all_poisoner	Милий, на наступний симпозіум приготувати мій особливий соус?	true
character_skills_localised_description_att_skill_background_champion_war_hero_nomadic	Ця людина живе війною. Його термін минув, його битви виграні, але він ще живий.	true
character_skills_localised_name_att_general_skills_barbarian_5_legend	Легенда	true
character_skills_localised_name_mk_skill_assassin_back_legend	Легенда	true
character_skills_localised_name_att_trad_army_roman_5_defenders_virtue	Охоронці честі	true
character_skills_localised_description_att_skill_background_champion_watchman_eastern	Він чекає. Це його справа.	true
character_skills_localised_name_mk_skill_spy_arsonist	Підпалювач	true
character_skills_localised_name_att_skill_background_wife_barbarian_midwife	Повитуха	true
character_skills_localised_description_att_trad_navy_roman_4_barbarian_subjugators	Жменька брудних дикунів на плотах - ніщо перед римським флотом!	true
character_skills_localised_description_att_skill_background_general_warrior_nomadic	Я не підкоряюся нікому!	true
character_skills_localised_description_mk_trad_army_marksman_training	Ти можеш перемогти шістьох. Ми навчимо тебе, як перемогти шість сотень.	true
character_skills_localised_name_att_trad_army_eastern_1_occupation_force	Окупаційні сили	true
character_skills_localised_description_att_general_skills_nomadic_5_scourge	Де б не йшов цей чоловік, за його спиною залишаються сльози і попелище.	true
character_skills_localised_description_att_general_skills_nomadic_2_hunter	Він готовий переслідувати здобич і в морі, і в небі, і в безкрайньому степу.	true
character_skills_localised_name_att_skill_background_champion_quartermaster_eastern	Розпорядник	true
character_skills_localised_description_cha_trad_army_hunters	Не шуми. Візьми лук. Видихни. Стріляй.	true
character_skills_localised_description_att_skill_background_general_marksman_roman	Його постріли завжди досягають мети - всупереч вогню, вітру і навіть самій смерті.	true
character_skills_localised_description_att_skill_background_general_attacker_nomadic	Цей войовничий догматик не зупиниться, поки не розтрощить усіх своїх ворогів.	true
character_skills_localised_name_att_skill_background_spy_spymaster_eastern	Очі та вуха	true
character_skills_localised_name_att_skill_background_spy_conspirator_eastern	Змовник	true
character_skills_localised_description_mk_skill_assassin_back_scout	Дорога попереду ховається в темряві. Я освітлю її.	true
character_skills_localised_description_att_general_skills_barbarian_3_judge	Справедливий суддя, що користується величезним авторитетом.	true
character_skills_localised_name_att_trad_army_barbarian_2_domestic_devotion	Вірність батьківщині	true
character_skills_localised_name_mk_skill_spy_practice	Тренування	true
character_skills_localised_description_att_skill_background_champion_engineer_nomadic	Полководець бачить в облогових машинах зброю, а ця людина - витвори мистецтва.	true
character_skills_localised_name_att_trad_army_nomadic_1_raider_band	Банда нальотників	true
character_skills_localised_name_att_trad_army_roman_5_palatini	Палатини	true
character_skills_localised_name_mk_skill_assassin_back_scout	Розвідник	true
character_skills_localised_name_att_general_skills_barbarian_3_judge	Суддя	true
character_skills_localised_description_att_skill_background_spy_conspirator_eastern	Підступність, хитрість і трохи обману.	true
character_skills_localised_description_att_skill_background_general_defender_eastern	Об цю неприступну стіну розбилося безліч ворогів.	true
character_skills_localised_name_mk_trad_navy_steady	Твердий	true
character_skills_localised_description_att_trad_navy_eastern_3_pirate_hunters	Ці люди рішуче викорінюють морських розбійників.	true
character_skills_localised_name_mk_skill_spy_sabotage	Диверсія	true
character_skills_localised_description_att_trad_army_nomadic_4_steppe_warfare	Ваші уявлення про війну марні в степу. Там інші правила.	true
character_skills_localised_description_att_skill_background_priest_elder_barbarian	Солодкі слова і гострий розум дають ідеальний смак мудрості.	true
character_skills_localised_name_att_skill_background_champion_medic_nomadic	Цілитель	true
character_skills_localised_name_att_skill_background_spy_racketeer_eastern	Вимагач	true
character_skills_localised_name_att_skill_background_general_warrior_nomadic	Безстрашний воїн	true
character_skills_localised_name_att_trad_navy_barbarian_4_bane_east	Гроза Сходу	true
character_skills_localised_description_att_skill_background_spy_mole_nomadic	Людина, яка опинилася в потрібному місці і почула потрібні слова, цінніша за тисячу вершників.	true
character_skills_localised_name_mk_trad_navy_stores	Сховища	true
character_skills_localised_description_att_trad_army_eastern_1_occupation_force	Це наша земля. Вони це дізнаються - так чи інакше.	true
character_skills_localised_name_att_trad_navy_eastern_2_barbarian_subjugators	Варвари-загарбники	true
character_skills_localised_name_att_general_skills_nomadic_5_scourge	Бич	true
character_skills_localised_name_bel_trad_army_roman_4_sieging	Майстри облоги	true
character_skills_localised_name_att_skill_background_spy_mole_roman	Спекулянт	true
character_skills_localised_name_cha_skill_spy_black_market	Чорний ринок	true
character_skills_localised_description_att_agent_skills_spy_bribery	Можливо, мій приятель Флавій переконає тебе передумати...	true
character_skills_localised_description_cha_skill_general_commander	За мною, бійці! Я приведу вас до вічної слави!	true
character_skills_localised_description_att_skill_background_champion_quartermaster_nomadic	Цей чоловік чудово розбирається у всьому, що стосується поставок і спорядження.	true
character_skills_localised_name_att_general_skills_barbarian_2_raven	Ворон	true
character_skills_localised_name_att_trad_army_roman_3_medium_training	Тренування середніх військ	true
character_skills_localised_description_att_skill_background_general_handler_barbarian	Цей чесний і справедливий чоловік завжди готовий поділитися мудрою порадою.	true
character_skills_localised_description_mk_skill_assassin_misdirection	Кинута монетка, розбита ваза... Є багато способів відвернути чужі погляди.	true
character_skills_localised_description_att_trad_army_roman_3_foederati_corps	Держава захистила цих чужинців. Тепер їм час віддячити.	true
character_skills_localised_description_att_trad_army_barbarian_3_epic_camp_following	Весь цей обоз дуже обтяжливий, але створює затишок далеко від дому.	true
character_skills_localised_name_att_general_skills_roman_4_strategist	Стратег	true
character_skills_localised_description_att_skill_background_wife_all_cunning	Я бачу більше, ніж ти, мій дорогий, тому що на жінок ніхто не звертає уваги.	true
character_skills_localised_name_att_skill_background_general_defender_roman	Стійкий захисник	true
character_skills_localised_description_cha_skill_general_bureaucrat	Так, війна - це чудово. Але потрібно оформити деякі папери...	true
character_skills_localised_description_att_general_skills_roman_2_dux	Перший серед рівних. Природжений командир. Справжній лідер.	true
character_skills_localised_name_mk_skill_priest_provocation	Провокація	true
character_skills_localised_description_att_trad_army_barbarian_4_berserkers	Немає ні розуму, ні милосердя. Є тільки смерть.	true
character_skills_localised_description_att_trad_navy_barbarian_1_master_shipwrights	Одні кораблі бовтаються на хвилях, інші пливуть за течією, але найкращі ковзають, розсікаючи море.	true
character_skills_localised_description_att_skill_background_wife_civilised_protective	Дорогий, я найняла ще шістьох охоронців. Всі міцні, як на підбір.	true
character_skills_localised_description_att_skill_background_priest_advisor_nomadic	Ця рука побудує все, що забажає цар.	true
character_skills_localised_name_cha_skill_back_cat_reflexes	Котяча реакція	true
character_skills_localised_description_att_trad_army_roman_3_comitatenses	Бийся! Перемагай! Перемагай!	true
character_skills_localised_name_mk_skill_assassin_back_aide	Помічник	true
character_skills_localised_description_att_trad_army_roman_4_military_engineering	Завдяки ретельному налаштуванню військові машини стають ще більш смертоносними.	true
character_skills_localised_description_att_skill_background_general_supply_barbarian	Нагодувати людину легко. Нагодувати цілу армію - справжній подвиг.	true
character_skills_localised_name_att_skill_background_general_rider_barbarian	Прославлений вершник	true
character_skills_localised_name_att_agent_skills_priest_imposition	Шахрайство	true
character_skills_localised_description_mk_skill_assassin_determined	Боротися і шукати, знайти і не здаватися!	true
character_skills_localised_description_cha_skill_assassin_opportunism	Кіт з дому - миші йдуть вбивати.	true
character_skills_localised_name_cha_skill_general_back_leader	Вождь	true
character_skills_localised_description_att_general_skills_barbarian_4_warchief	Його сила і рішучість вселяють повагу. Він гідний свого звання.	true
character_skills_localised_description_att_general_skills_eastern_3_cavalry_commander	Вперед! Тримайте стрій, проривайте їхні ряди!	true
character_skills_localised_name_att_agent_skills_spy_tracking	Переслідування	true
character_skills_localised_description_att_skill_background_general_leader_eastern	Сміливість - не відсутність страху, а перемога над ним.	true
character_skills_localised_name_cha_trad_army_steady_troops	Стійкі	true
character_skills_localised_description_att_skill_background_champion_drillmaster_barbarian	Ти будеш слухати. Ти будеш вчитися. Або ти помреш.	true
character_skills_localised_description_cha_skill_assassin_practice	Кажуть, щоб опанувати якусь справу, треба витратити 10 000 годин. Тож не гай часу!	true
character_skills_localised_name_att_general_skills_nomadic_3_wind	Вітер	true
character_skills_localised_name_cha_trad_navy_raiders	Нальотники	true
character_skills_localised_name_att_skill_background_champion_standard_bearer_nomadic	Прапороносець	true
character_skills_localised_description_att_skill_background_general_landowner_nomadic	Ох, як же чудово пасти стада.	true
character_skills_localised_name_att_trad_navy_eastern_5_defence_fleet	Оборонний флот	true
character_skills_localised_description_att_skill_background_wife_roman_former_vestal	Заради чоловіка мого я запалю будь-яке полум'я.	true
character_skills_localised_description_att_skill_background_general_supply_nomadic	Нагодувати людину легко. Нагодувати цілу армію - справжній подвиг.	true
character_skills_localised_description_att_skill_background_champion_engineer_roman	Полководець бачить в облогових машинах зброю, а ця людина - витвори мистецтва.	true
character_skills_localised_description_att_skill_background_general_administrator_barbarian	Печаткам цієї людини довіряють у всьому світі.	true
character_skills_localised_name_cha_skill_general_back_rider	Вершник	true
character_skills_localised_name_mk_skill_spy_back_racketeer	Вимагач	true
character_skills_localised_name_cha_skill_general_back_melee	Ближній бій	true
character_skills_localised_name_att_trad_army_nomadic_5_royal_host	Царський почет	true
character_skills_localised_name_mk_trad_navy_scourge_pirates	Бич піратів	true
character_skills_localised_name_cha_skill_priest_back_advisor	Радник	true
character_skills_localised_description_att_trad_army_eastern_5_army_immortals	Кожен з цих добірних бійців вартий десяти звичайних воїнів.	true
character_skills_localised_description_cha_skill_general_back_warrior	Ця людина народилася, щоб битися. Вона не потребує нічого, крім війни.	true
character_skills_localised_description_att_general_skills_barbarian_2_hunter	У морі і в небі, серед долин і лісових хащів - ця людина скрізь знайде слід.	true
character_skills_localised_name_att_skill_background_priest_strategy_gaming_nomadic	Знавець стратегії	true
character_skills_localised_name_cha_skill_assassin_eyes_ears	Очі та вуха	true
character_skills_localised_description_mk_skill_spy_tracking	Він буде переслідувати ворога вдень і вночі, через пустелі, пагорби та ущелини.	true
character_skills_localised_description_att_skill_background_priest_benefactor_roman	Ця людина простежить, щоб миші не бешкетували навіть за відсутності кішки.	true
character_skills_localised_description_mk_skill_general_sweet_talker	Солодкі слова можуть бути небезпечніші за меч.	true
character_skills_localised_name_att_skill_background_spy_agriculture_roman	Селянин	true
character_skills_localised_name_att_skill_background_general_merchant_nomadic	Купець	true
character_skills_localised_name_att_agent_skills_spy_violence	Вбивця	true
character_skills_localised_name_att_trad_army_nomadic_2_foreign_contingent	Чужоземні воїни	true
character_skills_localised_name_att_skill_background_general_leader_nomadic	Вождь	true
character_skills_localised_name_att_skill_background_priest_benefactor_roman	Куратор	true
character_skills_localised_name_att_skill_background_wife_civilised_social_climber	Амбіційна	true
character_skills_localised_description_att_skill_background_general_patron_barbarian	Це прекрасна споруда. Так. Красива. Дайте десять.	true
character_skills_localised_description_cha_skill_assassin_eyes_ears	Він все бачить, все чує і нічого не пропускає.	true
character_skills_localised_name_att_skill_background_wife_all_harridan_nag	Стара відьма	true
character_skills_localised_name_mk_skill_assassin_bodyguard	Охоронець	true
character_skills_localised_name_att_trad_navy_eastern_4_naval_marksmanship	Морські стрільці	true
character_skills_localised_name_mk_skill_spy_back_spymaster	Досвідчений підглядник	true
character_skills_localised_description_cha_skill_spy_smuggler	Не говори дурниць!	true
character_skills_localised_name_att_skill_background_priest_strategy_gaming_barbarian	Гравець в тафл	true
character_skills_localised_description_cha_skill_general_back_rider	Ця людина відчуває себе щасливою тільки в сідлі.	true
character_skills_localised_description_mk_trad_navy_scourge_pirates	Ті, хто ходить під чорним вітрилом, розсудливо уникають зустрічі з цими моряками.	true
character_skills_localised_name_att_agent_skills_priest_instigation	Підбурювання	true
character_skills_localised_description_cha_skill_general_back_melee	Стріли і дротики - для слабаків. Справжній воїн повинен відчувати запах поту свого ворога!	true
character_skills_localised_name_cha_trad_army_dread	Жахливі	true
character_skills_localised_name_cha_trad_army_loyal	Лояльні	true
character_skills_localised_name_att_skill_background_priest_advisor_eastern	Радник	true
character_skills_localised_name_att_skill_background_champion_officer_roman	Центуріон	true
character_skills_localised_name_att_skill_background_general_administrator_barbarian	Сановник	true
character_skills_localised_name_att_skill_background_wife_all_great_beauty	Красуня	true
character_skills_localised_name_att_skill_background_champion_martial_arts_eastern	Знавець пехлевані	true
character_skills_localised_name_att_skill_background_priest_public_speaker_eastern	Оратор	true
character_skills_localised_name_att_skill_background_champion_engineer_roman	Архітектор	true
character_skills_localised_name_att_skill_background_champion_officer_eastern	Гунд-салар	true
character_skills_localised_description_mk_skill_general_back_merchant	Його не хвилює батьківщина, дружба чи віра. Для нього важливі тільки гроші.	true
character_skills_localised_name_att_agent_skills_spy_coercion	Примус	true
character_skills_localised_description_att_skill_background_priest_strategy_gaming_eastern	Хороший гравець не прораховує на п'ять ходів вперед. Він перемагає на першому ході.	true
character_skills_localised_description_att_trad_army_nomadic_3_barbarian_subjugators	Нехай удача буде вічно прихильною до тебе.	true
character_skills_localised_description_mk_skill_assassin_back_master	Він вдосконалював свою майстерність все життя.	true
character_skills_localised_name_att_trad_navy_roman_5_defenders_mediterranean	Захисники Середземномор'я	true
character_skills_localised_description_mk_skill_spy_back_conspirator	Підступність, хитрість і трохи обману.	true
character_skills_localised_name_mk_skill_assassin_practice	Тренування	true
character_skills_localised_description_mk_skill_assassin_provision	Деякі істини вічні. Армією завжди рухає шлунок.	true
character_skills_localised_description_att_agent_skills_spy_diversion	Дивись, я тебе відволікаю!	true
character_skills_localised_name_mk_skill_assassin_determined	Рішучий	true
character_skills_localised_name_att_skill_background_general_supply_eastern	Досвідчений логіст	true
character_skills_localised_description_att_skill_background_general_rider_barbarian	Є ті, хто сидить у сідлі, а є вершники.	true
character_skills_localised_name_att_skill_background_general_patron_eastern	Патрон	true
character_skills_localised_description_att_skill_background_general_strategist_roman	Кожна можливість врахована, для кожного подиху є пояснення.	true
character_skills_localised_name_att_skill_background_champion_standard_bearer_roman	Сигніфер	true
character_skills_localised_description_att_skill_background_spy_hunter_roman	Вони полюють, щоб самі не стати здобиччю...	true
character_skills_localised_description_att_skill_background_priest_scribe_barbarian_barbarian	Ці літери незрозумілі більшості, але в них прихована історія всього світу.	true
character_skills_localised_name_att_skill_background_priest_progressive_roman	Прогресивний	true
character_skills_localised_description_att_trad_army_barbarian_5_furor_barbaricus	Насмішки над дикістю і лютістю варварів породжені страхом.	true
character_skills_localised_description_cha_skill_spy_back_racketeer	Я зроблю йому пропозицію, від якої неможливо відмовитися.	true
character_skills_localised_description_att_trad_navy_eastern_2_barbarian_subjugators	Ці сухопутні щури безсилі проти нашого флоту!	true
character_skills_localised_description_mk_skill_general_back_administrator	Печатки цієї людини довіряють у всьому світі.	true
character_skills_localised_description_mk_trad_navy_double_planking	Дві дошки міцніші за одну, чи не так?	true
character_skills_localised_name_att_skill_background_spy_racketeer_barbarian	Злочинець	true
character_skills_localised_description_att_general_skills_roman_3_cavalry_commander	Громовий тупіт копит надихає його на великі звершення.	true
character_skills_localised_description_mk_skill_general_back_attacker	Він не хоче знати нічого, крім нескінченних атак і постійного натиску.	true
character_skills_localised_name_att_skill_background_spy_mole_nomadic	Кріт	true
character_skills_localised_description_mk_skill_priest_spiritual_leadership	Сліпий прозріє! Глухий почує!	true
character_skills_localised_name_cha_skill_back_natural_gift	Вроджений талант	true
character_skills_localised_description_att_skill_background_priest_scholar_nomadic	Стій і послухай.	true
character_skills_localised_description_mk_skill_general_back_supply	Війни виграють не тільки солдати, але і зброя. І ще продовольство.	true
character_skills_localised_description_cha_skill_assassin_coercion	Який сенс у посланні, якщо ти не можеш говорити?	true
character_skills_localised_description_mk_skill_general_back_patron	Це прекрасна споруда. Так. Красива. Дайте десять.	true
character_skills_localised_description_mk_skill_spy_sabotage	Диверсія - це мистецтво порушувати плани ворога.	true
character_skills_localised_name_cha_skill_spy_back_spymaster	Досвідчений підглядник	true
character_skills_localised_name_att_skill_background_general_warrior_roman	Безстрашний воїн	true
character_skills_localised_name_att_skill_background_champion_martial_arts_barbarian	Майстер гліми	true
character_skills_localised_name_cha_skill_assassin_assassin	Асасин	true
character_skills_localised_name_cha_skill_assassin_bodyguard	Охоронець	true
character_skills_localised_name_att_skill_background_general_defender_eastern	Стійкий захисник	true
character_skills_localised_name_cha_skill_priest_determined	Рішучий	true
character_skills_localised_name_cha_trad_navy_loyal	Лояльний	true
character_skills_localised_description_cha_skill_assassin_back_aide	Мати прислугу дозволено тільки високопоставленим особам.	true
character_skills_localised_description_mk_skill_general_back_marksman	Його постріли завжди досягають мети - всупереч вогню, вітру і навіть самій смерті.	true
character_skills_localised_name_att_skill_background_wife_all_cunning	Хитра	true
character_skills_localised_description_att_trad_navy_eastern_2_blockade_runners	Це консульський корабель з дипломатичною місією...	true
character_skills_localised_name_att_trad_army_roman_3_foederati_corps	Війська федератів	true
character_skills_localised_description_att_skill_background_wife_all_flirt	Він так прив'язаний до мене. Дорогий, всім нам це буде тільки на користь...	true
character_skills_localised_description_att_skill_background_general_melee_barbarian	Зброя - не інструмент, а продовження руки воїна.	true
character_skills_localised_name_mk_skill_spy_sapping	Пошкодження стін	true
character_skills_localised_description_att_general_skills_roman_4_strategist	Перемоги він приписує собі, а про поразки мовчить. У цьому його стратегія.	true
character_skills_localised_name_att_trad_army_barbarian_3_epic_camp_following	Великий обоз	true
character_skills_localised_name_att_agent_skills_priest_retribution	Відплата	true
character_skills_localised_name_mk_skill_priest_conviction	Викриття	true
character_skills_localised_description_mk_trad_army_looters	Не залишати по собі нічого, окрім поживи для воронів.	true
character_skills_localised_name_att_skill_background_priest_scribe_eastern_eastern	Писець	true
character_skills_localised_name_att_skill_background_priest_scribe_nomadic_nomadic	Писар	true
character_skills_localised_name_mk_skill_assassin_training	Тренування	true
character_skills_localised_description_bel_trad_army_roman_4_sieging	Ну що, хлопці, ще раз! Всі в пролом!	true
character_skills_localised_description_att_trad_army_eastern_3_dailamite_regime	Відбірні загони важкої піхоти, славні своїм військовим мистецтвом.	true
character_skills_localised_name_att_trad_army_eastern_2_self_sufficiency	Самодостатність	true
character_skills_localised_description_att_trad_army_roman_3_medium_training	Спочатку ви навчитеся дисципліни. Потім - військовому мистецтву. А потім станете непереможними.	true
character_skills_localised_name_att_skill_background_wife_all_quiet	Тихоня	true
character_skills_localised_description_att_trad_navy_barbarian_3_cuthroat_raiders	Зараз не час для страху. Боятися будете потім.	true
character_skills_localised_name_att_skill_background_wife_all_shrew	Сварлива	true
character_skills_localised_name_att_skill_background_priest_scholar_eastern	Наставник	true
character_skills_localised_description_att_general_skills_barbarian_5_legend	Ця людина увійшла в історію. Історія стала легендою. Легенда стає міфом.	true
character_skills_localised_description_cha_skill_priest_conviction	Побач же своє злодійство, занурений у гріх!	true
character_skills_localised_description_mk_skill_assassin_back_legend	Ця людина увійшла в історію. Історія стала легендою. Легенда стає міфом.	true
character_skills_localised_name_att_skill_background_general_melee_barbarian	Боєць	true
character_skills_localised_description_mk_skill_spy_sapping	Ця людина точно знає, що під будь-якою стіною можна вирити підкоп.	true
character_skills_localised_name_mk_trad_army_looters	Грабіжники	true
character_skills_localised_name_att_skill_background_spy_conspirator_roman	Змовник	true
character_skills_localised_description_cha_skill_assassin_training	Дисципліна, сила, майстерність. У сумі вони дають перемогу.	true
character_skills_localised_description_mk_skill_spy_arsonist	Хочеш знати, навіщо я все підпалюю? Мені це просто подобається!	true
character_skills_localised_name_att_skill_background_champion_team_sports_barbarian	Учасник змагань	true
character_skills_localised_description_att_trad_army_eastern_2_self_sufficiency	Небо над головою і спис у руці. Що ще потрібно?	true
character_skills_localised_name_att_trad_army_eastern_3_dailamite_regime	Ударні загони	true
character_skills_localised_name_att_skill_background_general_marksman_nomadic	Влучний стрілець	true
character_skills_localised_name_att_general_skills_barbarian_4_sentinel	Вартовий	true
character_skills_localised_description_att_skill_background_priest_radical_eastern_eastern	Відсутність змін - це застій. Застій - це ворог.	true
character_skills_localised_description_att_skill_background_priest_radical_nomadic_nomadic	Відсутність змін - це застій. Застій - це ворог.	true
character_skills_localised_description_att_trad_navy_eastern_1_naval_support	Руйнівний дощ стріл - найкраща підтримка в морському бою.	true
character_skills_localised_name_cha_skill_assassin_back_aide	Помічник	true
character_skills_localised_description_cha_skill_priest_belief_islam	Віра передбачає обов'язки. Той, хто виконує їх, зміцнює віру.	true
character_skills_localised_description_att_agent_skills_priest_provocation	Мечі безсилі. Мене береже небесне військо!	true
character_skills_localised_description_cha_skill_priest_belief_pagan	Земля не належить нам. Ми належимо Землі.	true
character_skills_localised_description_att_general_skills_barbarian_3_fleet_commander	Ця людина не може жити без шуму хвиль і морського вітру.	true
character_skills_localised_name_mk_trad_army_cavalry_training	Знатний воєначальник	true
character_skills_localised_name_att_trad_navy_eastern_2_blockade_runners	Проривачі облоги	true
character_skills_localised_description_cha_skill_assassin_bodyguard	Він буде захищати пана до останнього передсмертного хрипу.	true
character_skills_localised_name_mk_skill_assassin_eyes_ears	Очі та вуха	true
character_skills_localised_description_att_skill_background_champion_martial_arts_barbarian	Так, мені потрібна хороша чесна бійка. Щоб ніяких ударів нижче пояса!	true
character_skills_localised_description_cha_skill_spy_back_spymaster	Він все бачить, все чує і нічого не пропускає.	true
character_skills_localised_name_mk_skill_general_back_supply	Постачальник	true
character_skills_localised_name_mk_skill_general_back_patron	Патрон	true
character_skills_localised_description_mk_skill_spy_practice	Кажуть, щоб опанувати якусь справу, треба витратити 10 000 годин. Тож не гай часу!	true
character_skills_localised_name_mk_skill_assassin_coercion	Примус	true
character_skills_localised_name_att_skill_background_spy_courier_barbarian	Гінець	true
character_skills_localised_name_mk_skill_priest_spiritual_leadership	Духовне лідерство	true
character_skills_localised_name_cha_trad_army_hunters	Мисливці	true
character_skills_localised_name_att_skill_background_general_attacker_nomadic	Неприборканий агресор	true
character_skills_localised_description_cha_skill_general_back_scholar	Книги - найвеличніша зброя у війні з невіглаством.	true
character_skills_localised_description_att_skill_background_spy_racketeer_barbarian	Я зроблю йому пропозицію, від якої неможливо відмовитися.	true
character_skills_localised_name_att_general_skills_roman_3_cavalry_commander	Командир кінноти	true
character_skills_localised_name_mk_trad_navy_double_planking	Подвійна обшивка	true
character_skills_localised_name_cha_trad_army_siege_experts	Знавці облогової справи	true
character_skills_localised_name_cha_skill_spy_back_racketeer	Вимагач	true
character_skills_localised_name_mk_skill_general_back_melee	Ближній бій	true
character_skills_localised_name_mk_skill_general_back_rider	Вершник	true
character_skills_localised_description_att_skill_background_champion_elite_barbarian	Цей вірний слуга і безстрашний воїн заслуговує на найглибшу повагу.	true
character_skills_localised_name_att_skill_background_priest_advisor_nomadic	Права рука	true
character_skills_localised_description_cha_skill_back_cat_reflexes	Сила лева і спритність леопарда.	true
character_skills_localised_description_mk_skill_assassin_back_aide	Мати прислугу дозволено тільки високопоставленим особам.	true
character_skills_localised_description_att_skill_background_wife_civilised_efficient	Тут я займаюся господарством. Ти ж - всім іншим.	true
character_skills_localised_description_att_trad_navy_barbarian_1_naval_expedition	Несіть мене до горизонту!	true
character_skills_localised_name_att_skill_background_priest_public_speaker_nomadic	Оратор	true
character_skills_localised_description_att_trad_army_eastern_3_parthian_horsemanship	Стародавня тактика кінного бою, збережена сучасними вершниками.	true
character_skills_localised_name_att_agent_skills_priest_conviction	Викриття	true
character_skills_localised_description_att_skill_background_priest_militarist_roman	Ну, думаю, що мир можливий, але ж можлива і війна!	true
character_skills_localised_name_att_skill_background_champion_martial_arts_nomadic	Досвідчений борець	true
character_skills_localised_name_att_skill_background_spy_builder_barbarian	Будівельник	true
character_skills_localised_description_mk_skill_spy_back_mole	Людина, здатна опинитися в потрібному місці і почути потрібні слова, цінніша за тисячі мечів.	true
character_skills_localised_name_att_skill_background_champion_officer_nomadic	Ватажок загону	true
character_skills_localised_name_att_general_skills_barbarian_4_warchief	Бойовий вождь	true
character_skills_localised_name_att_skill_background_general_leader_eastern	Вождь	true
character_skills_localised_name_att_skill_background_champion_drillmaster_barbarian	Провідник ратей	true
character_skills_localised_description_cha_trad_army_steady_troops	Тримайтеся міцніше, і ми доживемо до кінця дня!	true
character_skills_localised_description_mk_trad_army_hunters	Не шуми. Візьми лук. Видихни. Стріляй.	true
character_skills_localised_name_cha_skill_priest_prejudice	Упередженість	true
character_skills_localised_description_cha_skill_assassin_back_scout	Дорога попереду ховається в темряві. Я освітлю її.	true
character_skills_localised_name_att_skill_background_champion_war_hero_roman	Надстрочник	true
character_skills_localised_description_att_skill_background_general_leader_barbarian	Сміливість - не відсутність страху, а перемога над ним.	true
character_skills_localised_name_cha_skill_assassin_practice	Тренування	true
character_skills_localised_name_att_skill_background_champion_watchman_roman	Часовий	true
character_skills_localised_description_cha_skill_spy_sabotage	Диверсія - це мистецтво порушувати плани ворога.	true
character_skills_localised_description_att_skill_background_champion_marine_barbarian	Перемагати на суші, перемагати на морі. Перемога понад усе!	true
character_skills_localised_name_mk_trad_army_dread	Жахливі	true
character_skills_localised_name_mk_trad_army_loyal	Лояльні	true
character_skills_localised_name_att_general_skills_eastern_4_judge	Суддя	true
character_skills_localised_description_att_skill_background_wife_barbarian_priestess	Я молилася за твій успіх, чоловіче мій. І приносила жертви.	true
character_skills_localised_description_cha_skill_general_back_administrator	Печатки цієї людини довіряють у всьому світі.	true
character_skills_localised_name_att_skill_background_general_supply_nomadic	Досвідчений логіст	true
character_skills_localised_description_att_skill_background_general_taskmaster_roman	Цю людину не вразити ні подвигом, ні старанністю.	true
character_skills_localised_description_mk_skill_spy_back_racketeer	Я зроблю йому пропозицію, від якої неможливо відмовитися.	true
character_skills_localised_description_att_skill_background_priest_spiritual_leader_barbarian	Зверни погляд на свої гріхи; ніч темна і сповнена кошмарів.	true
character_skills_localised_description_att_skill_background_priest_strategy_gaming_nomadic	Хороший гравець не прораховує на п'ять ходів вперед. Він перемагає на першому ході.	true
character_skills_localised_description_att_trad_army_eastern_4_barbarian_subjugators	Те, що вони громили Рим, тут не має ніякого значення.	true
character_skills_localised_name_cha_skill_spy_sapping	Пошкодження стін	true
character_skills_localised_name_bel_trad_army_roman_3_attacking_enemy	Ворожі землі	true
character_skills_localised_description_att_skill_background_wife_roman_noble	Мої предки побудували це місто. Ти ж, мій любий, збережеш його!	true
character_skills_localised_description_att_skill_background_general_leader_nomadic	Сміливість - це не відсутність страху, а перемога над ним.	true
character_skills_localised_description_att_skill_background_champion_aide_camp_roman	Довгі роки ця людина пробивалася нагору, прагнучи до величі і надихаючи на це інших.	true
character_skills_localised_description_mk_skill_assassin_bodyguard	Він буде захищати пана до останнього передсмертного хрипу.	true
character_skills_localised_name_att_skill_background_general_scholar_roman	Вчений	true
character_skills_localised_description_mk_skill_spy_back_spymaster	Він все бачить, все чує і нічого не пропускає.	true
character_skills_localised_name_cha_trad_army_looters	Грабіжники	true
character_skills_localised_description_att_skill_background_general_landowner_eastern	Ах, як же добре володіти землею.	true
character_skills_localised_name_att_agent_skills_champion_skirmishing	Перестрілка	true
character_skills_localised_description_cha_skill_assassin_back_legend	Ця людина увійшла в історію. Історія стала легендою. Легенда стає міфом.	true
character_skills_localised_name_att_skill_background_champion_standard_bearer_eastern	Прапороносець	true
character_skills_localised_description_cha_skill_spy_arsonist	Хочеш знати, навіщо я все підпалюю? Мені це просто подобається!	true
character_skills_localised_description_cha_trad_army_dread	Серце будь-якого ворога, який побачив цих воїнів, стискають крижані пазурі страху.	true
character_skills_localised_description_cha_trad_army_loyal	Жоден з них ніколи не підніме бунт. Вони підуть за полководцем назустріч смерті і славі.	true
character_skills_localised_description_att_agent_skills_priest_instigation	І ще одне...	true
character_skills_localised_description_att_skill_background_priest_advisor_eastern	Ця рука побудує все, що забажає цар.	true
character_skills_localised_description_bel_trad_army_roman_2_home_defence	Захищати свій дім - найбільший обов'язок і найбільша честь.	true
character_skills_localised_description_att_skill_background_champion_officer_roman	Вожді. Воїни. Вкриті кров'ю, війною і славою.	true
character_skills_localised_name_att_skill_background_spy_artisan_barbarian	Ремісник	true
character_skills_localised_name_att_agent_skills_priest_admonition	Умовляння	true
character_skills_localised_name_cha_skill_general_back_administrator	Адміністратор	true
character_skills_localised_description_att_general_skills_nomadic_3_cavalry_commander	На фланг! Піки до бою!	true
character_skills_localised_description_att_skill_background_champion_war_hero_roman	Цей чоловік живе війною. Його термін минув, його битви виграні, але він ще живий.	true
character_skills_localised_name_att_skill_background_priest_strategy_gaming_eastern	Гравець в чатранг	true
character_skills_localised_description_att_skill_background_champion_watchman_roman	Він чекає. Це його справа.	true
character_skills_localised_description_att_trad_army_eastern_2_nomad_hunters	Коні степовиків швидкі, але перські коні швидші.	true
character_skills_localised_name_mk_trad_army_steady_troops	Стійкі	true
character_skills_localised_name_att_trad_navy_roman_2_naval_logistics	Морська логістика	true
character_skills_localised_name_att_agent_skills_champion_sabotage	Диверсія	true
character_skills_localised_name_mk_trad_army_hunters	Мисливці	true
character_skills_localised_description_mk_skill_general_back_scholar	Книги - найвеличніша зброя у війні з невіглаством.	true
character_skills_localised_name_mk_skill_assassin_provision	Провізія	true
character_skills_localised_name_att_trad_army_nomadic_5_scourge_world	Бич світу	true
character_skills_localised_name_cha_skill_priest_spiritual_leadership	Духовне лідерство	true
character_skills_localised_description_cha_skill_spy_practice	Кажуть, щоб опанувати якусь справу, треба витратити 10 000 годин. Тож не гай часу!	true
character_skills_localised_name_att_skill_background_general_merchant_eastern	Купець	true
character_skills_localised_name_cha_skill_general_back_patron	Патрон	true
character_skills_localised_name_cha_skill_general_back_supply	Постачальник	true
character_skills_localised_name_mk_skill_back_cat_reflexes	Котяча реакція	true
character_skills_localised_name_att_skill_background_priest_militarist_roman	Мілітарист	true
character_skills_localised_description_att_skill_background_general_patron_eastern	Це прекрасна споруда. Так. Красива. Дайте десять.	true
character_skills_localised_description_att_skill_background_general_supply_eastern	Нагодувати людину легко. Нагодувати цілу армію - справжній подвиг.	true
character_skills_localised_description_att_skill_background_champion_standard_bearer_roman	Він з гордістю несе прапор великих перемог.	true
character_skills_localised_description_att_skill_background_wife_roman_well_connected	Я неодмінно напишу своїм кузенам. І дідусеві. І дядькам...	true
character_skills_localised_name_cha_trad_navy_double_planking	Подвійна обшивка	true
character_skills_localised_description_att_agent_skills_priest_dogma	Я досягну успіху, тому що я в це вірю.	true
character_skills_localised_name_mk_skill_general_back_leader	Вождь	true
character_skills_localised_name_mk_trad_army_siege_experts	Знавці облогової справи	true
character_skills_localised_description_mk_skill_assassin_opportunism	Кіт з дому - миші йдуть вбивати.	true
character_skills_localised_name_mk_skill_general_back_administrator	Адміністратор	true
character_skills_localised_name_cha_skill_priest_pessimism	Песимізм	true
character_skills_localised_name_mk_trad_army_supplies	Припаси	true
character_skills_localised_name_att_skill_background_wife_all_fertile	Фертильна	true
character_skills_localised_name_att_skill_background_priest_advisor_barbarian	Правознавець	true
character_skills_localised_description_att_skill_background_spy_informant_barbarian	Насправді ти працюєш на нас, але вони переконані, що ти працюєш на них? Як же у вас, шпигунів, все заплутано...	true
character_skills_localised_name_cha_skill_priest_eyes_ears	Очі та вуха	true
character_skills_localised_description_att_skill_background_champion_medic_barbarian	Лікарю, вилікуй себе сам!	true
character_skills_localised_description_att_skill_background_spy_spymaster_barbarian	Він все бачить, все чує і нічого не пропускає.	true
character_skills_localised_description_cha_skill_back_natural_gift	Можливо, це вроджена риса?..	true
character_skills_localised_name_att_skill_background_priest_scholar_nomadic	Зберігач легенд	true
character_skills_localised_name_cha_skill_assassin_coercion	Примус	true
character_skills_localised_name_cha_skill_priest_damnation	Прокляття	true
character_skills_localised_name_mk_trad_navy_raiders	Нальотники	true
character_skills_localised_description_att_skill_background_priest_accountant_roman	Людина, яка вміє рахувати, високо цінується в будь-якій армії.	true
character_skills_localised_description_cha_skill_assassin_assassin	Картини смерті пишуться кров'ю.	true
character_skills_localised_description_att_skill_background_priest_scribe_roman_roman	Ці літери незрозумілі більшості, але в них прихована історія всього світу.	true
character_skills_localised_name_att_general_skills_roman_1_legatus	Легат	true
character_skills_localised_name_att_skill_background_general_marksman_eastern	Влучний стрілець	true
character_skills_localised_description_att_skill_background_general_landowner_roman	Світом, сповненим злиднів, править той, хто володіє землею.	true
character_skills_localised_description_cha_trad_navy_loyal	Жоден з них ніколи не підніме бунт. Вони підуть за полководцем назустріч смерті і славі.	true
character_skills_localised_name_att_general_skills_barbarian_celts_brethid	Бретид	true
character_skills_localised_description_cha_skill_priest_determined	Боротися і шукати, знайти і не здаватися!	true
character_skills_localised_description_mk_skill_general_back_warrior	Ця людина народилася, щоб битися. Він не потребує нічого, крім війни.	true
character_skills_localised_name_mk_skill_priest_back_advisor	Радник	true
character_skills_localised_name_att_trad_navy_eastern_5_pride_east	Гордість Сходу	true
character_skills_localised_name_cha_trad_navy_scourge_pirates	Бич піратів	true
character_skills_localised_description_mk_skill_general_back_defender	Ті, хто тримають лад і не згинаються в бурю, виграють битви.	true
character_skills_localised_name_att_general_skills_roman_2_infantry_commander	Командир піхоти	true
character_skills_localised_description_att_skill_background_champion_assassin_roman	Я стану твоїм захисником.	true
character_skills_localised_name_att_skill_background_wife_all_flirt	Велелюбна	true
character_skills_localised_description_att_agent_skills_priest_retribution	І ти дізнаєшся, що ім'я мені - Господь, коли віддам тобі за твоїми справами.	true
character_skills_localised_name_cha_skill_assassin_provision	Провізія	true
character_skills_localised_name_mk_skill_priest_dogma	Догма	true
character_skills_localised_name_att_skill_background_champion_horse_vet_roman	Ветеринар	true
character_skills_localised_description_cha_skill_spy_tracking	Він буде переслідувати ворога вдень і вночі, через пустелі, пагорби і ущелини.	true
character_skills_localised_name_att_skill_background_general_attacker_eastern	Неприборканий агресор	true
character_skills_localised_description_cha_skill_general_sweet_talker	Солодкі слова можуть бути небезпечніші за меч.	true
character_skills_localised_description_att_skill_background_wife_all_shrew	Ти хоч знаєш, котра година? А-а, знову п'єш?! Не смій тут блювати!	true
character_skills_localised_description_att_skill_background_wife_all_quiet	За тихими тільки око в око.	true
character_skills_localised_description_att_skill_background_priest_scholar_eastern	Стій і послухай.	true
character_skills_localised_description_cha_skill_assassin_provision	Деякі істини вічні. Армією завжди рухає шлунок.	true
character_skills_localised_name_cha_skill_priest_conviction	Викриття	true
character_skills_localised_name_att_agent_skills_champion_training	Тренування	true
character_skills_localised_name_att_skill_background_wife_civilised_brutal	Безжальна	true
character_skills_localised_name_att_skill_background_champion_assassin_roman	Пропугнатор	true
character_skills_localised_name_cha_skill_assassin_training	Тренування	true
character_skills_localised_description_mk_skill_spy_smuggler	Не говори дурниць!	true
character_skills_localised_description_att_skill_background_champion_team_sports_barbarian	Швидше. Вище. Сильніше.	true
character_skills_localised_name_att_skill_background_general_defender_nomadic	Стійкий захисник	true
character_skills_localised_description_att_general_skills_barbarian_4_sentinel	Він готовий стояти, дивитися і охороняти. На більше він не здатний, але йому це й не потрібно.	true
character_skills_localised_name_att_skill_background_priest_radical_eastern_eastern	Радикальний	true
character_skills_localised_name_att_skill_background_priest_radical_nomadic_nomadic	Радикальний	true
character_skills_localised_name_mk_trad_navy_loyal	Лояльні	true
character_skills_localised_description_mk_skill_priest_back_advisor	Ця рука побудує все, що забажає цар.	true
character_skills_localised_name_mk_skill_priest_determined	Рішучий	true
character_skills_localised_name_att_agent_skills_priest_provocation	Провокація	true
character_skills_localised_description_att_skill_background_general_politician_roman	Якщо відкушувати потроху, можна з'їсти навіть кита.	true
character_skills_localised_name_att_skill_background_general_landowner_roman	Землевласник	true
character_skills_localised_name_att_skill_background_spy_mole_eastern	Вивідувач	true
character_skills_localised_description_mk_skill_assassin_eyes_ears	Він все бачить, все чує і нічого не пропускає.	true
character_skills_localised_name_att_skill_background_priest_accountant_roman	Нумерарій	true
character_skills_localised_name_mk_skill_back_natural_gift	Вроджений талант	true
character_skills_localised_description_mk_trad_navy_raiders	Успіх на морі не завжди пов'язаний з перемогою в битві.	true
character_skills_localised_description_att_trad_navy_barbarian_5_naval_conquerors	Одна назва цього флоту наводить жах на жителів усіх навколишніх берегів.	true
character_skills_localised_name_att_skill_background_spy_informant_barbarian	Подвійний агент	true
character_skills_localised_name_mk_skill_assassin_assassin	Асасин	true
character_skills_localised_name_att_skill_background_spy_spymaster_barbarian	Досвідчений підглядник	true
character_skills_localised_name_mk_trad_navy_boarders	Абордажна команда	true
character_skills_localised_description_cha_skill_assassin_back_master	Він вдосконалював свою майстерність все життя.	true
character_skills_localised_name_att_skill_background_priest_scholar_barbarian	Зберігач легенд	true
character_skills_localised_description_cha_skill_spy_back_conspirator	Підступність, хитрість і трохи обману.	true
character_skills_localised_description_att_skill_background_champion_scout_barbarian	Дорога попереду ховається в темряві. Я освітлю її.	true
character_skills_localised_description_att_skill_background_wife_barbarian_swordmaid	Ходімо, коханий. І пам'ятай, в чесному бою я зможу розрубати тебе навпіл.	true
character_skills_localised_description_att_skill_background_wife_civilised_political	Ні. Ні, друзі. Всі, хто зібрався за цим столом, можуть принести користь іншим. Це допоможе всім нам.	true
character_skills_localised_description_att_skill_background_champion_quartermaster_barbarian	Цей чоловік чудово розбирається у всьому, що стосується поставок і спорядження.	true
character_skills_localised_description_cha_trad_army_siege_experts	Якщо вам потрібно проломити ворожі стіни або утримати свої, довіртеся цим воїнам. Вони впораються.	true
character_skills_localised_description_mk_skill_general_back_melee	Стріли і дротики - для слабаків. Справжній воїн повинен відчувати запах поту свого ворога!	true
character_skills_localised_name_att_skill_background_general_handler_roman	Приборкувач	true
character_skills_localised_description_mk_skill_general_back_rider	Ця людина відчуває себе щасливою тільки в сідлі.	true
character_skills_localised_description_mk_skill_general_back_leader	Сміливість - не відсутність страху, а перемога над ним.	true
character_skills_localised_name_cha_skill_assassin_determined	Рішучий	true
character_skills_localised_name_mk_skill_priest_back_militant	Войовничий	true
character_skills_localised_name_att_general_skills_roman_3_vicarius	Вікарій	true
character_skills_localised_description_mk_skill_general_trainer	Обов'язок того, хто знає - просвіщати тих, хто не знає.	true
character_skills_localised_name_mk_skill_general_builder	Будівельник	true
character_skills_localised_description_att_skill_background_general_administrator_roman	Печатки цієї людини довіряють у всьому світі.	true
character_skills_localised_name_att_skill_background_champion_assassin_nomadic	Солдафон	true
character_skills_localised_name_att_agent_skills_champion_ruse	Хитрість	true
character_skills_localised_description_att_skill_background_champion_engineer_barbarian	Полководець бачить в облогових машинах зброю, а ця людина - витвори мистецтва.	true
character_skills_localised_name_att_general_skills_barbarian_3_stag	Олень	true
character_skills_localised_name_cha_trad_navy_bombardment	Обстріл	true
character_skills_localised_name_att_skill_background_spy_agriculture_barbarian	Скотар	true
character_skills_localised_description_att_skill_background_priest_benefactor_barbarian	Ця людина простежить, щоб миші не бешкетували навіть за відсутності кішки.	true
character_skills_localised_name_att_trad_army_barbarian_3_champions_north_slavs	Воїни Півночі	true
character_skills_localised_description_att_trad_navy_barbarian_3_dauntless_navigators	Море любить сміливих! Повний вперед!	true
character_skills_localised_description_cha_skill_general_back_landowner	Своїм становищем він зобов'язаний вірності васальній клятві.	true
character_skills_localised_description_att_skill_background_general_taskmaster_nomadic	Цю людину не вразити ні подвигом, ні старанністю.	true
character_skills_localised_description_cha_skill_spy_local_agents	Задіюючи потрібні зв'язки в потрібний момент, можна досягти багато чого.	true
character_skills_localised_name_cha_skill_back_watchman	Часовий	true
character_skills_localised_description_mk_skill_general_back_strategist	Він знає, коли слід нападати, коли захищатися, а коли - нещадно винищувати. Це називається «стратегія».	true
character_skills_localised_description_mk_skill_general_inspired_leader	Ну що, хто хоче жити вічно?	true
character_skills_localised_name_att_skill_background_priest_benefactor_eastern	Доглядач	true
character_skills_localised_description_cha_skill_assassin_fear	Я не підкоряюся нікому!	true
character_skills_localised_description_att_skill_background_general_supply_roman	Нагодувати людину легко. Нагодувати цілу армію - справжній подвиг.	true
character_skills_localised_name_att_skill_background_general_rider_roman	Прославлений вершник	true
character_skills_localised_name_att_agent_skills_spy_subterfuge	Хитрощі	true
character_skills_localised_description_cha_skill_assassin_thugs	Змусити інших працювати за тебе - теж мистецтво.	true
character_skills_localised_name_att_trad_army_eastern_4_savaran_regime	Шляхетна кіннота	true
character_skills_localised_description_att_trad_army_eastern_2_self_sufficiency_eos	Небо над головою і спис в руці. Що ще потрібно?	true
character_skills_localised_name_att_skill_background_priest_militarist_eastern	Мілітарист	true
character_skills_localised_name_att_general_skills_eastern_5_zhayedan	Елітний воїн	true
character_skills_localised_description_cha_trad_army_infantry_training	Навіть простий ремісник з належною підготовкою може захистити своє місто від ворожої армії.	true
character_skills_localised_description_att_skill_background_spy_hunter_eastern	Вони полюють, щоб самі не стати здобиччю...	true
character_skills_localised_name_cha_trad_army_cavalry_training	Знатний воєначальник	true
character_skills_localised_description_att_skill_background_champion_drillmaster_roman	Ти будеш слухати. Ти будеш вчитися. Або ти помреш.	true
character_skills_localised_description_att_general_skills_eastern_3_archer_commander	Не стріляйте, поки не побачите білки їхніх очей!	true
character_skills_localised_name_att_trad_army_eastern_2_self_sufficiency_eos	Самодостатність	true
character_skills_localised_description_att_skill_background_spy_informant_nomadic	Насправді ти працюєш на нас, але вони переконані, що ти працюєш на них? Як же у вас, шпигунів, все заплутано...	true
character_skills_localised_name_att_skill_background_champion_team_sports_eastern	Чемпіон з човгану	true
character_skills_localised_name_mk_trad_army_weak_spots	Вразливі місця	true
character_skills_localised_name_att_general_skills_eastern_2_overseer	Наглядач	true
character_skills_localised_name_mk_trad_army_infantry_training	Військова підготовка ополчення	true
character_skills_localised_description_cha_skill_assassin_back_extortion	У мого друга було п'ять пальців. Він користувався тільки трьома.	true
character_skills_localised_name_att_skill_background_general_taskmaster_eastern	Організатор	true
character_skills_localised_name_cha_skill_general_thinker	Мислитель	true
character_skills_localised_name_att_skill_background_priest_progressive_barbarian	Прогресивний	true
character_skills_localised_description_att_skill_background_general_melee_nomadic	Зброя - не інструмент, а продовження руки воїна.	true
character_skills_localised_description_att_skill_background_general_rider_nomadic	Є ті, хто сидить у сідлі, а є вершники.	true
character_skills_localised_description_att_skill_background_spy_hunter_barbarian	Вони полюють, щоб самі не стати здобиччю...	true
character_skills_localised_name_mk_skill_assassin_fear	Страх	true
character_skills_localised_name_cha_skill_assassin_thugs	Головорізи	true
character_skills_localised_description_mk_skill_spy_black_market	Те, чого не можна купити на ринку, завжди можна «дістати» іншими способами.	true
character_skills_localised_description_att_skill_background_general_strategist_barbarian	Кожна можливість врахована, для кожного подиху є пояснення.	true
character_skills_localised_name_att_skill_background_champion_standard_bearer_barbarian	Прапороносець	true
character_skills_localised_description_att_skill_background_wife_all_ambitious	Ні, кохана моя. Вони заважають твоїй кар'єрі з заздрості...	true
character_skills_localised_description_att_skill_background_wife_all_religious	Всі знаки сприятливі для тебе. Завжди. А все завдяки моїм молитвам.	true
character_skills_localised_description_att_trad_navy_roman_3_military_escorts	Охороняє цінний вантаж в дорозі.	true
character_skills_localised_description_att_skill_background_general_rider_roman	Є ті, хто сидить у сідлі, а є вершники.	true
character_skills_localised_description_att_trad_army_nomadic_2_extortion	У мого друга було п'ять пальців. Він користувався тільки трьома.	true
character_skills_localised_description_att_trad_navy_roman_5_interdictor_fleet	Відмінно. Перший улов за день.	true
character_skills_localised_name_mk_skill_general_inspired_leader	Натхненний ватажок	true
character_skills_localised_name_mk_skill_general_back_strategist	Стратег	true
character_skills_localised_name_att_general_skills_eastern_2_infantry_commander	Командир піхоти	true
character_skills_localised_description_att_general_skills_roman_3_overseer	Жодного недоліку, жодної дрібниці не вислизне від пильного погляду цієї людини.	true
character_skills_localised_name_att_skill_background_priest_strategy_gaming_roman	Гравець в латрункулі	true
character_skills_localised_name_cha_skill_priest_rhetoric	Риторика	true
character_skills_localised_name_cha_skill_general_back_landowner	Землевласник	true
character_skills_localised_description_att_skill_background_general_patron_roman	Це прекрасна базиліка. Так. Красива. Дайте десять.	true
character_skills_localised_name_att_skill_background_priest_accountant_nomadic	Скарбник	true
character_skills_localised_description_att_trad_army_nomadic_4_ruin_rome	Не кожен орел пролетить там, де пройдуть ці коні.	true
character_skills_localised_name_att_general_skills_nomadic_1_lightning	Блискавка	true
character_skills_localised_name_att_skill_background_priest_benefactor_barbarian	Економ	true
character_skills_localised_name_att_skill_background_spy_hunter_nomadic	Мисливець з луком	true
character_skills_localised_description_cha_skill_general_back_entrepeneur	Тягни себе хоч за ремінці сандалій. Встань назустріч дню і візьми своє.	true
character_skills_localised_description_mk_skill_general_tactician	Хороший тактик завжди думає на багато ходів вперед.	true
character_skills_localised_description_att_agent_skills_spy_military_infiltration	Жодні замки і замки не зупинять цього майстра маскування.	true
character_skills_localised_description_att_skill_background_general_administrator_eastern	Печатки цієї людини довіряють у всьому світі.	true
character_skills_localised_name_att_skill_background_champion_engineer_barbarian	Будівельник	true
character_skills_localised_description_mk_trad_navy_weak_spots	Ці воїни помічають і використовують будь-які вразливі місця.	true
character_skills_localised_description_mk_skill_general_builder	Цеглинка, ще цеглинка... Найвеличніші будівлі починаються з малого.	true
character_skills_localised_name_att_general_skills_eastern_1_shahrdar	Головний радник	true
character_skills_localised_name_att_skill_background_general_administrator_roman	Адміністратор	true
character_skills_localised_description_att_trad_navy_barbarian_5_scourge_seas	Побачивши ці вітрила, вороги розуміють, що приречені.	true
character_skills_localised_name_att_skill_background_champion_officer_barbarian	Ватажок загону	true
character_skills_localised_name_mk_skill_general_trainer	Вчитель	true
character_skills_localised_description_att_trad_army_nomadic_1_nomadic_horsemanship	Якщо тобі ніде оселитися, твій дім - в сідлі.	true
character_skills_localised_name_cha_skill_priest_practice	Тренування	true
character_skills_localised_name_cha_skill_priest_back_progressive	Прогресивний	true
character_skills_localised_description_mk_skill_assassin_terror	Ніхто не захищений. Всі люди - мішені...	true
character_skills_localised_name_mk_skill_assassin_thugs	Головорізи	true
character_skills_localised_description_att_trad_navy_eastern_4_ruin_rome	Кораблі римлян відправляться в безодню забуття слідом за їх імперією.	true
character_skills_localised_description_mk_skill_spy_back_rumours	Яким би тихим не був шепіт, його завжди хтось почує...	true
character_skills_localised_description_mk_skill_back_dice_roller	Стукіт кинутих кісток - найсолодша музика на світі!	true
character_skills_localised_name_att_skill_background_general_politician_nomadic	Одержимий владою	true
character_skills_localised_name_att_trad_army_barbarian_4_great_migrators	Велике переселення	true
character_skills_localised_name_att_general_skills_nomadic_4_warmaster	Провідник ратей	true
character_skills_localised_name_att_agent_skills_priest_mystery	Таємниця	true
character_skills_localised_description_cha_skill_spy_surveillance	Дивитися. Чекати. Бачити. А вже потім діяти.	true
character_skills_localised_name_att_skill_background_champion_drillmaster_nomadic	Провідник ратей	true
character_skills_localised_name_cha_trad_army_weak_spots	Вразливі місця	true
character_skills_localised_description_att_skill_background_general_strategist_nomadic	Кожна можливість врахована, для кожного подиху є пояснення.	true
character_skills_localised_description_att_skill_background_general_melee_roman	Зброя - не інструмент, а продовження руки воїна.	true
character_skills_localised_description_att_general_skills_barbarian_celts_bandit	Земля багата сама по собі, але ті, хто ходить її дорогами, ще багатші.	true
character_skills_localised_name_mk_trad_army_ferocious	Люті	true
character_skills_localised_name_mk_skill_priest_belief	Віра	true
character_skills_localised_description_att_trad_army_nomadic_3_nomadic_marksmanship	Кожна тятива дзвенить по-своєму.	true
character_skills_localised_description_cha_trad_navy_placed_shots	Розрахунок, точність, рішучість - ось три складові влучного пострілу.	true
character_skills_localised_description_cha_trad_army_placed_shots	Розрахунок, точність, рішучість - ось три складові влучного пострілу.	true
character_skills_localised_name_att_skill_background_spy_racketeer_roman	Екзактор	true
character_skills_localised_description_att_general_skills_barbarian_3_cavalry_commander	Пів ліги, пів ліги, пів ліги вперед!	true
character_skills_localised_name_att_skill_background_wife_all_faithful	Вірна	true
character_skills_localised_name_att_skill_background_wife_all_arrogant	Зарозуміла	true
character_skills_localised_name_cha_skill_assassin_misdirection	Введення в оману	true
character_skills_localised_description_mk_skill_general_back_taskmaster	Цю людину не вразити ні подвигом, ні старанністю.	true
character_skills_localised_name_att_agent_skills_spy_corruption	Корупція	true
character_skills_localised_description_att_skill_background_priest_progressive_nomadic	Якщо стояти на скелі занадто довго, тебе змиє хвиля.	true
character_skills_localised_name_att_general_skills_barbarian_2_infantry_commander	Командир піхоти	true
character_skills_localised_description_att_skill_background_spy_racketeer_nomadic	Я зроблю йому пропозицію, від якої неможливо відмовитися.	true
character_skills_localised_name_att_trad_army_eastern_4_guardians_royal_road	Прикордонна варта	true
character_skills_localised_name_att_skill_background_general_warrior_barbarian	Безстрашний воїн	true
character_skills_localised_name_att_skill_background_champion_martial_arts_roman	Знавець панкратіону	true
character_skills_localised_name_mk_skill_general_back_landowner	Землевласник	true
character_skills_localised_description_mk_skill_back_vengeance	Неприборкана жага помсти часом доводить його до втрати розуму...	true
character_skills_localised_description_att_trad_army_eastern_4_guardians_royal_road	Вже багато років кордони держави надійно охороняються. Ці люди стежать, щоб так було і надалі.	true
character_skills_localised_name_att_skill_background_general_entrepreneur_nomadic	Скарбник	true
character_skills_localised_description_att_general_skills_roman_2_sentinel	Я стою на сторожі свого народу!	true
character_skills_localised_name_cha_skill_general_back_politician	Політик	true
character_skills_localised_name_att_skill_background_spy_courier_roman	Вередарій	true
character_skills_localised_name_att_agent_skills_champion_intimidation	Залякування	true
character_skills_localised_name_att_skill_background_general_strategist_eastern	Майстер планування	true
character_skills_localised_description_att_skill_background_champion_martial_arts_roman	Так, мені потрібна хороша чесна бійка. Щоб ніяких ударів нижче пояса!	true
character_skills_localised_description_cha_skill_spy_misdirection	Кинута монетка, розбита ваза... Є багато способів відвернути чужі погляди.	true
character_skills_localised_name_att_general_skills_roman_4_vanguard	Завжди попереду	true
character_skills_localised_name_att_trad_army_nomadic_3_nomadic_marksmanship	Влучність кочівників	true
character_skills_localised_description_att_skill_background_spy_spymaster_nomadic	Він все бачить, все чує і нічого не пропускає.	true
character_skills_localised_name_mk_skill_general_back_taskmaster	Наглядач	true
character_skills_localised_name_att_skill_background_champion_engineer_eastern	Інженер	true
character_skills_localised_description_att_trad_army_barbarian_1_wardens_tribe	Вірна і надійна рука, що оберігає плем'я.	true
character_skills_localised_description_att_skill_background_spy_racketeer_roman	Я зроблю йому пропозицію, від якої неможливо відмовитися.	true
character_skills_localised_name_att_general_skills_barbarian_3_cavalry_commander	Командир кінноти	true
character_skills_localised_description_att_skill_background_general_politician_eastern	Якщо відкушувати потроху, можна з'їсти навіть кита.	true
character_skills_localised_description_att_general_skills_nomadic_3_archer_commander	Не стріляйте, поки не побачите білки їхніх очей!	true
character_skills_localised_name_att_general_skills_barbarian_1_wolf	Вовк	true
character_skills_localised_name_cha_trad_army_marksman_training	Влучні стрільці	true
character_skills_localised_name_att_skill_background_champion_team_sports_roman	Атлет	true
character_skills_localised_name_att_skill_background_general_melee_roman	Боєць	true
character_skills_localised_name_att_skill_background_spy_conspirator_barbarian	Змовник	true
character_skills_localised_description_cha_trad_army_weak_spots	Ці воїни помічають і використовують будь-які вразливі місця.	true
character_skills_localised_description_att_skill_background_priest_elder_eastern	Солодкі слова і гострий розум дають ідеальний смак мудрості.	true
character_skills_localised_description_cha_skill_priest_belief	Будьте насторожі. Будьте тверді у вірі. Будьте відважні. Будьте сильні.	true
character_skills_localised_description_cha_trad_army_ferocious	Виття, скрегіт зубів, слина на губах... Всі ознаки люті.	true
character_skills_localised_name_att_trad_army_nomadic_1_nomadic_horsemanship	Кіннота кочівників	true
character_skills_localised_name_att_skill_background_champion_war_hero_eastern	Герой війни	true
character_skills_localised_name_att_general_skills_eastern_3_elephant_commander	Командир бойових слонів	true
character_skills_localised_name_att_skill_background_champion_watchman_nomadic	Вартовий	true
character_skills_localised_name_att_skill_background_priest_progressive_eastern	Прогресивний	true
character_skills_localised_name_mk_skill_assassin_terror	Жах	true
character_skills_localised_name_att_trad_army_barbarian_3_champions_north	Воїни Півночі	true
character_skills_localised_name_att_skill_background_wife_civilised_unsuitable	Негідна	true
character_skills_localised_description_att_agent_skills_spy_civilian_infiltration	Вовк серед овець.	true
character_skills_localised_description_att_trad_army_eastern_1_persian_marksmanship	Я можу вбити тебе і з одного кроку, але з сорока цікавіше.	true
character_skills_localised_description_att_general_skills_roman_3_vicarius	Я відповідаю тільки перед однією людиною, і це - не ти.	true
character_skills_localised_description_att_skill_background_priest_spiritual_leader_roman	В ім'я Отця і Сина, і Святого Духа.	true
character_skills_localised_description_cha_skill_spy_back_rumours	Яким би тихим не був шепіт, його завжди хтось почує...	true
character_skills_localised_description_att_trad_army_barbarian_3_dreaded_reavers	Ми несемо спасіння через руйнування.	true
character_skills_localised_description_cha_skill_back_dice_roller	Стукіт кинутих кісток - найсолодша музика на світі!	true
character_skills_localised_description_att_skill_background_general_melee_eastern	Зброя - не інструмент, а продовження руки воїна.	true
character_skills_localised_description_att_skill_background_general_rider_eastern	Є ті, хто сидить у сідлі, а є вершники.	true
character_skills_localised_name_mk_skill_priest_practice	Тренування	true
character_skills_localised_description_att_skill_background_general_taskmaster_barbarian	Цю людину не вразити ні подвигом, ні старанністю.	true
character_skills_localised_name_cha_trad_navy_boarders	Абордажна команда	true
character_skills_localised_name_mk_skill_priest_back_progressive	Прогресивний	true
character_skills_localised_description_att_trad_navy_barbarian_2_seafaring_traditions	Ми вже сотні років ходимо цими морями. Солона вода у нас в крові.	true
character_skills_localised_description_att_general_skills_barbarian_3_stag	Величний і гордий герой, який не схиляється ні перед чим.	true
character_skills_localised_name_att_agent_skills_champion_personal_combat	Поєдинок	true
character_skills_localised_name_att_trad_army_eastern_5_keepers_fort	Охоронці форту	true
character_skills_localised_name_att_skill_background_champion_team_sports_nomadic	Учасник змагань	true
character_skills_localised_description_att_skill_background_spy_informant_eastern	Насправді ти працюєш на нас, але вони переконані, що ти працюєш на них? Як же у вас, шпигунів, все заплутано...	true
character_skills_localised_description_att_general_skills_roman_3_fleet_commander	Могутній флот і попутний вітер - ось все, що потрібно йому для щастя.	true
character_skills_localised_description_mk_skill_spy_surveillance	Дивитися. Чекати. Бачити. А вже потім діяти.	true
character_skills_localised_name_att_skill_background_wife_all_drunkard	П'яниця	true
character_skills_localised_description_att_trad_army_barbarian_3_champions_north_slavs	Ці сильні і стійкі воїни здобули славу в північних землях.	true
character_skills_localised_name_cha_skill_priest_back_militant	Войовничий	true
character_skills_localised_name_att_skill_background_general_taskmaster_nomadic	Організатор	true
character_skills_localised_description_cha_skill_back_vengeance	Неприборкана жага помсти часом доводить його до втрати розуму...	true
character_skills_localised_name_att_agent_skills_spy_surveillance	Стеження	true
character_skills_localised_description_mk_skill_spy_eyes_and_ears	Він все бачить, все чує і нічого не пропускає.	true
character_skills_localised_description_att_skill_background_general_administrator_nomadic	Печатки цієї людини довіряють у всьому світі.	true
character_skills_localised_name_att_general_skill_sands_tanukhid_elephant	Імперський угар	true
character_skills_localised_description_cha_skill_back_watchman	Він чекає і спостерігає, ретельно оцінюючи кожен крок...	true
character_skills_localised_name_cha_skill_assassin_fear	Страх	true
character_skills_localised_description_att_skill_background_priest_militarist_barbarian	Ну, думаю, що мир можливий, але ж можлива і війна!	true
character_skills_localised_name_att_skill_background_spy_builder_roman	Фабрикатор	true
character_skills_localised_name_att_trad_navy_eastern_1_persian_naval_heritage	Східні морські традиції	true
character_skills_localised_name_att_general_skills_nomadic_2_vanguard	Завжди попереду	true
character_skills_localised_description_att_agent_skills_spy_subterfuge	Займаючись брудними справами, важко не забруднити руки.	true
character_skills_localised_description_mk_trad_navy_placed_shots	Розрахунок, точність, рішучість - ось три складові влучного пострілу.	true
character_skills_localised_description_mk_trad_army_placed_shots	Розрахунок, точність, рішучість - ось три складові влучного пострілу.	true
character_skills_localised_description_att_skill_background_champion_elite_roman	Вірний слуга правителя заслуговує на найглибшу повагу.	true
character_skills_localised_name_att_trad_army_nomadic_3_unconventional_warfare	Нестандартні методи війни	true
character_skills_localised_description_att_skill_background_champion_marine_roman	Перемагати на суші, перемагати на морі. Перемога понад усе!	true
character_skills_localised_name_att_general_skills_roman_3_logistician	Логіст	true
character_skills_localised_name_att_skill_background_priest_accountant_eastern	Рахівник	true
character_skills_localised_description_mk_skill_general_back_politician	Щоб перемагати на полі бою, доводиться воювати і в рідних стінах.	true
character_skills_localised_name_att_skill_background_champion_war_hero_barbarian	Герой війни	true
character_skills_localised_description_att_skill_background_general_leader_roman	Сміливість - не відсутність страху, а перемога над ним.	true
character_skills_localised_name_att_skill_background_champion_watchman_barbarian	Вартовий	true
character_skills_localised_description_att_trad_army_eastern_3_ruin_rome	Марнославні завойовники впадуть біля ніг цих могутніх воїнів.	true
character_skills_localised_name_cha_trad_army_infantry_training	Військова підготовка ополчення	true
character_skills_localised_description_att_trad_army_nomadic_2_bane_east	Східна кіннота - ніщо перед незліченною ордою степових воїнів.	true
character_skills_localised_name_att_skill_background_spy_hunter_eastern	Царський лучник	true
character_skills_localised_name_att_skill_background_champion_drillmaster_roman	Кампідоктор	true
character_skills_localised_description_mk_skill_general_motivator	Я в вас вірю. Не вірте в себе, вірте в МЕНЕ, який вірить у вас!	true
character_skills_localised_description_mk_trad_army_weak_spots	Ці воїни помічають і використовують будь-які вразливі місця.	true
character_skills_localised_description_att_agent_skills_priest_damnation	У них є вибір: порятунок або кілок.	true
character_skills_localised_description_att_skill_background_general_taskmaster_eastern	Цю людину не вразити ні подвигом, ні старанністю.	true
character_skills_localised_name_att_trad_army_nomadic_4_terror	Терор	true
character_skills_localised_description_att_skill_background_champion_war_hero_barbarian	Ця людина живе війною. Його термін минув, його битви виграні, але він ще живий.	true
character_skills_localised_name_mk_skill_general_back_politician	Політик	true
character_skills_localised_description_att_skill_background_champion_watchman_barbarian	Він чекає. Це його справа.	true
character_skills_localised_name_cha_skill_general_back_taskmaster	Наглядач	true
character_skills_localised_description_mk_skill_priest_back_elder	Солодкі слова і гострий розум дають ідеальний смак мудрості.	true
character_skills_localised_name_cha_skill_priest_dogma	Догма	true
character_skills_localised_description_mk_skill_spy_misdirection	Кинута монетка, розбита ваза... Є багато способів відвернути чужі погляди.	true
character_skills_localised_name_mk_skill_back_watchman	Часовий	true
character_skills_localised_description_att_skill_background_champion_standard_bearer_barbarian	Він з гордістю несе прапор великої і переможної держави.	true
character_skills_localised_name_att_general_skills_nomadic_3_despoiler	Жадібний	true
character_skills_localised_name_att_skill_background_wife_all_ambitious	Честолюбна	true
character_skills_localised_name_att_skill_background_wife_all_religious	Побожна	true
character_skills_localised_name_att_trad_navy_roman_5_interdictor_fleet	Блокадний флот	true
character_skills_localised_name_att_skill_background_champion_assassin_eastern	Захисник	true
character_skills_localised_name_att_skill_background_priest_militarist_barbarian	Підпалювач війни	true
character_skills_localised_description_att_general_skills_eastern_2_infantry_commander	Він народжений, щоб крокувати попереду і вести інших за собою.	true
character_skills_localised_description_att_agent_skills_priest_pessimism	З кожним кроком ти трохи наближаєшся до неминучої смерті!	true
character_skills_localised_name_att_general_skills_roman_3_overseer	Наглядач	true
character_skills_localised_description_att_trad_army_eastern_5_keepers_fort	Імперії розпадуться на порох, світ охопить полум'я, але цей форт буде стояти з волі Господа!	true
character_skills_localised_name_att_agent_skills_spy_misdirection	Введення в оману	true
character_skills_localised_name_mk_skill_priest_pessimism	Песимізм	true
character_skills_localised_name_att_skill_background_general_scholar_barbarian	Мудрець	true
character_skills_localised_name_cha_skill_back_vengeance	Помста	true
character_skills_localised_name_att_skill_background_priest_militarist_nomadic	Підпалювач війни	true
character_skills_localised_name_cha_trad_army_supplies	Припаси	true
character_skills_localised_description_att_trad_navy_roman_1_mediterranean_seamanship	Вони не знають, що таке морська хвороба.	true
character_skills_localised_description_att_skill_background_champion_aide_camp_barbarian	Довгі роки ця людина пробивалася нагору, прагнучи до величі і надихаючи на це інших.	true
character_skills_localised_name_att_skill_background_wife_civilised_unfaithful	Невірна	true
character_skills_localised_description_att_skill_background_spy_hunter_nomadic	Вони полюють, щоб самі не стати здобиччю...	true
character_skills_localised_name_cha_skill_assassin_terror	Жах	true
character_skills_localised_name_mk_skill_priest_eyes_ears	Очі і вуха	true
character_skills_localised_name_att_trad_army_eastern_1_persian_marksmanship	Перська влучність	true
character_skills_localised_description_att_trad_army_barbarian_2_hunters	Не шуми. Візьми лук. Видихни. Стріляй.	true
character_skills_localised_name_att_agent_skills_champion_sapping	Пошкодження стін	true
character_skills_localised_name_mk_skill_priest_damnation	Прокляття	true
character_skills_localised_name_mk_trad_navy_weak_spots	Вразливі місця	true
character_skills_localised_name_att_skill_background_spy_artisan_roman	Артиціан	true
character_skills_localised_name_att_skill_background_priest_benefactor_nomadic	Економ	true
character_skills_localised_name_att_skill_background_wife_barbarian_shieldmaid	Діва-воїн	true
character_skills_localised_description_mk_skill_priest_back_progressive	Якщо стояти на скелі занадто довго, тебе змиє хвиля.	true
character_skills_localised_description_att_skill_background_champion_officer_barbarian	Ватажки. Воїни. Вкриті кров'ю, війною і славою.	true
character_skills_localised_description_mk_skill_priest_practice	Кажуть, щоб опанувати якусь справу, треба витратити 10 000 годин. Тож не гай часу!	true
character_skills_localised_name_cha_skill_general_builder	Будівельник	true
character_skills_localised_description_att_skill_background_spy_spymaster_eastern	Він все бачить, все чує і нічого не пропускає.	true
character_skills_localised_description_mk_skill_assassin_thugs	Змусити інших працювати за тебе - теж мистецтво.	true
character_skills_localised_name_att_general_skills_nomadic_3_warchief	Бойовий вождь	true
character_skills_localised_description_att_trad_army_roman_5_palatini	На сторожі Риму і його правителя!	true
character_skills_localised_description_att_skill_background_general_politician_nomadic	Якщо відкушувати потроху, можна з'їсти навіть кита.	true
character_skills_localised_description_att_skill_background_general_landowner_barbarian	Ах, як же добре володіти землею.	true
character_skills_localised_description_att_agent_skills_priest_mystery	Головоломка, оточена загадками і прихована за завісою таємниці.	true
character_skills_localised_name_att_skill_background_champion_engineer_nomadic	Будівельник	true
character_skills_localised_name_att_skill_background_general_entrepreneur_eastern	Магнат	true
character_skills_localised_name_att_skill_background_champion_horse_vet_barbarian	Конюх	true
character_skills_localised_name_mk_trad_navy_bombardment	Обстріл	true
character_skills_localised_name_mk_trad_army_marksman_training	Влучні стрільці	true
character_skills_localised_name_att_skill_background_general_strategist_nomadic	Майстер планування	true
character_skills_localised_description_mk_skill_priest_rhetoric	Слова мають силу. Вони дозволяють сенсу набути плоті.	true
character_skills_localised_description_att_skill_background_champion_assassin_barbarian	Я стану твоїм захисником.	true
character_skills_localised_description_mk_skill_general_commander	За мною, бійці! Я приведу вас до вічної слави!	true
character_skills_localised_name_att_trad_army_eastern_2_conscription	Призов новобранців	true
character_skills_localised_name_att_skill_background_priest_advisor_roman	Консиліарій	true
character_skills_localised_name_att_agent_skills_champion_tactics	Тактика	true
character_skills_localised_name_cha_trad_navy_weak_spots	Вразливі місця	true
character_skills_localised_name_att_skill_background_wife_all_poisoner	Отруйниця	true
character_skills_localised_description_cha_skill_assassin_misdirection	Кинута монетка, розбита ваза... Є багато способів відвернути чужі погляди.	true
character_skills_localised_description_mk_skill_general_thinker	Гострий розум настільки ж корисний, як і гострий меч.	true
character_skills_localised_name_att_skill_background_champion_war_hero_nomadic	Герой війни	true
character_skills_localised_description_mk_skill_spy_local_agents	Задіюючи потрібні зв'язки в потрібний момент, можна досягти багато чого.	true
character_skills_localised_name_att_general_skills_roman_5_vir_illustris	Просвічений чоловік	true
character_skills_localised_description_att_trad_army_roman_5_defenders_virtue	Поклик честі вимагає сатисфакції. І ми її отримаємо.	true
character_skills_localised_description_att_agent_skills_spy_corruption	Мені - все, іншим - нічого.	true
character_skills_localised_name_att_skill_background_priest_progressive_nomadic	Прогресивний	true
character_skills_localised_name_att_skill_background_champion_watchman_eastern	Часовий	true
character_skills_localised_description_att_skill_background_priest_accountant_barbarian	Людина, яка вміє рахувати, високо цінується в будь-якій армії.	true
character_skills_localised_name_att_trad_army_nomadic_3_defenders_camp	Захисники табору	true
character_skills_localised_name_mk_skill_back_vengeance	Помста	true
character_skills_localised_description_mk_skill_general_back_landowner	Своїм становищем він зобов'язаний вірності васальній клятві.	true
character_skills_localised_description_att_skill_background_spy_informant_roman	Насправді ти працюєш на нас, але вони переконані, що ти працюєш на них? Як же у вас, шпигунів, все заплутано...	true
character_skills_localised_description_att_skill_background_priest_elder_nomadic	Солодкі слова і гострий розум дають ідеальний смак мудрості.	true
character_skills_localised_description_att_skill_background_spy_spymaster_roman	Він все бачить, все чує і нічого не пропускає.	true
character_skills_localised_description_att_skill_background_champion_medic_roman	Лікар, вилікуй себе сам!	true
character_skills_localised_name_att_general_skills_roman_2_sentinel	Вартовий	true
character_skills_localised_name_att_skill_background_priest_scholar_roman	Вчений	true
character_skills_localised_name_att_skill_background_champion_drillmaster_eastern	Солдафон	true
character_skills_localised_name_att_general_skills_roman_2_dux	Вождь	true
character_skills_localised_name_att_skill_background_spy_informant_roman	Продитор	true
character_skills_localised_name_att_skill_background_spy_spymaster_roman	Агенс ін ребус	true
character_skills_localised_description_att_agent_skills_priest_prejudice	Підступний і жорстокий демон повинен бути проклятий і знищений.	true
character_skills_localised_description_att_skill_background_general_strategist_eastern	Кожна можливість врахована, для кожного подиху є пояснення.	true
character_skills_localised_name_att_skill_background_priest_accountant_barbarian	Камерарій	true
character_skills_localised_name_att_skill_background_wife_civilised_protective	Перестраховщиця	true
character_skills_localised_description_att_general_skills_roman_4_vanguard	Шукайте цю людину серед воїнів, що б'ються на вістрі атаки.	true
character_skills_localised_name_cha_skill_general_back_strategist	Стратег	true
character_skills_localised_name_cha_skill_general_inspired_leader	Натхненний ватажок	true
character_skills_localised_description_cha_skill_spy_black_market	Те, чого не можна купити на ринку, завжди можна «дістати» іншими способами.	true
character_skills_localised_description_att_trad_army_eastern_2_conscription	Імперія вимагає від тебе битися, а не думати.	true
character_skills_localised_name_att_skill_background_wife_all_intelligent	Розумна	true
character_skills_localised_description_att_general_skills_roman_5_vir_illustris	Та ти знаєш, хто я?!	true
character_skills_localised_name_att_skill_background_general_handler_barbarian	Наставник	true
character_skills_localised_name_mk_skill_assassin_misdirection	Введення в оману	true
character_skills_localised_name_mk_skill_general_thinker	Мислитель	true
character_skills_localised_description_att_skill_background_champion_scout_roman	Дорога попереду ховається в темряві. Я освітлю її.	true
character_skills_localised_name_att_trad_army_barbarian_1_wardens_tribe	Вартові племені	true
character_skills_localised_name_att_skill_background_general_politician_eastern	Політикан	true
character_skills_localised_description_cha_trad_navy_weak_spots	Ці воїни помічають і використовують будь-які вразливі місця.	true
character_skills_localised_description_att_skill_background_champion_quartermaster_roman	Ця людина чудово розбирається у всьому, що стосується поставок і спорядження.	true
character_skills_localised_description_att_skill_background_wife_barbarian_superstitious	Я наклала на твоїх ворогів страшне прокляття, чоловіче мій.	true
character_skills_localised_description_cha_trad_army_block_parry	Блок продовжує життя, а парирування дає шанс на перемогу.	true
character_skills_localised_description_att_general_skills_barbarian_1_wolf	Він переслідує ворогів всюди, приваблений запахом жертви і смаком крові.	true
character_skills_localised_description_att_skill_background_spy_racketeer_eastern	Я зроблю йому пропозицію, від якої неможливо відмовитися.	true
character_skills_localised_name_att_skill_background_champion_assassin_barbarian	Солдафон	true
character_skills_localised_description_cha_trad_army_marksman_training	Ти можеш перемогти шістьох. Ми навчимо тебе, як перемогти шість сотень.	true
character_skills_localised_description_att_skill_background_champion_team_sports_roman	Швидше. Вище. Сильніше.	true
character_skills_localised_name_mk_skill_priest_rhetoric	Риторика	true
character_skills_localised_name_cha_skill_priest_belief	Віра	true
character_skills_localised_name_cha_trad_army_ferocious	Люті	true
character_skills_localised_description_mk_trad_navy_bombardment	Шквал вогню, подібний до гніву небес, карає всіх негідних.	true
character_skills_localised_name_cha_skill_general_trainer	Вчитель	true
character_skills_localised_name_mk_skill_priest_prejudice	Упередженість	true
character_skills_localised_description_mk_skill_general_back_entrepeneur	Тягни себе хоч за ремінці сандалій. Встань назустріч дню і візьми своє.	true
character_skills_localised_name_att_skill_background_general_landowner_barbarian	Володар	true
character_skills_localised_name_att_general_skills_nomadic_4_overlord	Повелитель	true
character_skills_localised_description_att_skill_background_general_politician_barbarian	Якщо відкушувати потроху, можна з'їсти навіть кита.	true
character_skills_localised_description_att_skill_background_priest_progressive_eastern	Якщо стояти на скелі занадто довго, тебе змиє хвиля.	true
character_skills_localised_description_att_general_skills_eastern_3_elephant_commander	В бій, мої красені! Топчіть і трощіть ворогів!	true
character_skills_localised_name_att_trad_navy_eastern_3_pirate_hunters	Мисливці на піратів	true
character_skills_localised_name_att_trad_army_nomadic_4_steppe_warfare	Степові військові звичаї	true
character_skills_localised_name_mk_skill_spy_misdirection	Введення в оману	true
character_skills_localised_description_att_skill_background_spy_agriculture_roman	Деякі тварини рівніші за інших.	true
character_skills_localised_name_att_agent_skills_priest_pessimism	Песимізм	true
character_skills_localised_name_cha_trad_navy_navigation	Навігація	true
character_skills_localised_description_cha_skill_general_back_taskmaster	Цю людину не вразити ні подвигом, ні старанністю.	true
character_skills_localised_description_att_trad_army_roman_3_bane_east	Спадкоємці парфянської могутності впадуть перед нами!	true
character_skills_localised_description_mk_trad_navy_seamanship	Цим морякам не страшні ніякі шторми і шквали.	true
character_skills_localised_name_mk_skill_spy_subterfuge	Хитрощі	true
character_skills_localised_description_att_trad_army_roman_2_civil_duty	Кожна людина повинна служити благу своєї держави.	true
character_skills_localised_name_att_agent_skills_priest_damnation	Прокляття	true
character_skills_localised_description_att_trad_army_nomadic_5_royal_host	На чолі могутньої і грізної орди стоїть всього одна людина. Всі воїни підкоряються йому.	true
character_skills_localised_description_cha_skill_general_back_merchant	Його не хвилює батьківщина, дружба або віра. Для нього важливі тільки гроші.	true
character_skills_localised_name_att_skill_background_spy_artisan_eastern	Хутокш	true
character_skills_localised_name_att_general_skills_eastern_4_strategist	Стратег	true
character_skills_localised_name_att_trad_army_eastern_5_army_immortals	Військова еліта	true
character_skills_localised_name_cha_skill_general_back_warrior	Воїн	true
character_skills_localised_name_att_agent_skills_spy_observation	Спостереження	true
character_skills_localised_name_att_skill_background_general_landowner_nomadic	Пастух	true
character_skills_localised_name_mk_skill_spy_determined	Рішучий	true
character_skills_localised_description_cha_skill_assassin_terror	Ніхто не захищений. Всі люди - мішені.	true
character_skills_localised_name_mk_skill_general_zealot	Фанатик	true
character_skills_localised_description_mk_skill_priest_eyes_ears	Він все бачить, все чує і нічого не пропускає.	true
character_skills_localised_name_att_skill_background_spy_builder_eastern	Будівельник	true
character_skills_localised_name_att_trad_army_barbarian_3_nomad_hunters	Кочові мисливці	true
character_skills_localised_description_att_skill_background_general_merchant_barbarian	Його не хвилює батьківщина, дружба чи віра. Для нього важливі тільки гроші.	true
character_skills_localised_name_att_trad_army_barbarian_2_hunters	Мисливці	true
character_skills_localised_name_att_trad_army_roman_1_limatinei	Лімітани	true
character_skills_localised_description_att_skill_background_priest_radical_barbarian_barbarian	Відсутність змін - це застій. Застій - це ворог.	true
character_skills_localised_description_mk_skill_priest_damnation	У них є вибір: порятунок або кілок.	true
character_skills_localised_description_att_agent_skills_champion_sapping	Ця людина точно знає, що під будь-якою стіною можна вирити підкоп.	true
character_skills_localised_name_att_skill_background_champion_horse_vet_nomadic	Коновал	true
character_skills_localised_name_att_trad_army_roman_3_comitatenses	Комітати	true
character_skills_localised_name_att_trad_army_roman_4_military_engineering	Інженерна справа	true
character_skills_localised_description_att_agent_skills_priest_imposition	Вибачте, можна до вас звернутися?..	true
character_skills_localised_name_att_skill_background_champion_aide_camp_barbarian	Військовий радник	true
character_skills_localised_name_cha_skill_assassin_opportunism	Опортунізм	true
character_skills_localised_description_att_agent_skills_spy_misdirection	Кинута монетка, розбита ваза... Є багато способів відвернути чужі погляди.	true
character_skills_localised_description_mk_skill_priest_pessimism	Кожна мить наближає людину до неминучої загибелі!	true
character_skills_localised_description_bel_trad_navy_roman_2_defending	Якщо ти можеш утримати рівновагу, коли всі навколо її втрачають...	true
character_skills_localised_name_att_agent_skills_priest_rhetoric	Риторика	true
character_skills_localised_name_att_general_skills_eastern_3_cavalry_commander	Командир кінноти	true
character_skills_localised_name_mk_skill_spy_surveillance	Стеження	true
character_skills_localised_description_mk_skill_priest_back_strategist	Перемоги він приписує собі, а про поразки мовчить. У цьому його стратегія.	true
character_skills_localised_name_att_skill_background_priest_scribe_barbarian_barbarian	Писар	true
character_skills_localised_description_att_agent_skills_priest_rhetoric	Слова мають силу. Вони дозволяють сенсу набути плоті.	true
character_skills_localised_name_cha_skill_spy_back_mole	Кріт	true
character_skills_localised_description_att_agent_skills_champion_personal_combat	Ми зійдемося в рукопашній, а потім я зламаю тобі хребет.	true
character_skills_localised_description_att_skill_background_champion_team_sports_nomadic	Швидше. Вище. Сильніше.	true
character_skills_localised_name_att_skill_background_general_taskmaster_barbarian	Організатор	true
character_skills_localised_description_mk_skill_assassin_practice	Кажуть, щоб опанувати якусь справу, треба витратити 10 000 годин. Тож не гай часу!	true
character_skills_localised_description_mk_skill_general_legend	Ця людина увійшла в історію. Історія стала легендою. Легенда стає міфом.	true
character_skills_localised_name_att_agent_skills_spy_diversion	Відволікання	true
character_skills_localised_name_att_trad_army_barbarian_3_dreaded_reavers	Грізні руйнівники	true
character_skills_localised_description_att_skill_background_spy_builder_eastern	Цеглинка, ще цеглинка... Найвеличніші будівлі починаються з малого.	true
character_skills_localised_description_att_skill_background_general_attacker_barbarian	Цей войовничий догматик не зупиниться, поки не знищить усіх своїх ворогів.	true
character_skills_localised_description_att_agent_skills_spy_observation	Варта змінюється двічі на день. Перерва - п'ять хвилин. Ось тоді я і вдарю!	true
character_skills_localised_name_att_skill_background_general_leader_roman	Вождь	true
character_skills_localised_name_att_trad_army_eastern_3_ruin_rome	Руйнівники Риму	true
character_skills_localised_name_att_trad_army_nomadic_2_bane_east	Гроза Сходу	true
character_skills_localised_description_att_skill_background_priest_public_speaker_eastern	Друзі, брати, співвітчизники! Слухайте мене!	true
character_skills_localised_description_att_skill_background_wife_all_great_beauty	У потворному світі благословенна будь-яка краса.	true
character_skills_localised_description_att_skill_background_champion_martial_arts_eastern	Так, мені потрібна хороша чесна бійка. Щоб ніяких ударів нижче пояса!	true
character_skills_localised_name_mk_skill_general_back_merchant	Купець	true
character_skills_localised_description_att_skill_background_spy_artisan_eastern	Мої руки - ось мої знаряддя. Ними я створюю прекрасні і чудові речі.	true
character_skills_localised_description_att_skill_background_wife_civilised_social_climber	Приходиш до них і починаєш говорити люб'язності його дружині. Ти зрозумів? Завоюй їхню довіру!	true
character_skills_localised_description_att_trad_army_nomadic_2_foreign_contingent	Ці воїни прийшли з чужих земель, але б'ються не гірше за нас.	true
character_skills_localised_description_att_general_skills_nomadic_2_vanguard	Він завжди попереду, з мечем у руці і бойовим кличем на устах.	true
character_skills_localised_name_mk_trad_navy_placed_shots	Точний приціл	true
character_skills_localised_name_mk_trad_army_placed_shots	Точний приціл	true
character_skills_localised_name_att_skill_background_champion_elite_roman	Доместик	true
character_skills_localised_description_att_skill_background_wife_all_harridan_nag	Моя матінка завжди казала, що я занадто хороша для тебе. Бідна...	true
character_skills_localised_description_att_trad_navy_eastern_4_naval_marksmanship	Уміння влучно стріляти, стоячи на хиткій палубі, справді безцінне.	true
character_skills_localised_description_att_agent_skills_spy_surveillance	Дивитися. Чекати. Бачити. А вже потім діяти.	true
character_skills_localised_name_att_trad_army_roman_2_civil_duty	Громадянський обов'язок	true
character_skills_localised_description_mk_skill_priest_justice	Перед людьми і всім святим оголошую тебе винним!	true
character_skills_localised_description_att_general_skill_sands_tanukhid_elephant	Надійність цієї стійкої, непохитної і вірної людини не підлягає сумніву.	true
character_skills_localised_description_att_skill_background_champion_horse_vet_eastern	Відкрий рот і скажи: "Іго-го!"	true
character_skills_localised_description_bel_trad_navy_roman_4_attacking	Раптовість - половина перемоги. Спритність - друга половина.	true
character_skills_localised_name_cha_skill_spy_smuggler	Контрабандист	true
character_skills_localised_description_cha_trad_navy_navigation	Прямий шлях не завжди найвигідніший.	true
character_skills_localised_description_mk_skill_priest_conviction	Побач же своє злодіяння, занурений у гріх!	true
character_skills_localised_description_mk_skill_assassin_training	Дисципліна, сила, майстерність. У сумі вони дають перемогу.	true
character_skills_localised_description_att_skill_background_priest_scribe_eastern_eastern	Ці літери незрозумілі більшості, але в них прихована історія всього світу.	true
character_skills_localised_description_att_skill_background_priest_scribe_nomadic_nomadic	Ці літери незрозумілі більшості, але в них прихована історія всього світу.	true
character_skills_localised_name_att_skill_background_champion_scout_roman	Дослідник	true
character_skills_localised_name_cha_trad_army_block_parry	Блок і парирування	true
character_skills_localised_name_att_skill_background_champion_quartermaster_roman	Армікуст	true
character_skills_localised_name_att_skill_background_wife_barbarian_superstitious	Забобонна	true
character_skills_localised_description_cha_skill_general_back_strategist	Він знає, коли слід нападати, коли захищатися, а коли - нещадно винищувати. Це називається «стратегія».	true
character_skills_localised_description_cha_skill_general_inspired_leader	Ну що, хто хоче жити вічно?	true
character_skills_localised_description_att_skill_background_wife_all_intelligent	Це ще можна зробити перевагою. Дай подумаю...	true
character_skills_localised_description_cha_skill_general_zealot	Ця людина бачить тільки мету. У прагненні до неї вона буде використовувати будь-які засоби.	true
character_skills_localised_description_att_skill_background_wife_civilised_spendthrift	Про що ти? Звичайно, це твої гроші. Ти головний, а як інакше?!	true
character_skills_localised_description_cha_skill_spy_determined	Боротися і шукати, знайти і не здаватися!	true
character_skills_localised_name_att_agent_skills_priest_prejudice	Упередженість	true
character_skills_localised_description_att_general_skills_barbarian_3_despoiler	Ні п'яді землі, ні акра власності не сховається від його жадібного погляду.	true
character_skills_localised_name_mk_skill_general_back_marksman	Влучний стрілець	true
character_skills_localised_name_att_skill_background_champion_aide_camp_eastern	Довірена особа	true
character_skills_localised_description_att_skill_background_champion_drillmaster_eastern	Ти будеш слухати. Ти будеш вчитися. Або ти помреш.	true
character_skills_localised_description_att_skill_background_priest_scholar_roman	Стій і послухай.	true
character_skills_localised_description_att_agent_skills_spy_opportunism	Кіт з дому - миші йдуть вбивати.	true
character_skills_localised_name_att_skill_background_general_marksman_barbarian	Влучний стрілець	true
character_skills_localised_name_mk_skill_assassin_back_extortion	Вимагання	true
character_skills_localised_name_mk_skill_general_back_entrepeneur	Підприємець	true
character_skills_localised_description_att_general_skills_nomadic_4_overlord	Він не тільки вміє, але й любить командувати. Ця посада йому підходить.	true
character_skills_localised_name_att_skill_background_general_politician_barbarian	Одержимий владою	true
character_skills_localised_description_att_skill_background_general_warrior_roman	Я не підкоряюся нікому!	true
character_skills_localised_description_cha_skill_general_trainer	Обов'язок того, хто знає - просвіщати тих, хто не знає.	true
character_skills_localised_description_att_skill_background_spy_courier_nomadic	Швидкі ноги і добре підвішений язик.	true
character_skills_localised_description_cha_skill_spy_subterfuge	Займаючись брудними справами, важко не забруднити руки.	true
character_skills_localised_description_mk_skill_priest_prejudice	Все протиприродне, зле і демонічне підлягає викоріненню!	true
character_skills_localised_name_att_trad_army_barbarian_5_furor_barbaricus	Варварська лютість	true
character_skills_localised_name_mk_skill_general_back_attacker	Атакуючий	true
character_skills_localised_description_att_trad_navy_barbarian_4_ship_warriors	Ці люди несуть хаос і смерть на палуби ворожих кораблів.	true
character_skills_localised_name_att_trad_navy_roman_4_destroyers	Спустошувачі	true
character_skills_localised_description_att_skill_background_general_entrepreneur_roman	Якщо ця людина вважає щось важливим, з нею погоджується весь світ.	true
character_skills_localised_description_att_trad_navy_eastern_3_merchant_allies	Гроші сильніші за будь-який меч.	true
character_skills_localised_description_att_skill_background_general_entrepreneur_eastern	Якщо ця людина вважає щось важливим, з нею погоджується весь світ.	true
character_skills_localised_description_cha_skill_general_back_attacker	Вона не хоче знати нічого, крім нескінченних атак і постійного натиску.	true
character_skills_localised_description_att_skill_background_champion_aide_camp_nomadic	Довгі роки ця людина пробивалася нагору, прагнучи до величі і надихаючи на це інших.	true
character_skills_localised_description_att_trad_navy_roman_4_destroyers	Ми непереможні. Відправимо їх рибам на корм!	true
character_skills_localised_name_att_trad_army_roman_1_logistics	Логістика	true
character_skills_localised_description_att_skill_background_champion_horse_vet_barbarian	Відкрий рот і скажи: "Іго-го!"	true
character_skills_localised_name_att_skill_background_priest_radical_roman_roman	Радикальний	true
character_skills_localised_description_att_skill_background_spy_mole_barbarian	Людина, яка опинилася в потрібному місці і почула потрібні слова, цінніша за тисячі мечів.	true
character_skills_localised_description_att_general_skills_nomadic_3_warchief	Війна б'ється в серці цієї людини і веде її до величі.	true
character_skills_localised_description_att_skill_background_spy_courier_barbarian	Швидкі ноги і добре підвішений язик.	true
character_skills_localised_description_mk_skill_assassin_coercion	Який сенс у посланні, якщо ти не можеш говорити?	true
character_skills_localised_name_cha_skill_spy_subterfuge	Хитрощі	true
character_skills_localised_description_cha_skill_general_builder	Цеглинка, ще цеглинка... Найвеличніші будівлі починаються з малого.	true
character_skills_localised_name_att_skill_background_spy_courier_nomadic	Гінець	true
character_skills_localised_name_mk_trad_navy_navigation	Навігація	true
character_skills_localised_description_att_skill_background_general_defender_barbarian	Об цю неприступну стіну розбилося безліч ворогів.	true
character_skills_localised_name_cha_skill_general_back_scholar	Вчений	true
character_skills_localised_name_att_general_skills_barbarian_3_fleet_commander	Командир флоту	true
character_skills_localised_name_att_skill_background_priest_elder_nomadic	Старійшина	true
character_skills_localised_name_att_skill_background_champion_medic_roman	Медик	true
character_skills_localised_name_cha_skill_general_back_defender	Захисник	true
character_skills_localised_description_mk_skill_assassin_back_extortion	У мого друга було п'ять пальців. Він користувався тільки трьома.	true
character_skills_localised_description_cha_skill_general_back_marksman	Його постріли завжди досягають мети - всупереч вогню, вітру і навіть самій смерті.	true
character_skills_localised_name_att_agent_skills_spy_opportunism	Опортунізм	true
character_skills_localised_description_att_agent_skills_champion_glory	Вони покриють себе кров'ю, славою і, врешті-решт, перемогою.	true
character_skills_localised_name_att_general_skills_barbarian_3_despoiler	Жадібний	true
character_skills_localised_name_att_trad_navy_barbarian_3_cuthroat_raiders	Нальотники-головорізи	true
character_skills_localised_name_mk_skill_spy_local_agents	Місцеві агенти	true
character_skills_localised_description_att_skill_background_spy_conspirator_roman	Підступність, хитрість і трохи обману.	true
character_skills_localised_name_cha_skill_general_zealot	Фанатик	true
character_skills_localised_name_cha_skill_spy_determined	Рішучий	true
character_skills_localised_description_att_trad_navy_roman_2_bane_east	Східні флоти прекрасні, але вони справедливо побоюються могутності Риму.	true
character_skills_localised_description_att_skill_background_priest_advisor_roman	Ця людина побудує все, що забажає його пан.	true
character_skills_localised_name_att_skill_background_priest_elder_roman	Сенатор	true
character_skills_localised_description_att_agent_skills_champion_tactics	У цієї проблеми є два рішення: правильне і не дуже...	true
character_skills_localised_name_att_skill_background_spy_hunter_barbarian	Мисливець	true
character_skills_localised_name_att_skill_background_general_strategist_barbarian	Майстер планування	true
character_skills_localised_name_mk_skill_spy_black_market	Чорний ринок	true
character_skills_localised_name_att_trad_army_nomadic_2_extortion	Вимагання	true
character_skills_localised_name_mk_trad_navy_seamanship	Мореплавство	true
character_skills_localised_description_cha_skill_general_thinker	Гострий розум настільки ж корисний, як і гострий меч.	true
character_skills_localised_name_att_trad_army_roman_3_bane_east	Гроза Сходу	true
character_skills_localised_name_mk_trad_army_block_parry	Блок і парирування	true
character_skills_localised_description_mk_skill_spy_subterfuge	Займаючись брудними справами, важко не забруднити руки.	true
character_skills_localised_description_att_skill_background_priest_progressive_barbarian	Якщо стояти на скелі занадто довго, тебе змиє хвиля.	true
character_skills_localised_description_att_skill_background_spy_builder_nomadic	Цеглинка, ще цеглинка... Найвеличніші будівлі починаються з малого.	true
character_skills_localised_description_att_general_skills_eastern_3_logistician	Завдяки його турботі воїни завжди ситі і одягнені в обладунки.	true
character_skills_localised_description_att_general_skills_eastern_2_overseer	Він завжди здатний побачити картину в цілому і зрозуміти її.	true
character_skills_localised_description_mk_trad_army_dread	Серце будь-якого ворога, який побачив цих воїнів, стискають крижані пазурі страху.	true
character_skills_localised_description_mk_trad_army_loyal	Жоден з них ніколи не підніме бунт. Вони підуть за полководцем назустріч смерті і славі.	true
character_skills_localised_description_att_general_skills_eastern_4_judge	Справедливий суддя, що користується величезним авторитетом.	true
character_skills_localised_name_cha_skill_assassin_back_extortion	Вимагання	true
character_skills_localised_name_cha_skill_general_back_merchant	Купець	true
character_skills_localised_name_att_general_skills_eastern_3_archer_commander	Командир лучників	true
character_skills_localised_description_att_general_skills_eastern_4_strategist	Він знає, коли слід нападати, коли захищатися, а коли - нещадно винищувати. Це називається «стратегія».	true
character_skills_localised_name_att_skill_background_priest_spiritual_leader_barbarian	Духовний лідер	true
character_skills_localised_description_att_skill_background_champion_team_sports_eastern	Швидше. Вище. Сильніше.	true
character_skills_localised_description_att_general_skills_eastern_1_shahrdar	У жилах цієї благородної і владної людини тече царська кров.	true
character_skills_localised_description_cha_skill_priest_prejudice	Все протиприродне, зле і демонічне підлягає викоріненню!	true
character_skills_localised_description_att_skill_background_priest_public_speaker_roman	Друзі, брати, римляни! Слухайте мене!	true
character_skills_localised_description_mk_skill_spy_determined	Боротися і шукати, знайти і не здаватися!	true
character_skills_localised_description_mk_skill_general_zealot	Ця людина бачить тільки мету. У прагненні до неї вона буде використовувати будь-які засоби.	true
character_skills_localised_name_att_skill_background_general_merchant_barbarian	Купець	true
character_skills_localised_description_att_trad_army_barbarian_3_nomad_hunters	Стадо скачучих поні, нічого більше.	true
character_skills_localised_name_att_skill_background_wife_roman_decorous	Благопристойна	true
character_skills_localised_name_att_skill_background_champion_marine_barbarian	Мореплавець	true
character_skills_localised_name_att_skill_background_priest_radical_barbarian_barbarian	Радикальний	true
character_skills_localised_name_cha_skill_spy_sabotage	Диверсія	true
character_skills_localised_description_att_trad_army_roman_1_limatinei	Кожна людина прагне захищати свій дім. Для деяких це стає обов'язком.	true
character_skills_localised_name_att_skill_background_wife_civilised_mean	Скупа	true
character_skills_localised_description_att_skill_background_champion_horse_vet_nomadic	Відкрий рот і скажи: "Іго-го!"	true
character_skills_localised_name_att_trad_navy_barbarian_1_naval_expedition	Морська експедиція	true
character_skills_localised_name_att_skill_background_general_patron_roman	Патрон	true
character_skills_localised_name_att_trad_army_nomadic_4_ruin_rome	Руйнівники Риму	true
character_skills_localised_description_att_agent_skills_priest_conviction	Побач же своє злодіяння, занурений у гріх!	true
character_skills_localised_description_att_skill_background_champion_martial_arts_nomadic	Так, мені потрібна хороша чесна бійка. Щоб ніяких ударів нижче пояса!	true
character_skills_localised_description_att_skill_background_spy_builder_barbarian	Цеглинка, ще цеглинка... Найвеличніші будівлі починаються з малого.	true
character_skills_localised_description_att_skill_background_priest_public_speaker_nomadic	Друзі, брати, співвітчизники! Слухайте мене!	true
character_skills_localised_description_att_skill_background_priest_strategy_gaming_roman	Хороший гравець не прораховує п'ять ходів наперед. Він перемагає на першому ході.	true
character_skills_localised_description_att_trad_navy_roman_3_blockaders	Стріляйте вперед! Щільно! Ніхто не повинен прорватися!	true
character_skills_localised_name_mk_skill_spy_back_mole	Кріт	true
character_skills_localised_name_att_general_skill_sands_elephant	Сила пустелі	true
character_skills_localised_name_att_agent_skills_champion_terror	Терор	true
character_skills_localised_name_att_skill_background_wife_civilised_sharp_tongue	Злослівна	true
character_skills_localised_name_bel_trad_navy_roman_2_defending	Морські захисники	true
character_skills_localised_description_cha_skill_priest_rhetoric	Слова мають силу. Вони дозволяють сенсу набути плоті.	true
character_skills_localised_description_att_skill_background_spy_artisan_nomadic	Мої руки - ось мої знаряддя. Ними я створюю прекрасні і чудові речі.	true
character_skills_localised_description_mk_skill_back_cat_reflexes	Сила лева і спритність леопарда.	true
character_skills_localised_name_mk_skill_priest_back_strategist	Стратег	true
character_skills_localised_name_att_skill_background_spy_artisan_nomadic	Ремісник	true
character_skills_localised_description_att_skill_background_wife_civilised_sharp_tongue	Може, він і полководець, але це не заважає йому бути ледачим, жалюгідним, бляклим пародією на справжнього чоловіка.	true
character_skills_localised_description_cha_skill_spy_back_mole	Людина, здатна опинитися в потрібному місці і почути потрібні слова, цінніша за тисячі мечів.	true
character_skills_localised_description_att_general_skill_sands_elephant	Зв'язки в племенах, якими володіє ця людина, можуть бути дуже корисні в критичній ситуації.	true
character_skills_localised_description_att_agent_skills_champion_terror	Ніхто не захищений. Всі люди - мішені.	true
character_skills_localised_name_att_trad_navy_roman_3_blockaders	Майстри блокади	true
character_skills_localised_description_cha_trad_navy_bombardment	Шквал вогню, подібний до гніву небес, карає всіх негідних.	true
character_skills_localised_name_att_skill_background_wife_roman_well_connected	Широкі зв'язки	true
character_skills_localised_description_mk_trad_army_steady_troops	Тримайтеся міцніше, і ми доживемо до кінця дня!	true
character_skills_localised_description_att_agent_skills_champion_sabotage	Диверсія - це мистецтво порушувати плани ворога.	true
character_skills_localised_description_att_skill_background_wife_civilised_mean	Навіщо твоїм людям нові черевики. Три роки тому ми давали їм взуття. Вони що, його з'їли?	true
character_skills_localised_name_mk_skill_general_legend	Легенда	true
character_skills_localised_description_att_skill_background_wife_roman_decorous	Чоловік, дім, вогнище. Що ще потрібно благородній пані?	true
character_skills_localised_name_att_skill_background_priest_public_speaker_roman	Оратор	true
character_skills_localised_name_cha_skill_spy_practice	Тренування	true
character_skills_localised_name_att_skill_background_general_attacker_barbarian	Неприборканий агресор	true
character_skills_localised_name_bel_trad_army_roman_2_home_defence	Дім	true
character_skills_localised_description_att_general_skills_eastern_5_zhayedan	Тільки найкращий з найкращих може очолювати добірних воїнів.	true
character_skills_localised_description_att_agent_skills_priest_admonition	Іноді слово б'є сильніше за меч. Нечасто, але буває.	true
character_skills_localised_description_att_skill_background_spy_artisan_barbarian	Мої руки - ось мої знаряддя. Ними я створюю прекрасні і чудові речі.	true
character_skills_localised_name_att_general_skills_eastern_3_logistician	Логіст	true
character_skills_localised_name_att_general_skills_nomadic_3_cavalry_commander	Командир кінноти	true
character_skills_localised_name_att_skill_background_general_supply_roman	Досвідчений логіст	true
character_skills_localised_description_att_skill_background_general_scholar_roman	Книги - найвеличніша зброя у війні з невіглаством.	true
character_skills_localised_name_cha_skill_assassin_back_legend	Легенда	true
character_skills_localised_name_att_skill_background_spy_builder_nomadic	Будівельник	true
character_skills_localised_name_mk_skill_priest_justice	Справедливість	true
character_skills_localised_name_att_skill_background_general_landowner_eastern	Землевласник	true
character_skills_localised_name_cha_skill_spy_arsonist	Підпалювач	true
character_skills_localised_description_mk_trad_army_block_parry	Блок продовжує життя, а парирування дає шанс на перемогу.	true
character_skills_localised_name_bel_trad_navy_roman_4_attacking	Морські мисливці	true
character_skills_localised_name_att_skill_background_champion_horse_vet_eastern	Стор-безашх	true
character_skills_localised_name_att_skill_background_spy_courier_eastern	Барид	true
character_skills_localised_name_cha_skill_general_legend	Легенда	true
character_skills_localised_description_att_general_skills_barbarian_celts_ollam	Якщо хочеш, щоб справа була зроблена, доручи її гідному.	true
character_skills_localised_name_cha_skill_general_sweet_talker	Красномовність	true
character_skills_localised_name_att_skill_background_wife_civilised_spendthrift	Марнотратка	true
character_skills_localised_name_cha_skill_spy_tracking	Переслідування	true
character_skills_localised_description_att_general_skills_barbarian_celts_brethid	У гельському світі його слово - закон.	true
character_skills_localised_description_att_trad_navy_eastern_5_pride_east	Куди б не йшов цей флот, цар може пишатися ним.	true
character_skills_localised_name_mk_skill_general_back_defender	Захисник	true
character_skills_localised_name_cha_skill_priest_back_strategist	Стратег	true
character_skills_localised_description_att_skill_background_general_entrepreneur_nomadic	Якщо ця людина вважає щось важливим, з нею погоджується весь світ.	true
character_skills_localised_description_att_skill_background_champion_aide_camp_eastern	Довгі роки ця людина пробивалася нагору, прагнучи до величі і надихаючи на це інших.	true
character_skills_localised_description_cha_skill_general_back_politician	Щоб перемагати на полі бою, доводиться воювати і в рідних стінах.	true
character_skills_localised_description_att_skill_background_general_marksman_barbarian	Його постріли завжди досягають мети - всупереч вогню, вітру і навіть самій смерті.	true
character_skills_localised_description_cha_skill_priest_eyes_ears	Він все бачить, все чує і нічого не пропускає.	true
character_skills_localised_description_att_trad_army_barbarian_3_champions_north	Ці сильні і стійкі воїни здобули славу в північних землях.	true
character_skills_localised_description_cha_skill_priest_damnation	У них є вибір: порятунок або кілок.	true
character_skills_localised_name_cha_skill_priest_justice	Справедливість	true
character_skills_localised_description_att_general_skills_roman_1_legatus	Ватажок армії, призначений особисто правителем.	true
character_skills_localised_name_att_skill_background_priest_scribe_roman_roman	Скриніарій	true
character_skills_localised_description_cha_trad_navy_seamanship	Цим морякам не страшні ніякі шторми і шквали.	true
character_skills_localised_description_mk_trad_army_siege_experts	Якщо вам потрібно проломити ворожі стіни або утримати свої, довіртеся цим воїнам. Вони впораються.	true
character_skills_localised_description_cha_skill_priest_pessimism	Кожна мить наближає людину до неминучої загибелі!	true
character_skills_localised_name_att_skill_background_priest_elder_eastern	Вузурган	true
character_skills_localised_name_att_general_skills_nomadic_3_archer_commander	Командир лучників	true
character_skills_localised_name_att_trad_navy_barbarian_4_ship_warriors	Майстри абордажу	true
character_skills_localised_name_att_skill_background_general_entrepreneur_roman	Магнат	true
character_skills_localised_name_att_general_skills_barbarian_celts_bandit	Розбійник	true
character_skills_localised_description_att_skill_background_general_handler_roman	Цей чесний і справедливий чоловік завжди готовий поділитися мудрою порадою.	true
character_skills_localised_name_att_trad_navy_eastern_3_merchant_allies	Дружні купці	true
character_skills_localised_name_att_skill_background_champion_aide_camp_nomadic	Військовий радник	true
character_skills_localised_name_cha_skill_general_back_attacker	Атакуючий	true
character_skills_localised_description_att_trad_army_roman_1_logistics	Потрібна людина в потрібному місці здатна змінити світ.	true
character_skills_localised_description_att_skill_background_priest_radical_roman_roman	Відсутність змін - це застій. Застій - це ворог.	true
character_skills_localised_description_att_skill_background_champion_drillmaster_nomadic	Ти будеш слухати. Ти будеш вчитися. Або ти помреш.	true
character_skills_localised_name_att_skill_background_spy_mole_barbarian	Кріт	true
character_skills_localised_description_mk_skill_back_natural_gift	Можливо, це вроджена риса?..	true
character_skills_localised_name_att_trad_navy_barbarian_5_naval_conquerors	Підкорювачі морів	true
character_skills_localised_name_att_trad_navy_eastern_4_ruin_rome	Руйнівники Риму	true
character_skills_localised_name_mk_skill_spy_back_rumours	Чутки	true
character_skills_localised_name_mk_skill_back_dice_roller	Гравець в кості	true
character_skills_localised_description_mk_skill_assassin_assassin	Картини смерті пишуться кров'ю.	true
character_skills_localised_description_att_trad_army_barbarian_4_great_migrators	Вони пройшли дуже довгий шлях і багато чому навчилися.	true
character_skills_localised_name_cha_trad_navy_seamanship	Мореплавство	true
character_skills_localised_description_mk_trad_navy_navigation	Прямий шлях не завжди найвигідніший.	true
character_skills_localised_name_cha_skill_assassin_back_master	Майстер	true
character_skills_localised_name_att_skill_background_general_defender_barbarian	Стійкий захисник	true
character_skills_localised_description_cha_skill_priest_practice	Кажуть, щоб опанувати якусь справу, треба витратити 10 000 годин. Тож не гай часу!	true
character_skills_localised_description_cha_skill_priest_back_progressive	Якщо стояти на скелі занадто довго, тебе змиє хвиля.	true
character_skills_localised_description_cha_skill_priest_justice	Перед обличчям людей і всього святого оголошую тебе винним!	true
character_skills_localised_name_cha_skill_spy_back_conspirator	Змовник	true
character_skills_localised_description_mk_trad_navy_loyal	Жоден з них ніколи не підніме бунт. Вони підуть за полководцем назустріч смерті і славі.	true
character_skills_localised_description_mk_skill_priest_determined	Боротися і шукати, знайти і не здаватися!	true
character_skills_localised_description_cha_skill_general_back_defender	Ті, хто тримають стрій і не згинаються в бурю, виграють битви.	true
character_skills_localised_name_cha_skill_general_back_marksman	Влучний стрілець	true
character_skills_localised_description_cha_skill_priest_back_strategist	Перемоги він приписує собі, а про поразки мовчить. У цьому його стратегія.	true
character_skills_localised_description_att_general_skills_barbarian_2_infantry_commander	Він народжений, щоб крокувати попереду і вести інших за собою.	true
character_skills_localised_name_att_agent_skills_champion_glory	Слава	true
character_skills_localised_description_att_agent_skills_champion_training	Дисципліна, сила, майстерність. У сумі вони дають перемогу.	true
character_skills_localised_description_att_skill_background_wife_civilised_brutal	Я наказала випороти всіх слуг. Один на зло мені все-таки здох, так що мені потрібні гроші.	true
character_skills_localised_name_att_trad_navy_roman_2_bane_east	Гроза Сходу	true
character_skills_localised_description_cha_skill_general_legend	Ця людина увійшла в історію. Історія стала легендою. Легенда стає міфом.	true
character_skills_localised_name_att_general_skills_barbarian_celts_ollam	Оллам	true
character_skills_localised_description_att_skill_background_priest_elder_roman	Солодкі слова і гострий розум дають ідеальний смак мудрості.	true
character_skills_localised_description_att_skill_background_spy_courier_eastern	Швидкі ноги і добре підвішений язик.	true
