key	text	tooltip
#Loc;1;text/db/event_feed_targeted_events.loc		
event_feed_targeted_events_title_faction_political_dilemmaevent_feed_target_dilemma_faction	Політична подія	true
event_feed_targeted_events_title_diplomacy_treaty_broken_defensive_alliance_manipulatedevent_feed_target_diplomacy_recipient	Оборонний союз розірвано	true
event_feed_targeted_events_title_military_army_raisedevent_feed_target_military_force_faction	Армія зібрана	true
event_feed_targeted_events_title_faction_horde_endsevent_feed_target_capital_faction	Орда осіла	true
event_feed_targeted_events_title_faction_resource_lostevent_feed_target_settlement_faction	Втрачено ресурси	true
event_feed_targeted_events_title_character_ancillary_lostevent_feed_target_character_faction	Втрати в оточенні	true
event_feed_targeted_events_title_conquest_province_securedevent_feed_target_province_faction	Захоплено провінцію	true
event_feed_targeted_events_title_military_navy_rank_gainedevent_feed_target_military_force_faction	Морські традиції	true
event_feed_targeted_events_title_scripted_transient_located_eventevent_feed_target_faction	#(title)	true
event_feed_targeted_events_title_military_force_decimationevent_feed_target_military_force_faction	Децимація	true
event_feed_targeted_events_title_diplomacy_treaty_negotiated_non_aggression_pactevent_feed_target_diplomacy_recipient	Укладено договір про ненапад	true
event_feed_targeted_events_title_conquest_settlement_capital_capturedevent_feed_target_conquest_captured_from	Столиця в руках ворога!	true
event_feed_targeted_events_title_character_born_illegitimateevent_feed_target_character_child_faction	Позашлюбна дитина	true
event_feed_targeted_events_title_faction_resource_gainedevent_feed_target_settlement_faction	Отримано ресурси	true
event_feed_targeted_events_title_conquest_sea_region_contestedevent_feed_target_owner	Триває боротьба за морський регіон	true
event_feed_targeted_events_title_conquest_settlement_surrender_warningevent_feed_target_settlement_faction	Капітуляція неминуча!	true
event_feed_targeted_events_title_conquest_blockade_liftedevent_feed_target_conquest_blockader_faction	Блокада знята	true
event_feed_targeted_events_title_conquest_blockade_liftedevent_feed_target_conquest_blockaded_faction	Ворожа блокада знята!	true
event_feed_targeted_events_title_faction_civil_war_forceevent_feed_target_faction_instigator_faction	Громадянська війна!	true
event_feed_targeted_events_title_character_ready_for_dutyevent_feed_target_character_faction	Готовність до служби	true
event_feed_targeted_events_title_provinces_unrest_rebellionevent_feed_target_province_faction	Повстання!	true
event_feed_targeted_events_title_character_dies_naturalevent_feed_target_character_faction	Природна смерть	true
event_feed_targeted_events_title_agent_action_vs_armyevent_feed_target_agent_faction	Дії агентів	true
event_feed_targeted_events_title_diplomacy_treaty_broken_tradeevent_feed_target_diplomacy_recipient	Торговельна угода порушена	true
event_feed_targeted_events_title_diplomacy_treaty_broken_defensive_allianceevent_feed_target_diplomacy_actor	Оборонний союз розірвано	true
event_feed_targeted_events_title_conquest_battleevent_feed_target_conquest_battle_attacker	#(battle_info)	true
event_feed_targeted_events_title_provinces_food_shortageevent_feed_target_province_faction	Нестача їжі!	true
event_feed_targeted_events_title_agent_action_vs_settlementevent_feed_target_target_faction	Ворожі агенти діють!	true
event_feed_targeted_events_title_character_dies_hostileevent_feed_target_character_faction	Персонаж убитий	true
event_feed_targeted_events_title_provinces_unseasonal_conditionsevent_feed_target_province_faction	Несезонні умови	true
event_feed_targeted_events_title_diplomacy_treaty_negotiated_peaceevent_feed_target_diplomacy_actor	Укладено мир	true
event_feed_targeted_events_title_diplomacy_war_declaredevent_feed_target_diplomacy_recipient	Оголошено війну	true
event_feed_targeted_events_title_provinces_plague_spreads_region_to_forceevent_feed_target_plague_to_faction	Хвороба поширюється!	true
event_feed_targeted_events_title_military_navy_raisedevent_feed_target_military_force_faction	Флот зібрано	true
event_feed_targeted_events_title_horde_food_shortageevent_feed_target_military_force_faction	Нестача їжі!	true
event_feed_targeted_events_title_character_woundedevent_feed_target_character_faction	Персонаж поранений!	true
event_feed_targeted_events_title_horde_building_demolishedevent_feed_target_building_faction	Знесення завершено	true
event_feed_targeted_events_title_provinces_edict_cancelledevent_feed_target_province_faction	Едикт скасовано!	true
event_feed_targeted_events_title_diplomacy_treaty_negotiated_tradeevent_feed_target_diplomacy_actor	Укладено торговельну угоду	true
event_feed_targeted_events_title_diplomacy_treaty_broken_client_stateevent_feed_target_diplomacy_recipient	Держава-данник розриває відносини	true
event_feed_targeted_events_title_provinces_plague_spreads_force_to_forceevent_feed_target_plague_to_faction	Хвороба поширюється!	true
event_feed_targeted_events_title_character_dies_infant_mortalityevent_feed_target_character_faction	Дитяча смертність	true
event_feed_targeted_events_title_diplomacy_treaty_negotiated_client_stateevent_feed_target_diplomacy_actor	Засновано державу-данника	true
event_feed_targeted_events_title_diplomacy_treaty_broken_non_aggression_pact_manipulatedevent_feed_target_diplomacy_recipient	Договір про ненапад розірвано	true
event_feed_targeted_events_title_agent_action_vs_characterevent_feed_target_target_faction	Ворожі агенти діють!	true
event_feed_targeted_events_title_provinces_settlement_abandonedevent_feed_target_settlement_faction	Поселення покинуто!	true
event_feed_targeted_events_title_conquest_blockade_establishedevent_feed_target_conquest_blockaded_faction	Противник встановив блокаду!	true
event_feed_targeted_events_title_military_army_rank_gainedevent_feed_target_military_force_faction	Військові традиції	true
event_feed_targeted_events_title_conquest_blockade_establishedevent_feed_target_conquest_blockader_faction	Блокада встановлена	true
event_feed_targeted_events_title_diplomacy_treaty_broken_non_aggression_pactevent_feed_target_diplomacy_actor	Договір про ненапад розірвано	true
event_feed_targeted_events_title_military_ambusher_discovered_yoursevent_feed_target_ambusher_faction	Зірвано засідку	true
event_feed_targeted_events_title_character_dies_executedevent_feed_target_character_faction	Політичне вбивство	true
event_feed_targeted_events_title_conquest_settlement_capturedevent_feed_target_conquest_captured_from	Поселення втрачено!	true
event_feed_targeted_events_title_faction_political_subjectevent_feed_target_dilemma_faction	Державна справа	true
event_feed_targeted_events_title_scripted_transient_eventevent_feed_target_faction	#(title)	true
event_feed_targeted_events_title_diplomacy_faction_encounteredevent_feed_target_diplomacy_faction_1	Нова фракція	true
event_feed_targeted_events_title_conquest_battleevent_feed_target_conquest_battle_defender	#(battle_info)	true
event_feed_targeted_events_title_diplomacy_treaty_negotiated_defensive_allianceevent_feed_target_diplomacy_recipient	Укладено оборонний союз	true
event_feed_targeted_events_title_diplomacy_treaty_negotiated_soft_military_accessevent_feed_target_diplomacy_actor	Укладено угоду про право проходу	true
event_feed_targeted_events_title_military_path_blockedevent_feed_target_military_character_faction	Шлях перекрито!	true
event_feed_targeted_events_title_military_ambusher_discoveredevent_feed_target_discovered_by	Виявлено засідку	true
event_feed_targeted_events_title_character_dies_suspiciousevent_feed_target_character_faction	Підозріла смерть	true
event_feed_targeted_events_title_diplomacy_treaty_negotiated_military_allianceevent_feed_target_diplomacy_recipient	Укладено військовий союз	true
event_feed_targeted_events_title_provinces_plague_spreads_force_to_regionevent_feed_target_plague_to_faction	Хвороба поширюється!	true
event_feed_targeted_events_title_diplomacy_faction_joins_warevent_feed_target_diplomacy_war_faction_2	Разом ми - сила	true
event_feed_targeted_events_title_faction_religion_changeevent_feed_target_faction_known_to	Зміна релігії	true
event_feed_targeted_events_title_scripted_persistent_located_eventevent_feed_target_faction	#(title)	true
event_feed_targeted_events_title_diplomacy_faction_emergesevent_feed_target_faction_known_to	З'являється фракція	true
event_feed_targeted_events_title_diplomacy_treaty_broken_vassalevent_feed_target_diplomacy_recipient	Незалежність маріонеткової держави	true
event_feed_targeted_events_title_diplomacy_war_declaredevent_feed_target_diplomacy_known_to	Оголошено війну	true
event_feed_targeted_events_title_diplomacy_treaty_broken_trade_dissolvedevent_feed_target_diplomacy_recipient	Торговельна угода розірвана	true
event_feed_targeted_events_title_faction_bankruptcyevent_feed_target_faction	Скарбниця порожня!	true
event_feed_targeted_events_title_faction_campaign_chapter_objective_completeevent_feed_target_mission_faction	Мета досягнута	true
event_feed_targeted_events_title_character_dies_in_actionevent_feed_target_character_faction	Смерть на службі	true
event_feed_targeted_events_title_military_attritionevent_feed_target_military_force_faction	Небойові втрати!	true
event_feed_targeted_events_title_provinces_slumsevent_feed_target_settlement_faction	Нетрі	true
event_feed_targeted_events_title_diplomacy_treaty_broken_military_alliance_manipulatedevent_feed_target_diplomacy_recipient	Військовий союз розірвано	true
event_feed_targeted_events_title_scripted_persistent_eventevent_feed_target_faction	#(title)	true
event_feed_targeted_events_title_provinces_plague_spreads_region_to_regionevent_feed_target_plague_to_faction	Хвороба поширюється!	true
event_feed_targeted_events_title_provinces_plague_spreads_force_to_forceevent_feed_target_plague_from_faction	Хвороба поширюється	true
event_feed_targeted_events_title_horde_building_constructedevent_feed_target_building_faction	Будівництво завершено	true
event_feed_targeted_events_title_faction_campaign_victory_objective_completeevent_feed_target_mission_faction	Умова перемоги виконана	true
event_feed_targeted_events_title_agent_action_vs_settlementevent_feed_target_agent_faction	Дії агентів	true
event_feed_targeted_events_title_character_trait_gainedevent_feed_target_character_faction	Нова особливість	true
event_feed_targeted_events_title_agent_action_vs_armyevent_feed_target_target_faction	Ворожі агенти діють!	true
event_feed_targeted_events_title_diplomacy_war_coordination_target_availableevent_feed_target_faction	Взаємодія на війні	true
event_feed_targeted_events_title_faction_political_ministerial_term_endedevent_feed_target_character_faction	Термін служби	true
event_feed_targeted_events_title_character_born_legitimateevent_feed_target_character_child_faction	Шляхетний нащадок	true
event_feed_targeted_events_title_diplomacy_treaty_broken_military_allianceevent_feed_target_diplomacy_actor	Військовий союз розірвано	true
event_feed_targeted_events_title_diplomacy_treaty_negotiated_vassalevent_feed_target_diplomacy_actor	Засновано маріонеткову державу	true
event_feed_targeted_events_title_faction_political_party_power_changeevent_feed_target_party_faction	Баланс сил	true
event_feed_targeted_events_title_conquest_province_contestedevent_feed_target_owner	Триває боротьба за провінцію	true
event_feed_targeted_events_title_horde_food_shortage_endsevent_feed_target_military_force_faction	Перебої з продовольством усунені	true
event_feed_targeted_events_title_faction_event_mission_failedevent_feed_target_mission_faction	Завдання провалено	true
event_feed_targeted_events_title_character_rank_gainedevent_feed_target_character_faction	Підвищено ранг	true
event_feed_targeted_events_title_diplomacy_faction_joins_warevent_feed_target_diplomacy_war_faction_1_b	Союз проти нас	true
event_feed_targeted_events_title_provinces_plague_spreads_region_to_forceevent_feed_target_plague_from_faction	Хвороба поширюється	true
event_feed_targeted_events_title_diplomacy_war_coordination_ally_mobilisation_vs_forceevent_feed_target_faction	Союзник закликає війська проти армії	true
event_feed_targeted_events_title_provinces_cannot_abandon_settlementevent_feed_target_settlement_faction	Не вдалося покинути поселення	true
event_feed_targeted_events_title_provinces_building_constructedevent_feed_target_building_faction	Будівництво завершено	true
event_feed_targeted_events_title_diplomacy_treaty_broken_trade_dissolvedevent_feed_target_diplomacy_actor	Торгова угода розірвана	true
event_feed_targeted_events_title_diplomacy_treaty_broken_vassalevent_feed_target_diplomacy_actor	Звільнення маріонеткової держави	true
event_feed_targeted_events_title_faction_famineevent_feed_target_faction	Голод!	true
event_feed_targeted_events_title_provinces_settlement_lootedevent_feed_target_settlement_faction	Поселення розграбоване!	true
event_feed_targeted_events_title_character_dies_battleevent_feed_target_character_faction	Смерть у бою	true
event_feed_targeted_events_title_diplomacy_treaty_broken_vassal_manipulatedevent_feed_target_diplomacy_recipient	Маніпуляція маріонетковою державою	true
event_feed_targeted_events_title_military_unit_recruitedevent_feed_target_military_unit_faction	Найнято загін	true
event_feed_targeted_events_title_conquest_siege_liftedevent_feed_target_conquest_besieger_faction	Облога знята	true
event_feed_targeted_events_title_conquest_siege_liftedevent_feed_target_conquest_besieged_faction	Противник зняв облогу	true
event_feed_targeted_events_title_character_ancillary_gainedevent_feed_target_character_faction	Нове в оточенні	true
event_feed_targeted_events_title_diplomacy_war_coordination_ally_mobilisation_vs_regionevent_feed_target_faction	Союзник закликає війська проти поселення	true
event_feed_targeted_events_title_diplomacy_treaty_negotiated_military_allianceevent_feed_target_diplomacy_actor	Укладено військовий союз	true
event_feed_targeted_events_title_faction_campaign_lostevent_feed_target_mission_faction	Поразка!	true
event_feed_targeted_events_title_horde_unrest_imminent_rebellionevent_feed_target_military_force_faction	Повстання неминуче!	true
event_feed_targeted_events_title_faction_successionevent_feed_target_faction_new_leader_faction	Престолонаслідування	true
event_feed_targeted_events_title_faction_civil_war_provinceevent_feed_target_faction_instigator_faction	Громадянська війна!	true
event_feed_targeted_events_title_faction_event_mission_issuedevent_feed_target_mission_faction	Нове завдання	true
event_feed_targeted_events_title_conquest_enemy_raid_trade_routeevent_feed_target_raided	Напад на торговий шлях!	true
event_feed_targeted_events_title_provinces_plague_startsevent_feed_target_region_faction	Спалах хвороби!	true
event_feed_targeted_events_title_diplomacy_war_coordination_target_not_availableevent_feed_target_faction	Взаємодія на війні	true
event_feed_targeted_events_title_diplomacy_treaty_broken_military_allianceevent_feed_target_diplomacy_recipient	Військовий союз розірвано	true
event_feed_targeted_events_title_conquest_sea_region_controlledevent_feed_target_owner	Захоплено морський регіон	true
event_feed_targeted_events_title_faction_succession_regencyevent_feed_target_faction_new_leader_faction	Регентство	true
event_feed_targeted_events_title_provinces_settlement_sackedevent_feed_target_settlement_faction	Поселення розорене!	true
event_feed_targeted_events_title_faction_civil_war_endsevent_feed_target_faction	Громадянська війна!	true
event_feed_targeted_events_title_faction_imperium_level_increaseevent_feed_target_faction	Імперіум	true
event_feed_targeted_events_title_faction_horde_beginsevent_feed_target_faction	Орда	true
event_feed_targeted_events_title_conquest_settlement_capital_capturedevent_feed_target_conquest_occupier_faction	Поселення захоплено	true
event_feed_targeted_events_title_conquest_settlement_capturedevent_feed_target_conquest_occupier_faction	Поселення захоплено	true
event_feed_targeted_events_title_faction_event_mission_abortedevent_feed_target_mission_faction	Завдання перервано	true
event_feed_targeted_events_title_military_navy_destroyedevent_feed_target_military_force_faction	Флот втрачено!	true
event_feed_targeted_events_title_military_army_withdrawsevent_feed_target_military_force_faction	Армія відступає	true
event_feed_targeted_events_title_agent_discoveredevent_feed_target_discovered_by	Замаскований агент розкритий	true
event_feed_targeted_events_title_faction_heir_nominatedevent_feed_target_character_heir_faction	Оголошено спадкоємця	true
event_feed_targeted_events_title_faction_succession_heir_comes_of_ageevent_feed_target_faction_new_leader_faction	Зійти на трон	true
event_feed_targeted_events_title_conquest_siege_establishedevent_feed_target_conquest_besieged_faction	Противник почав облогу!	true
event_feed_targeted_events_title_conquest_siege_establishedevent_feed_target_conquest_besieger_faction	Облога почалася	true
event_feed_targeted_events_title_agent_action_vs_characterevent_feed_target_agent_faction	Дії агентів	true
event_feed_targeted_events_title_provinces_edict_issuedevent_feed_target_province_faction	Видано едикт	true
event_feed_targeted_events_title_provinces_building_demolishedevent_feed_target_building_faction	Знесення завершено	true
event_feed_targeted_events_title_diplomacy_treaty_broken_tradeevent_feed_target_diplomacy_actor	Розірвано торговельну угоду	true
event_feed_targeted_events_title_diplomacy_treaty_broken_defensive_allianceevent_feed_target_diplomacy_recipient	Оборонний союз розірвано	true
event_feed_targeted_events_title_diplomacy_treaty_broken_trade_manipulatedevent_feed_target_diplomacy_recipient	Розірвано торговельну угоду	true
event_feed_targeted_events_title_character_loyalty_lowevent_feed_target_character_faction	Коливання	true
event_feed_targeted_events_title_diplomacy_faction_destroyedevent_feed_target_faction_known_to	Фракція знищена	true
event_feed_targeted_events_title_military_navy_foundedevent_feed_target_military_force_faction	Флот засновано	true
event_feed_targeted_events_title_faction_event_incidentevent_feed_target_incident_faction	#(incident)	true
event_feed_targeted_events_title_conquest_enemy_raid_settlementevent_feed_target_raided_faction	Наліт!	true
event_feed_targeted_events_title_diplomacy_treaty_negotiated_non_aggression_pactevent_feed_target_diplomacy_actor	Укладено договір про ненапад	true
event_feed_targeted_events_title_diplomacy_trespassingevent_feed_target_faction	Ворог порушив кордони	true
event_feed_targeted_events_title_military_navy_withdrawsevent_feed_target_military_force_faction	Флот відступає	true
event_feed_targeted_events_title_faction_technology_researchedevent_feed_target_faction	Розвиток	true
event_feed_targeted_events_title_military_army_destroyedevent_feed_target_military_force_faction	Армія втрачена!	true
event_feed_targeted_events_title_military_army_foundedevent_feed_target_military_force_faction	Армія заснована	true
event_feed_targeted_events_title_provinces_plague_spreads_region_to_regionevent_feed_target_plague_from_faction	Хвороба поширюється	true
event_feed_targeted_events_title_diplomacy_treaty_broken_client_state_manipulatedevent_feed_target_diplomacy_recipient	Маніпуляція державою-данником	true
event_feed_targeted_events_title_provinces_food_shortage_endsevent_feed_target_province_faction	Перебої з продовольством усунені	true
event_feed_targeted_events_title_diplomacy_treaty_broken_non_aggression_pactevent_feed_target_diplomacy_recipient	Договір про ненапад розірвано	true
event_feed_targeted_events_title_character_trait_lostevent_feed_target_character_faction	Втрачено особливість	true
event_feed_targeted_events_title_provinces_plague_spreads_force_to_regionevent_feed_target_plague_from_faction	Хвороба поширюється	true
event_feed_targeted_events_title_provinces_settlement_lootedevent_feed_target_attacked_by_faction	Вороже поселення розграбоване	true
event_feed_targeted_events_title_character_dies_battleevent_feed_target_opponent	Противник загинув у битві	true
event_feed_targeted_events_title_provinces_settlement_razedevent_feed_target_attacked_by_faction	Вороже поселення зруйноване	true
event_feed_targeted_events_title_diplomacy_trespassingevent_feed_target_military_force_faction	Порушення кордонів!	true
event_feed_targeted_events_title_diplomacy_treaty_negotiated_defensive_allianceevent_feed_target_diplomacy_actor	Укладено оборонний союз	true
event_feed_targeted_events_title_military_navy_disbandedevent_feed_target_military_force_faction	Флот розформовано	true
event_feed_targeted_events_title_provinces_unrest_imminent_rebellionevent_feed_target_province_faction	Повстання неминуче!	true
event_feed_targeted_events_title_provinces_settlement_razedevent_feed_target_settlement_faction	Поселення зруйновано!	true
event_feed_targeted_events_title_agent_discovered_yoursevent_feed_target_agent_faction	Агент викрито	true
event_feed_targeted_events_title_diplomacy_treaty_broken_soft_military_accessevent_feed_target_diplomacy_actor	Угода про право проходу розірвано	true
event_feed_targeted_events_title_agent_recruitedevent_feed_target_agent_faction	Найнято агента	true
event_feed_targeted_events_title_diplomacy_treaty_broken_soft_military_access_manipulatedevent_feed_target_diplomacy_recipient	Угода про право проходу розірвано	true
event_feed_targeted_events_title_military_army_disbandedevent_feed_target_military_force_faction	Армія розформована	true
event_feed_targeted_events_title_faction_event_dilemmaevent_feed_target_dilemma_faction	#(dilemma)	true
event_feed_targeted_events_title_provinces_settlement_sackedevent_feed_target_attacked_by_faction	Вороже поселення розорене	true
event_feed_targeted_events_title_provinces_development_points_availableevent_feed_target_province_faction	Надлишок населення	true
event_feed_targeted_events_title_diplomacy_treaty_negotiated_peaceevent_feed_target_diplomacy_recipient	Укладено мир	true
event_feed_targeted_events_title_world_climate_changeevent_feed_target_faction	Зміна клімату	true
event_feed_targeted_events_title_diplomacy_war_declaredevent_feed_target_diplomacy_actor	Оголошено війну	true
event_feed_targeted_events_title_faction_event_mission_successevent_feed_target_mission_faction	Завдання виконано	true
event_feed_targeted_events_title_diplomacy_treaty_negotiated_peaceevent_feed_target_diplomacy_known_to	Укладено мир	true
event_feed_targeted_events_title_faction_religion_changeevent_feed_target_faction	Випробування віри	true
event_feed_targeted_events_title_faction_civil_war_characterevent_feed_target_faction_instigator_faction	Громадянська війна!	true
event_feed_targeted_events_title_diplomacy_treaty_broken_client_stateevent_feed_target_diplomacy_actor	Держава-данник розриває стосунки	true
event_feed_targeted_events_title_diplomacy_treaty_negotiated_tradeevent_feed_target_diplomacy_recipient	Укладено торговельну угоду	true
