key	text	tooltip
#Loc;1;text/db/missions.loc		
missions_localised_description_cha_objective_cha_charlemagne_primary_1_seal_2	Дрібні правителі подібні до псів, що шматують тіло Європи. Істинний король повстане і розжене їх.	true
missions_localised_description_cha_objective_cha_charlemagne_primary_2_seal_3	Перш ніж істинний король затвердить свою владу над землею, його ім'я повинно прозвучати з усіх чотирьох сторін.	true
missions_localised_description_cha_objective_cha_charlemagne_primary_3_seal_4	Вороги б'ються об армію істинного короля, немов хвилі об берег. Рішучий, він встоїть під їхніми ударами.	true
missions_localised_description_cha_objective_cha_charlemagne_primary_4_seal_5	Здійснюючи великі діяння, король створює спадщину, непідвладну часу і смерті.	true
missions_localised_description_cha_objective_cha_charlemagne_primary_5_seal_6	Слава Європи - в єдності. Нехай же ніхто не посміє відокремитися від великої держави, створеної істинним королем!	true
missions_localised_title_att_senate_western_roman_construct_bch_roman_west_military_1	Військове будівництво	true
missions_localised_title_att_religious_manichaeism_convert_region_1	Релігійна вимога	true
missions_localised_title_att_objective_suebi_primary_2_seal_3	Розділ II: Розорення	true
missions_localised_title_att_objective_suebi_primary_1_seal_2	Глава I: Підготовка	true
missions_localised_title_att_objective_suebi_primary_4_seal_5	Розділ IV: Відплата	true
missions_localised_title_att_objective_suebi_primary_3_seal_4	Розділ III: Спустошення	true
missions_localised_title_att_objective_suebi_primary_5_seal_6	Глава V: Виправдання	true
missions_localised_title_att_religious_tengri_assassinate_character_1	Релігійна вимога	true
missions_localised_title_att_mp_coop_loyalist	Спільна перемога лоялістів	true
missions_localised_title_mk_religious_baltic_declare_war_1	Релігійна вимога	true
missions_localised_description_att_bel_request_antoninia_ioannina_1	Мій дорогий чоловіче, пам'ятаєш, я просила тебе зробити хоч що-небудь. Так от, я мала на увазі, що ти маєш вбити Анастазія за те, що він збезчестив нашу доньку. Ми не можемо залишити це без наслідків.	true
missions_localised_description_att_objective_axum_primary_1_seal_2	Вони готувалися до війни.	true
missions_localised_description_att_objective_axum_primary_2_seal_3	Аттіла народився з темряви і відчаю.	true
missions_localised_description_att_objective_axum_primary_3_seal_4	Залиш будь-яку надію.	true
missions_localised_title_att_senate_nomadic_research_technology_military_1	Прогрес військової справи	true
missions_localised_description_att_objective_axum_primary_4_seal_5	Немає пощади грішникам.	true
missions_localised_description_att_objective_axum_primary_5_seal_6	Час відплати настав.	true
missions_localised_title_att_diplomatic_nomadic_mercenary_engage_force_army_1	Контракт із найманцями	true
missions_localised_description_att_religious_germanic_assassinate_character_1	Він говорить мовою лжебогів! Його потрібно усунути!	true
missions_localised_description_att_religious_orthodox_assassinate_character_1	Він зіб'є віруючих зі шляху істинного обіцянками і промовами про лжебогів.  Патріарх просить нас усунути його.	true
missions_localised_description_pro_destroy_rebels_petrodava	Жителі Петродави повстали і хочуть вигнати нас зі своїх земель. Їм потрібно показати, що ми тут господарі, а не вони.	true
missions_localised_description_att_senate_nomadic_research_technology_civil_1	Нам слід вкладати час і гроші в управління містами, щоб наші сім'ї також отримували користь від наших перемог.	true
missions_localised_title_att_diplomatic_eastern_roman_blockade_port_1	Взаємодія на війні	true
missions_localised_title_att_diplomatic_western_roman_blockade_port_1	Взаємодія на війні	true
missions_localised_description_att_religious_manichaeism_construct_bch_religion_manichaeist_major_1	Наші священники просять нас побудувати храм одночасно і для Атара, і для Абана, щоб віряни могли кидати жертвоприношення в очищувальний вогонь.	true
missions_localised_title_att_objective_bel_vandals_primary_5_seal_6	Глава V: Нестримний	true
missions_localised_title_att_objective_bel_vandals_primary_4_seal_5	Розділ IV: Новий світ	true
missions_localised_title_att_objective_bel_vandals_primary_3_seal_4	Розділ III: Королівство на руїнах імперії	true
missions_localised_title_att_objective_bel_vandals_primary_2_seal_3	Глава II: Вільний і самостійний	true
missions_localised_title_att_objective_bel_vandals_primary_1_seal_2	Глава I: По праву наше	true
missions_localised_title_att_objective_caledonians_primary_1_seal_2	Глава I: Підготовка	true
missions_localised_title_att_objective_caledonians_primary_2_seal_3	Розділ II: Розорення	true
missions_localised_title_att_objective_caledonians_primary_3_seal_4	Розділ III: Спустошення	true
missions_localised_title_att_objective_caledonians_primary_4_seal_5	Розділ IV: Відплата	true
missions_localised_title_att_objective_caledonians_primary_5_seal_6	Глава V: Виправдання	true
missions_localised_description_att_bel_request_antoninia_rumours_2	Феодосій відплатив вам за добро, осквернивши чистоту вашого шлюбного ложа. Якщо ви хочете зберегти повагу знаті, то повинні обрушити на нього всю лють вашого гніву.	true
missions_localised_description_att_senate_eastern_engage_force_navy_1	Жителі пустелі можуть битися і на морі. Доведемо це тим, хто в нас сумнівається.	true
missions_localised_title_att_senate_eastern_roman_research_technology_civil_1	Розвиток суспільства	true
missions_localised_title_att_senate_western_roman_research_technology_civil_1	Розвиток суспільства	true
missions_localised_title_cha_objective_cha_cordoba_primary_2_seal_3	Королівське ім'я	true
missions_localised_title_cha_objective_cha_cordoba_primary_1_seal_2	Розколотий світ	true
missions_localised_title_mk_religious_shia_recruit_agent_1	Релігійна вимога	true
missions_localised_title_cha_objective_cha_cordoba_primary_5_seal_6	Відродження Європи	true
missions_localised_title_cha_objective_cha_cordoba_primary_4_seal_5	Створена спадщина	true
missions_localised_title_cha_objective_cha_cordoba_primary_3_seal_4	Прибій війни	true
missions_localised_description_att_vc_2_imperial_separatist	Тріумф лоялістів	true
missions_localised_description_att_religious_celtic_assassinate_character_1	Він говорить чужими мовами і прославляє несправжніх богів. Його потрібно усунути.	true
missions_localised_description_mk_religious_bogomilist_declare_war_1	Члени нашої пастви зазнають нападів з боку фанатичних і жорстоких людей, і ми змушені взятися за зброю, щоб захистити їх в ім'я Господа.	true
missions_localised_description_att_victory_mission_1_success	Успіх	true
missions_localised_description_att_religious_catholic_assassinate_character_1	Папа оголосив цю людину єретиком і вимагає, щоб усі добрі католики виконали його волю.	true
missions_localised_title_att_religious_manichaeism_construct_bch_religion_manichaeist_minor_1	Релігійна вимога	true
missions_localised_title_att_senate_eastern_roman_construct_bch_roman_east_military_1	Військове будівництво	true
missions_localised_title_cha_mission_italian_kingdom	Королівство Італія	true
missions_localised_description_mk_religious_eastern_convert_region_1	Патріарх надіслав листа. Він просить навернути цей край до істинної віри.	true
missions_localised_title_att_religious_catholic_construct_bch_religion_catholic_legendary_1	Релігійна вимога	true
missions_localised_title_att_religious_orthodox_construct_bch_religion_orthodox_legendary_1	Релігійна вимога	true
missions_localised_description_att_religious_arian_convert_region_1	Ми повинні поширювати слово боже в наших землях. Єпископ заклинає тебе зайнятися наверненням людей до істинної віри.	true
missions_localised_title_att_senate_nordic_capture_regions_own_settlement_1	Звільнення	true
missions_localised_title_att_senate_nomadic_construct_bch_nomad_community_1	Міське будівництво	true
missions_localised_title_att_diplomatic_nomadic_engage_force_army_1	Взаємодія на війні	true
missions_localised_description_att_bel_request_justinian_photius_1	Найвиснажливіші битви відбуваються в ліжку. Сміливіше, могутній Велісарій, на вас чекає велика доля, заради якої можна і потерпіти.	true
missions_localised_title_att_senate_eastern_make_trade_agreement_1	Справи торговельні	true
missions_localised_description_ch_vc_1_short	Швидка перемога	true
missions_localised_description_cha_mission_spanish_kingdom	Здобудьте могутність, побудуйте своє королівство, створіть спадщину на століття - і ваше ім'я назавжди увійде в історію!	true
missions_localised_title_pro_build_farm_adrianople	Побудуйте садибу в Адріанополі	true
missions_localised_title_att_objective_nords_primary_2_seal_3	Розділ II: Розорення	true
missions_localised_title_att_objective_nords_primary_1_seal_2	Глава I: Підготовка	true
missions_localised_title_att_objective_nords_primary_5_seal_6	Глава V: Виправдання	true
missions_localised_title_att_objective_nords_primary_4_seal_5	Розділ IV: Відплата	true
missions_localised_title_att_objective_nords_primary_3_seal_4	Розділ III: Спустошення	true
missions_localised_description_att_diplomatic_nomadic_raid_region_1	Союзник попросив нас влаштувати наліт на цей регіон, щоб перешкодити ворожій торгівлі.	true
missions_localised_description_att_eos_religious_mission_build_att_rel_church_east	Смиренно благаємо повелителя повернутися до обрядів, які служили нам вірою і правдою. Зведи чотири релігійні споруди - і ти будеш винагороджений терпінням і побожністю своїх підданих.	true
missions_localised_title_att_vc_1_christian	Перемога християн	true
missions_localised_title_att_vc_2_christian	Релігійна перемога християн	true
missions_localised_description_pro_political_actions	Не забувайте стежити за обстановкою в придворних колах. Честолюбну і могутню знать слід тримати під контролем.	true
missions_localised_description_att_objective_alans_primary_4_seal_5	Немає пощади грішникам.	true
missions_localised_description_att_objective_alans_primary_3_seal_4	Залиш будь-яку надію.	true
missions_localised_description_att_objective_antes_primary_5_seal_6	Час відплати настав.	true
missions_localised_description_att_objective_antes_primary_4_seal_5	Немає пощади грішникам.	true
missions_localised_description_att_objective_alans_primary_5_seal_6	Час відплати настав.	true
missions_localised_description_att_objective_antes_primary_3_seal_4	Залиш будь-яку надію.	true
missions_localised_description_att_objective_antes_primary_2_seal_3	Аттіла народився з темряви і відчаю.	true
missions_localised_description_att_objective_antes_primary_1_seal_2	Вони готувалися до війни.	true
missions_localised_description_att_objective_alans_primary_2_seal_3	Аттіла народився з темряви і відчаю.	true
missions_localised_description_att_objective_alans_primary_1_seal_2	Вони готувалися до війни.	true
missions_localised_title_mk_religious_sunni_construct_building_religious_1	Релігійна вимога	true
missions_localised_title_pro_engage_hun_third_wave	Нападіть на війська гунів	true
missions_localised_title_att_vc_1_historical	Історична перемога	true
missions_localised_title_att_diplomatic_nomadic_raid_region_1	Взаємодія на війні	true
missions_localised_description_att_religious_hellenic_recruit_agent_1	Політ орла говорить нам про те, що ми повинні завербувати нового жерця. Прохання богів має бути виконано.	true
missions_localised_title_pro_build_torp_adrianople	Побудуйте торп в Адріанополі	true
missions_localised_description_cha_mission_cordoba_caliphate	Здобудьте могутність, побудуйте своє королівство, створіть спадщину на століття - і ваше ім'я назавжди увійде в історію!	true
missions_localised_description_att_objective_nords_primary_5_seal_6	Час відплати настав.	true
missions_localised_description_att_objective_nords_primary_3_seal_4	Залиш будь-яку надію.	true
missions_localised_description_att_objective_nords_primary_4_seal_5	Немає пощади грішникам.	true
missions_localised_description_att_objective_nords_primary_1_seal_2	Вони готувалися до війни.	true
missions_localised_description_att_objective_nords_primary_2_seal_3	Аттіла народився з темряви і відчаю.	true
missions_localised_title_att_senate_eastern_recruit_unit_infantry_1	Підкріплення	true
missions_localised_title_mk_religious_ibadi_construct_building_religious_1	Релігійна вимога	true
missions_localised_title_att_victory_mp_coop	Спільна перемога в мережевій грі	true
missions_localised_title_att_objective_antes_primary_1_seal_2	Глава I: Підготовка	true
missions_localised_title_att_objective_antes_primary_2_seal_3	Розділ II: Розорення	true
missions_localised_title_att_objective_alans_primary_1_seal_2	Глава I: Підготовка	true
missions_localised_title_att_objective_alans_primary_2_seal_3	Розділ II: Розорення	true
missions_localised_title_att_objective_alans_primary_3_seal_4	Розділ III: Спустошення	true
missions_localised_title_att_objective_antes_primary_5_seal_6	Глава V: Виправдання	true
missions_localised_title_att_objective_alans_primary_4_seal_5	Розділ IV: Відплата	true
missions_localised_title_att_objective_alans_primary_5_seal_6	Глава V: Виправдання	true
missions_localised_title_att_objective_antes_primary_3_seal_4	Розділ III: Спустошення	true
missions_localised_title_att_objective_antes_primary_4_seal_5	Розділ IV: Відплата	true
missions_localised_description_att_religious_celtic_construct_building_religious_1	Ми повинні будувати храми і монументи на честь богів, щоб заслужити їхнє благовоління.	true
missions_localised_description_att_senate_nordic_construct_bch_barbmigs_military_1	Побудуємо поліпшені тренувальні майданчики й арсенали, щоб кожен громадянин володів списом і пращею.	true
missions_localised_title_att_test_victory_mission_military	Тестова військова перемога	true
missions_localised_title_pro_engage_hun_first_wave	Нападіть на війська гунів	true
missions_localised_description_att_objective_primary_5_seal_6	Час відплати настав.	true
missions_localised_description_att_objective_primary_4_seal_5	Немає пощади грішникам.	true
missions_localised_description_att_objective_primary_3_seal_4	Залиш будь-яку надію.	true
missions_localised_description_att_objective_primary_2_seal_3	Аттіла народився з темряви і відчаю.	true
missions_localised_description_att_objective_primary_1_seal_2	Вони готувалися до війни.	true
missions_localised_title_att_religious_arian_convert_region_1	Релігійна вимога	true
missions_localised_description_att_religious_manichaeism_construct_bch_religion_manichaeist_minor_1	Наші священники просять нас побудувати храм одночасно і для Атара, і для Абана, щоб віряни могли кидати жертвоприношення в очищувальний вогонь.	true
missions_localised_description_att_senate_eastern_roman_construct_bch_roman_east_military_1	Армія - хребет країни. Сенат просить зберегти цю традицію.	true
missions_localised_description_att_senate_nordic_construct_bch_barbmigs_industry_1	Ми повинні більш дбайливо використовувати доступні ресурси. Цей край може дати нам набагато більше.	true
missions_localised_title_att_religious_zoroastrian_convert_region_1	Релігійна вимога	true
missions_localised_title_att_diplomatic_nomadic_engage_force_navy_1	Взаємодія на війні	true
missions_localised_description_att_religious_arian_assassinate_character_1	Єретик має померти. Нехай горить у божественному вогні!	true
missions_localised_title_att_objective_huns_primary_5_seal_6	Глава V: Виправдання	true
missions_localised_title_att_objective_huns_primary_4_seal_5	Розділ IV: Відплата	true
missions_localised_title_att_objective_huns_primary_3_seal_4	Розділ III: Спустошення	true
missions_localised_title_att_objective_huns_primary_2_seal_3	Розділ II: Розорення	true
missions_localised_title_att_objective_huns_primary_1_seal_2	Глава I: Підготовка	true
missions_localised_title_att_religious_arian_recruit_agent_1	Релігійна вимога	true
missions_localised_title_att_senate_eastern_research_technology_military_1	Прогрес військової справи	true
missions_localised_description_att_senate_eastern_engage_force_army_1	Наші воєначальники стверджують, що ми здобудемо перемогу у війні тільки в тому разі, якщо розгромимо цю армію.	true
missions_localised_title_att_religious_manichaeism_construct_bch_religion_manichaeist_major_1	Релігійна вимога	true
missions_localised_description_att_diplomatic_eastern_blockade_port_1	Нас попросили блокувати морські торгові шляхи противника.	true
missions_localised_title_cha_mission_english_kingdom	Королівство Англія	true
missions_localised_description_att_diplomatic_eastern_roman_blockade_port_1	Нас попросили блокувати морські торгові шляхи противника.	true
missions_localised_title_pro_destroy_rebels_petrodava	Придушіть повстання	true
missions_localised_title_att_senate_eastern_make_alliance_1	Надійний друг	true
missions_localised_description_att_diplomatic_western_roman_blockade_port_1	Нас попросили блокувати морські торгові шляхи противника.	true
missions_localised_title_att_victory_mission_2_military_victory	Військова перемога	true
missions_localised_description_att_diplomatic_nomadic_mercenary_engage_force_army_1	Нам пропонують золото, сяюче, як саме сонце, якщо ми розгромимо цю армію.	true
missions_localised_title_att_objective_white_huns_primary_5_seal_6	Глава V: Виправдання	true
missions_localised_title_att_objective_white_huns_primary_3_seal_4	Розділ III: Спустошення	true
missions_localised_title_att_objective_white_huns_primary_4_seal_5	Розділ IV: Відплата	true
missions_localised_title_att_objective_white_huns_primary_1_seal_2	Глава I: Підготовка	true
missions_localised_title_att_objective_white_huns_primary_2_seal_3	Розділ II: Розорення	true
missions_localised_title_cha_mission_avar_khaganate	Аварський каганат	true
missions_localised_title_att_vc_2_imperial_separatist	Тріумф лоялістів	true
missions_localised_title_att_religious_celtic_assassinate_character_1	Релігійна вимога	true
missions_localised_description_att_senate_eastern_roman_research_technology_civil_1	Проблеми всередині держави множаться з лякаючою швидкістю. Може, ними займуться наші найкращі уми?	true
missions_localised_description_att_senate_western_roman_research_technology_civil_1	Проблеми всередині держави множаться з лякаючою швидкістю. Може, ними займуться наші найкращі уми?	true
missions_localised_title_att_senate_eastern_lift_blockade_1	Прорив блокади	true
missions_localised_title_att_religious_tengri_construct_building_religious_1	Релігійна вимога	true
missions_localised_description_att_senate_western_roman_construct_bch_roman_west_military_1	Легіони - хребет нашого народу. Сенат просить нас не забувати про це.	true
missions_localised_description_att_mp_coop_loyalist	Спільна перемога лоялістів	true
missions_localised_title_att_bel_request_antoninia_ioannina_1	Прохання Антоніни: Іоанніна	true
missions_localised_description_att_objective_suebi_primary_3_seal_4	Залиш будь-яку надію.	true
missions_localised_description_att_objective_suebi_primary_4_seal_5	Немає пощади грішникам.	true
missions_localised_description_att_objective_suebi_primary_5_seal_6	Час відплати настав.	true
missions_localised_description_att_objective_suebi_primary_1_seal_2	Вони готувалися до війни.	true
missions_localised_description_att_objective_suebi_primary_2_seal_3	Аттіла народився з темряви і відчаю.	true
missions_localised_description_att_religious_tengri_assassinate_character_1	Усі люди народжені, щоб померти, і його час настав. На нього чекають сини та доньки Ерліка.	true
missions_localised_title_att_senate_nordic_recruit_agent_veteran_1	Легенда	true
missions_localised_description_att_vc_1_historical_expedition	Перемога сепаратистів	true
missions_localised_description_att_senate_nordic_recruit_agent_spy_1	Хоча нашому народу більше до душі чесний бій, нам слід набрати розвідників. Нехай вони доставляють нам відомості, нехай турбують противника. Тоді перемога точно буде на нашому боці.	true
missions_localised_description_att_religious_catholic_recruit_agent_1	Папа римський просить провести рукопокладення нового священика, щоб той поширював вчення про істинну віру і в нашій країні, і за її межами.	true
missions_localised_description_cha_mission_italian_kingdom	Здобудьте могутність, побудуйте своє королівство, створіть спадщину на століття - і ваше ім'я назавжди увійде в історію!	true
missions_localised_title_att_senate_eastern_blockade_port_1	Блокада	true
missions_localised_title_att_diplomatic_eastern_engage_force_army_1	Взаємодія на війні	true
missions_localised_title_att_vc_2_imperial_expedition	Тріумф Західної Римської імперії	true
missions_localised_title_att_bel_request_justinian_photius_1	Прохання Юстиніана: Фотій	true
missions_localised_title_att_test_victory_mission_economic	Тестова економічна перемога	true
missions_localised_title_att_religious_germanic_declare_war_1	Релігійна вимога	true
missions_localised_description_att_senate_nomadic_construct_bch_nomad_noble_1	Вожді втомилися від нескінченних воєн. Потрібно організувати для них що-небудь особливе.	true
missions_localised_title_cha_mission_spanish_kingdom	Королівство Іспанія	true
missions_localised_title_att_senate_western_roman_construct_bch_roman_civic_major_1	Міське будівництво	true
missions_localised_title_att_senate_eastern_roman_construct_bch_roman_water_minor_1	Міське будівництво	true
missions_localised_title_att_eos_religious_mission_build_att_rel_church_east	Архієпископ - благочестя	true
missions_localised_description_att_senate_eastern_roman_recruit_unit_ranged_1	Сенат просить у його імператорської величності найняти більше лучників, щоб вони знищували ворога здалеку.	true
missions_localised_description_att_senate_western_roman_declare_war_1	Війна завжди має бути останнім засобом залагодження суперечок. Але Сенат хоче, щоб ми ліквідували цю загрозу в зародку, поки вона ще не вийшла з-під контролю.	true
missions_localised_description_att_vc_1_historical_separatist	Перемога експедиції	true
missions_localised_description_att_diplomatic_eastern_raid_region_1	Союзник попросив нас влаштувати наліт на цей регіон, щоб перешкодити ворожій торгівлі.	true
missions_localised_title_att_religious_christian_reform_pentarchy_1	Реформувати Пентархію	true
missions_localised_title_att_vc_1_zoroastrism	Релігійна перемога зороастрійців	true
missions_localised_title_att_vc_2_zoroastrism	Релігійна перемога зороастрійців	true
missions_localised_description_att_senate_nordic_recruit_unit_naval_1	Наші армії переможно крокують сушею, але на морі нас перевершують інші народи, народи другого сорту. Давай побудуємо флот, щоб він міг розоряти їхні поселення.	true
missions_localised_title_att_religious_orthodox_declare_war_1	Релігійна вимога	true
missions_localised_title_att_religious_tengri_recruit_agent_1	Релігійна вимога	true
missions_localised_description_cha_mission_asturias_1	Мій пане, прибуло послання від папи! Він хоче принести світло християнства в Іберію і доручає це вам. Проповідь слави Божої - сама по собі нагорода, але понтифік щедро погодився оплатити будівництво всіх церковних споруд, які ми зведемо на виконання його волі. Віряни всієї Іберії дивляться на вас. Немає більшої честі, ніж врятувати їх з рук єретиків!	true
missions_localised_description_att_religious_catholic_construct_bch_religion_catholic_minor_1	Його святість просить тебе побудувати монумент, що прославляє Господа, щоб благочестиві могли молитися.	true
missions_localised_description_att_religious_germanic_construct_bch_religion_germanic_minor_1	Ми повинні будувати храми і монументи на честь богів, щоб заслужити їхнє благовоління.	true
missions_localised_description_att_religious_orthodox_construct_bch_religion_orthodox_minor_1	Патріарх просить нас побудувати церкву, щоб про нашу віру дізналося більше людей.	true
missions_localised_description_att_objective_bel_visigoths_primary_1_seal_2	Результати важких перемог під загрозою. Минуле звернуло на нас свій похмурий і згубний погляд. У цьому важкому становищі імператор відправив війська в похід, щоб відновити колишню імперію. Вони неминуче зазнають поразки у війні з новим королівством!	true
missions_localised_description_att_objective_bel_visigoths_primary_2_seal_3	Сірі небеса віщують усім нам похмурі часи. Але ми вистоїмо і задушимо наших ворогів попелом і смогом.	true
missions_localised_description_att_objective_bel_visigoths_primary_5_seal_6	Ми домоглися майже неможливого. Наші противники втрачають надію, довго вони не вистоять. Ми створимо новий світ із попелу старого!	true
missions_localised_description_att_objective_bel_visigoths_primary_3_seal_4	Колишній світ імперій гине. Але приходить новий світ, світ королівств. Місце в ньому знайдеться тільки найсильнішим. І ми будемо серед них!	true
missions_localised_description_att_objective_bel_visigoths_primary_4_seal_5	Світ змінився назавжди. Старі імперії впали і звільнили дорогу новій великій державі. Розширимо ж її межі та закріпимо свій успіх навічно!	true
missions_localised_title_att_objective_axum_primary_5_seal_6	Глава V: Виправдання	true
missions_localised_title_att_objective_axum_primary_3_seal_4	Розділ III: Спустошення	true
missions_localised_title_att_objective_axum_primary_4_seal_5	Розділ IV: Відплата	true
missions_localised_title_att_objective_axum_primary_1_seal_2	Глава I: Підготовка	true
missions_localised_title_att_objective_axum_primary_2_seal_3	Розділ II: Розорення	true
missions_localised_title_att_senate_eastern_recruit_unit_cavalry_1	Підкріплення	true
missions_localised_description_att_religious_orthodox_recruit_agent_1	Патріарх просить, щоб ми рукопоклали нового священика. Він буде вірно служити і принесе користь державі.	true
missions_localised_description_att_religious_germanic_recruit_agent_1	Коли ми піднімаємо чаші на честь богів, боги набувають сили. Наші жерці просять взяти на службу одного з них, щоб міць богів не вичерпувалася.	true
missions_localised_title_att_religious_zoroastrian_construct_bch_religion_zoroastrian_minor_1	Релігійна вимога	true
missions_localised_description_att_religious_catholic_declare_war_1	Папа римський оголосив хрестовий похід проти цих єретиків і просить тебе виконати його волю.	true
missions_localised_title_att_senate_eastern_roman_construct_bch_roman_civic_major_1	Міське будівництво	true
missions_localised_title_att_senate_western_roman_construct_bch_roman_water_minor_1	Міське будівництво	true
missions_localised_description_att_objective_picts_primary_1_seal_2	Вони готувалися до війни.	true
missions_localised_description_att_objective_picts_primary_2_seal_3	Аттіла народився з темряви і відчаю.	true
missions_localised_description_att_objective_picts_primary_3_seal_4	Залиш надію.	true
missions_localised_description_att_objective_picts_primary_4_seal_5	Немає пощади грішникам.	true
missions_localised_description_att_objective_picts_primary_5_seal_6	Час відплати настав.	true
missions_localised_title_att_objective_burgundians_primary_1_seal_2	Глава I: Підготовка	true
missions_localised_title_att_objective_burgundians_primary_2_seal_3	Розділ II: Розорення	true
missions_localised_title_att_objective_burgundians_primary_5_seal_6	Глава V: Виправдання	true
missions_localised_description_att_senate_western_roman_engage_force_army_1	До Сенату дійшли чутки про те, що солдати цієї армії називають нас боягузами і слабаками. Доведемо ворогові, що вони помиляються...	true
missions_localised_title_att_objective_burgundians_primary_3_seal_4	Розділ III: Спустошення	true
missions_localised_title_att_objective_burgundians_primary_4_seal_5	Розділ IV: Відплата	true
missions_localised_title_att_bel_request_antoninia_rumours_2	Прохання Антоніни: Феодосій	true
missions_localised_description_att_senate_eastern_roman_engage_force_army_1	До Сенату дійшли чутки про те, що солдати цієї армії називають нас боягузами і слабаками. Народ в люті!	true
missions_localised_title_att_senate_eastern_roman_engage_force_navy_1	У глибини	true
missions_localised_description_att_senate_western_roman_recruit_unit_ranged_1	Сенат просить у його імператорської величності найняти більше лучників, щоб вони знищували ворога здалеку.	true
missions_localised_description_att_objective_vandals_primary_3_seal_4	Залиш будь-яку надію.	true
missions_localised_description_att_objective_vandals_primary_4_seal_5	Немає пощади грішникам.	true
missions_localised_description_att_objective_vandals_primary_5_seal_6	Час відплати настав.	true
missions_localised_description_att_objective_vandals_primary_1_seal_2	Вони готувалися до війни.	true
missions_localised_description_att_objective_vandals_primary_2_seal_3	Аттіла народився з темряви і відчаю.	true
missions_localised_title_att_senate_western_roman_engage_force_navy_1	У глибини	true
missions_localised_title_att_bel_request_antoninia_philotus_1	Прохання Антоніни: Фотій	true
missions_localised_description_att_senate_eastern_roman_declare_war_1	Сенат вимагає, щоб ми знищили цю загрозу ще в зародку.	true
missions_localised_description_att_senate_eastern_research_technology_civil_1	Наші найбільші мудреці вважають, що вони зможуть поліпшити життя народу. Може, до них варто прислухатися?	true
missions_localised_description_att_religious_celtic_recruit_agent_1	Друїди просять тебе взяти на службу одного з них. Вони кажуть, що інакше боги зачахнуть і покинуть наш світ.	true
missions_localised_description_att_religious_hellenic_declare_war_1	Оракул передбачив, що перемога над цим народом принесе нам величезні багатства. Верховні жерці просять нас оголосити війну.	true
missions_localised_title_mk_religious_shia_assassinate_character_1	Релігійна вимога	true
missions_localised_description_mk_religious_shia_construct_bch_religion_shia_minor_1	Улеми просять нас побудувати мечеть, щоб про нашу віру дізналося більше людей.	true
missions_localised_description_att_vc_1_pagan	Перемога язичників	true
missions_localised_description_att_vc_2_pagan	Релігійна перемога язичників	true
missions_localised_title_att_senate_western_roman_engage_force_army_1	Військова слава	true
missions_localised_title_att_senate_eastern_roman_engage_force_army_1	Військова слава	true
missions_localised_title_att_religious_catholic_declare_war_1	Релігійна вимога	true
missions_localised_description_cha_mission_english_kingdom	Здобудьте могутність, побудуйте своє королівство, створіть спадщину на століття - і ваше ім'я назавжди увійде в історію!	true
missions_localised_title_att_objective_picts_primary_4_seal_5	Розділ IV: Відплата	true
missions_localised_title_att_objective_picts_primary_3_seal_4	Розділ III: Спустошення	true
missions_localised_title_att_objective_picts_primary_5_seal_6	Глава V: Виправдання	true
missions_localised_title_att_objective_picts_primary_2_seal_3	Розділ II: Розорення	true
missions_localised_title_att_objective_picts_primary_1_seal_2	Глава I: Підготовка	true
missions_localised_description_att_religious_zoroastrian_construct_bch_religion_zoroastrian_minor_1	Волхви просять нас побудувати храм одночасно і для Атара, і для Абана, щоб віряни могли кидати жертвоприношення в очищувальний вогонь.	true
missions_localised_description_cha_mission_vikings_1	Відправте свої війська у великий похід за Північне море, до багатих християнських монастирів. Нехай народ переконається, що ви відважні та сповнені сил. Заткніть горлянки всім, хто сумнівається у вашій владі, і доведіть полководцям, що під вашим проводом на них чекають слава і шана. На Англію! За багатством! До бою!	true
missions_localised_description_att_senate_nordic_assassinate_character_agent_female_1	Ця жінка зломислить проти нас. Її потрібно якомога швидше усунути!	true
missions_localised_title_att_test_victory_mission_cultural	Тестова культурна перемога	true
missions_localised_description_att_senate_nomadic_engage_force_army_1	Якщо нічого не зробити, рано чи пізно ця армія становитиме загрозу. Ми повинні негайно її розгромити!	true
missions_localised_title_att_religious_celtic_recruit_agent_1	Релігійна вимога	true
missions_localised_title_att_religious_hellenic_declare_war_1	Релігійна вимога	true
missions_localised_description_att_religious_manichaeism_construct_building_1	Наші священники просять нас побудувати храм одночасно і для Атара, і для Абана, щоб віряни могли кидати жертвоприношення в очищувальний вогонь.	true
missions_localised_description_att_diplomatic_nomadic_blockade_port_1	Нас попросили блокувати морські торгові шляхи противника.	true
missions_localised_title_att_senate_nomadic_make_alliance_1	Надійний друг	true
missions_localised_description_att_bel_request_antoninia_philotus_1	Фотій доводить мене до відчаю. Я розумію, батьківські почуття вимагають його пощадити, але його брехня та інтриги гублять нашу сім'ю. Я просто не бачу іншого виходу...	true
missions_localised_title_mk_religious_cathar_declare_war_1	Релігійна вимога	true
missions_localised_description_att_senate_eastern_roman_engage_force_navy_1	На морі повинні правити тільки ми... Сенат бажає, щоб цей флот був знищений.	true
missions_localised_description_att_senate_western_roman_engage_force_navy_1	Тільки ми повинні правити на морі. Кому ще можна довірити його багатства?	true
missions_localised_description_att_vc_1_zoroastrism	Релігійна перемога зороастрійців	true
missions_localised_description_att_vc_2_zoroastrism	Релігійна перемога зороастрійців	true
missions_localised_title_mk_religious_jewish_declare_war_1	Релігійна вимога	true
missions_localised_description_att_religious_tengri_construct_building_religious_1	Умай змушує трави рости і дарує добробут нашому народу. Так і ми повинні вшанувати богів, побудувавши монумент на честь наших предків.	true
missions_localised_description_att_religious_orthodox_declare_war_1	Єретики з цього народу переслідують і принижують послідовників істинної віри. Патріарх просить нас втрутитися.	true
missions_localised_title_att_senate_eastern_roman_construct_bch_roman_water_major_1	Міське будівництво	true
missions_localised_title_att_objective_bel_visigoths_primary_5_seal_6	Глава V: Нестримний	true
missions_localised_title_att_objective_bel_visigoths_primary_4_seal_5	Розділ IV: Новий світ	true
missions_localised_title_att_objective_bel_visigoths_primary_3_seal_4	Розділ III: Королівство на руїнах імперії	true
missions_localised_title_att_objective_bel_visigoths_primary_2_seal_3	Глава II: Вільний і самостійний	true
missions_localised_title_att_objective_bel_visigoths_primary_1_seal_2	Глава I: По праву наше	true
missions_localised_description_att_religious_tengri_recruit_agent_1	Радники просять найняти ще одного агента-жерця.	true
missions_localised_title_att_senate_nordic_assassinate_character_general_1	Смерть до терміну	true
missions_localised_description_att_religious_hellenic_assassinate_character_1	Ця людина - богохульник, і боги вимагають його крові! Відправ його в пекло!	true
missions_localised_description_att_vc_1_historical	Історична перемога	true
missions_localised_description_att_senate_nordic_recruit_unit_siege_1	Нехай вороги вважають, що за стінами фортеці вони в безпеці. Ми побудуємо облогові машини, які рознесуть їхню впевненість ущент.	true
missions_localised_description_att_religious_germanic_declare_war_1	Авгури одностайні: боги вимагають крові. Будемо готуватися до війни.	true
missions_localised_title_slav_mission_sclaveneans_1	Полювання на гунів	true
missions_localised_title_slav_mission_sclaveneans_2	Полювання на гунів	true
missions_localised_description_att_victory_mp_coop	Перемога у спільній мережевій грі	true
missions_localised_title_att_diplomatic_eastern_raid_region_1	Взаємодія на війні	true
missions_localised_description_att_religious_catholic_construct_bch_religion_catholic_major_1	Його святість просить тебе побудувати монумент, що прославляє Господа, щоб благочестиві могли молитися.	true
missions_localised_description_att_religious_germanic_construct_bch_religion_germanic_major_1	Ми повинні будувати храми і монументи на честь богів, щоб заслужити їхнє благовоління.	true
missions_localised_description_att_religious_orthodox_construct_bch_religion_orthodox_major_1	Патріарх просить нас побудувати церкву, щоб про нашу віру дізналося більше людей.	true
missions_localised_title_att_religious_celtic_construct_building_religious_1	Релігійна вимога	true
missions_localised_title_att_senate_nomadic_recruit_unit_infantry_1	Підкріплення	true
missions_localised_title_att_senate_nordic_construct_bch_barbmigs_military_1	Військове будівництво	true
missions_localised_title_att_religious_tengri_declare_war_1	Релігійна вимога	true
missions_localised_title_att_religious_arian_construct_building_religious_1	Релігійна вимога	true
missions_localised_title_att_senate_nordic_construct_bch_barbmigs_industry_1	Міське будівництво	true
missions_localised_title_att_senate_western_roman_construct_bch_roman_water_major_1	Міське будівництво	true
missions_localised_description_att_vc_2_imperial_expedition	Тріумф Західної Римської імперії	true
missions_localised_title_att_victory_mission_2_cultural_victory	Культурна перемога	true
missions_localised_description_att_objective_huns_primary_2_seal_3	Аттіла народився з темряви і відчаю.	true
missions_localised_description_att_objective_huns_primary_1_seal_2	Вони готувалися до війни.	true
missions_localised_title_att_senate_nomadic_recruit_unit_cavalry_1	Підкріплення	true
missions_localised_description_att_objective_huns_primary_4_seal_5	Немає пощади грішникам.	true
missions_localised_title_att_diplomatic_eastern_engage_force_navy_1	Взаємодія на війні	true
missions_localised_description_att_objective_huns_primary_3_seal_4	Залиш будь-яку надію.	true
missions_localised_description_att_objective_huns_primary_5_seal_6	Час відплати настав.	true
missions_localised_title_att_religious_arian_assassinate_character_1	Релігійна вимога	true
missions_localised_description_mk_religious_shia_construct_bch_religion_shia_major_1	Улеми просять нас побудувати мечеть, щоб про нашу віру дізналося більше людей.	true
missions_localised_title_att_religious_celtic_declare_war_1	Релігійна вимога	true
missions_localised_description_att_religious_arian_recruit_agent_1	Ваші єпископи просять тебе збільшити кількість священників.	true
missions_localised_title_mk_religious_eastern_assassinate_character_1	Релігійна вимога	true
missions_localised_description_att_senate_eastern_recruit_agent_spy_1	Землі ворогів великі, і ми не можемо бути скрізь одночасно. Може, найняти агента, щоб він діяв від нашого імені?	true
missions_localised_description_att_senate_western_roman_assassinate_character_agent_female_1	Сенат просить негайно доручити нашим агентам убити цю жінку.	true
missions_localised_description_mk_religious_eastern_construct_bch_religion_eastern_major_1	Патріарх просить нас побудувати церкву, щоб про нашу віру дізналося більше людей.	true
missions_localised_description_att_diplomatic_barbarian_engage_force_army_1	Союзники попросили нас стерти цю армію в порох.	true
missions_localised_title_att_diplomatic_barbarian_engage_force_navy_1	Взаємодія на війні	true
missions_localised_description_att_diplomatic_nomadic_assassinate_character_general_1	Наш союзник засудив цього полководця до смерті.	true
missions_localised_title_att_diplomatic_nomadic_assassinate_character_agent_male_1	Взаємодія на війні	true
missions_localised_description_att_vc_2_imperial	Тріумф імперії	true
missions_localised_description_att_objective_venedi_primary_1_seal_2	Вони готувалися до війни.	true
missions_localised_description_att_objective_venedi_primary_2_seal_3	Аттіла народився з темряви і відчаю.	true
missions_localised_description_att_objective_venedi_primary_3_seal_4	Залиш будь-яку надію.	true
missions_localised_title_att_senate_western_roman_capture_regions_own_settlement_1	Звільнення	true
missions_localised_description_att_objective_venedi_primary_4_seal_5	Немає пощади грішникам.	true
missions_localised_description_att_objective_venedi_primary_5_seal_6	Час відплати настав.	true
missions_localised_title_mk_religious_cathar_convert_region_1	Релігійна вимога	true
missions_localised_title_cha_mission_saxon_kingdom	Королівство саксів	true
missions_localised_description_att_senate_eastern_roman_construct_building_economic_1	Наша торгівля, наші ринки занепали. Нам слід сприяти їхньому розвитку.	true
missions_localised_title_ch_vc_3_domination	Перемога через домінування	true
missions_localised_description_att_senate_western_roman_construct_bch_all_livestock_1	Наша торгівля, наші ринки занепали. Нам слід знайти нові способи поліпшити економіку.	true
missions_localised_description_att_religious_germanic_construct_building_religious_1	Ми повинні будувати храми і монументи на честь богів, щоб заслужити їхнє благовоління.	true
missions_localised_description_att_religious_hellenic_construct_building_religious_1	Оракул каже, що на нас чекають великі нещастя, якщо ми не будемо шанувати богів. Жерці пропонують умилостивити їх, побудувавши храм.	true
missions_localised_title_att_senate_eastern_capture_regions_port_1	Вторгнення	true
missions_localised_description_att_senate_western_roman_raid_region_1	Розори цей край, щоб зірвати плани ворога і водночас наповнити нашу скарбницю.	true
missions_localised_description_att_senate_western_roman_construct_bch_all_military_upgrades_1	Легіони - хребет нашого народу. Сенат просить нас не забувати про це.	true
missions_localised_title_att_senate_eastern_construct_bch_all_city_minor_1	Міське будівництво	true
missions_localised_title_mk_religious_sunni_recruit_agent_1	Релігійна вимога	true
missions_localised_description_att_senate_nordic_engage_force_army_1	Усі знають, що наші люди - природжені воїни. Нехай розгромлять цю шваль!	true
missions_localised_title_att_religious_zoroastrian_construct_bch_religion_zoroastrian_major_burial_1	Релігійна вимога	true
missions_localised_title_att_senate_nordic_blockade_port_1	Блокада	true
missions_localised_title_att_religious_arian_construct_bch_religion_arian_legendary_1	Релігійна вимога	true
missions_localised_title_att_senate_nordic_construct_bch_barbarian_industry_1	Міське будівництво	true
missions_localised_title_pro_recruit_agent	Найміть агента	true
missions_localised_description_att_senate_eastern_construct_bch_all_industry_minor_1	Цей край багатий, у ньому багато сировини. Воно має принести користь Царю царів.	true
missions_localised_description_att_religious_catholic_construct_building_religious_1	Його святість просить тебе побудувати монумент, що прославляє Господа, щоб благочестиві могли молитися.	true
missions_localised_description_att_senate_nordic_raise_force_army_1	Наші воєначальники мріють про битви. Наберемо кілька армій, щоб полководці змогли здійснити свої мрії.	true
missions_localised_title_cha_objective_cha_mercia_primary_5_seal_6	Відродження Європи	true
missions_localised_title_cha_objective_cha_mercia_primary_3_seal_4	Прибій війни	true
missions_localised_title_cha_objective_cha_mercia_primary_4_seal_5	Створена спадщина	true
missions_localised_title_cha_objective_cha_mercia_primary_1_seal_2	Розколотий світ	true
missions_localised_title_cha_objective_cha_mercia_primary_2_seal_3	Королівське ім'я	true
missions_localised_title_att_senate_nordic_assassinate_character_agent_male_1	Смерть до терміну	true
missions_localised_description_att_victory_mission_3_divine_triumph	Божественний тріумф	true
missions_localised_title_att_senate_nordic_raise_force_navy_1	Заклик до зброї	true
missions_localised_description_att_senate_nordic_construct_bch_barbmigs_leadership_1	Ми повинні виказати повагу нашому народу, зводячи будівлі, що збагачують його культуру.	true
missions_localised_description_att_senate_western_roman_recruit_unit_siege_1	Наші балістарії скаржаться на брак хороших облогових машин. Сенат попросив нас зайнятися цією справою.	true
missions_localised_title_cha_mission_pope_attacked_1	Око за око	true
missions_localised_title_att_diplomatic_barbarian_assassinate_character_agent_male_1	Взаємодія на війні	true
missions_localised_description_att_senate_western_roman_construct_building_economic_1	Наша торгівля, наші ринки занепали. Нам слід знайти нові способи поліпшити економіку.	true
missions_localised_description_att_senate_eastern_roman_construct_bch_all_livestock_1	Наша торгівля, наші ринки занепали. Нам слід сприяти їхньому розвитку.	true
missions_localised_title_mk_religious_jewish_construct_bch_religion_jewish_minor_1	Релігійна вимога	true
missions_localised_title_att_senate_eastern_roman_raise_force_army_1	Військова експансія	true
missions_localised_title_att_senate_western_roman_raise_force_army_1	Заклик до зброї	true
missions_localised_description_att_senate_eastern_roman_construct_bch_all_industry_major_1	Наша торгівля, наші ринки занепали. Нам слід сприяти їхньому розвитку.	true
missions_localised_description_att_senate_western_roman_construct_bch_all_industry_major_1	Наша торгівля, наші ринки занепали. Нам слід знайти нові способи поліпшити економіку.	true
missions_localised_title_mk_religious_eastern_construct_building_religious_1	Релігійна вимога	true
missions_localised_description_att_vc_wonder_civic_2	Божественний культурний тріумф	true
missions_localised_description_att_vc_wonder_civic_1	Культурна перемога	true
missions_localised_description_att_objective_ebdani_primary_1_seal_2	Вони готувалися до війни.	true
missions_localised_title_mk_religious_cathar_construct_building_religious_1	Релігійна вимога	true
missions_localised_description_att_objective_ebdani_primary_2_seal_3	Аттіла народився з темряви і відчаю.	true
missions_localised_description_att_objective_ebdani_primary_5_seal_6	Час відплати настав.	true
missions_localised_description_att_objective_ebdani_primary_3_seal_4	Залиш надію.	true
missions_localised_description_att_objective_ebdani_primary_4_seal_5	Немає пощади грішникам.	true
missions_localised_description_att_senate_eastern_roman_raid_region_1	Ми повинні набити нашу скарбницю. Розграбуй цей край, завдай шкоди ворогові.	true
missions_localised_description_att_senate_eastern_roman_construct_bch_all_military_upgrades_1	Армія - хребет країни. Сенат просить зберегти цю традицію.	true
missions_localised_description_att_senate_eastern_construct_bch_eastern_sassanid_military_cavalry_1	Нові військові споруди лише зміцнять славу Царя царів.	true
missions_localised_title_mk_religious_baltic_construct_bch_religion_baltic_major_1	Релігійна вимога	true
missions_localised_description_mk_religious_ibadi_convert_region_1	Улеми просять нас навернути невірних і зробити цей регіон територією ісламу.	true
missions_localised_description_mk_religious_cathar_assassinate_character_1	Ця людина - агент іноземної держави, вона загрожує спокою і свободі наших громад. Його слід негайно зупинити!	true
missions_localised_title_mk_religious_cathar_recruit_agent_1	Релігійна вимога	true
missions_localised_description_att_diplomatic_nomadic_capture_regions_city_1	Союзники попросили нас захопити це поселення, щоб тим самим послабити наших ворогів.	true
missions_localised_title_mk_religious_jewish_construct_building_religious_1	Релігійна вимога	true
missions_localised_title_att_religious_zoroastrian_construct_bch_religion_zoroastrian_major_fire_1	Релігійна вимога	true
missions_localised_description_att_eos_axum_mission_2	Два прекрасних порти з прянощами тільки й чекають, коли їх захоплять. Що може бути приємнішим, ніж титул "володаря прянощів"? З новими військами сасаніди перестануть бути загрозою, а бажана нагорода стане близькою як ніколи!	true
missions_localised_description_att_eos_axum_mission_3	Західна торгівля своїм карбуванням монет не дає розвиватися нашій монополії на прянощі! Потрібно захопити землю, де видобувають золото і карбують монети, щоб стати повновладним господарем і в економіці.	true
missions_localised_description_att_eos_axum_mission_1	Вдихни солодкий аромат Сходу, повелителю! Омана, Мешан або Гармозія стануть служити нашим цілям, якщо ти дозволиш своїм воїнам захопити їх. Мої кораблі стоять на якорі, чекаючи на накази.	true
missions_localised_title_att_senate_eastern_assassinate_character_general_1	Смерть до терміну	true
missions_localised_description_mk_religious_jewish_recruit_agent_1	Синедріон просить, щоб ми призначили нового рабина, який очолить нашу громаду.	true
missions_localised_description_mk_religious_eastern_construct_bch_religion_eastern_minor_1	Патріарх просить нас побудувати церкву, щоб про нашу віру дізналося більше людей.	true
missions_localised_title_mk_religious_jewish_assassinate_character_1	Релігійна вимога	true
missions_localised_title_att_senate_nomadic_capture_regions_port_1	Вторгнення	true
missions_localised_title_att_senate_eastern_construct_bch_eastern_sassanid_military_cavalry_1	Військове будівництво	true
missions_localised_title_att_senate_eastern_roman_raise_force_navy_1	Заклик до зброї	true
missions_localised_title_att_senate_western_roman_raise_force_navy_1	Заклик до зброї	true
missions_localised_title_mk_religious_ibadi_recruit_agent_1	Релігійна вимога	true
missions_localised_title_mk_religious_sunni_convert_region_1	Релігійна вимога	true
missions_localised_title_att_senate_eastern_roman_assassinate_character_agent_male_1	Смерть до терміну	true
missions_localised_title_att_senate_western_roman_assassinate_character_agent_male_1	Смерть до терміну	true
missions_localised_title_att_senate_nomadic_recruit_agent_veteran_1	Гідний командир	true
missions_localised_description_cha_objective_cha_westphalia_primary_5_seal_6	Слава Європи - в єдності. Нехай же ніхто не посміє відокремитися від великої держави, створеної істинним королем!	true
missions_localised_description_cha_objective_cha_westphalia_primary_4_seal_5	Здійснюючи великі діяння, король створює спадщину, непідвладну часу і смерті.	true
missions_localised_description_cha_objective_cha_westphalia_primary_3_seal_4	Вороги б'ються об армію істинного короля, немов хвилі об берег. Рішучий, він встоїть під їхніми ударами.	true
missions_localised_title_att_diplomatic_nomadic_assassinate_character_agent_female_1	Взаємодія на війні	true
missions_localised_description_cha_objective_cha_westphalia_primary_2_seal_3	Перш ніж істинний король затвердить свою владу над землею, його ім'я повинно прозвучати з усіх чотирьох сторін.	true
missions_localised_description_cha_objective_cha_westphalia_primary_1_seal_2	Дрібні правителі подібні до псів, що шматують тіло Європи. Істинний король повстане і розжене їх.	true
missions_localised_description_cha_objective_cha_asturias_primary_3_seal_4	Вороги б'ються об армію істинного короля, немов хвилі об берег. Рішучий, він встоїть під їхніми ударами.	true
missions_localised_description_cha_objective_cha_asturias_primary_4_seal_5	Здійснюючи великі діяння, король створює спадщину, непідвладну часу і смерті.	true
missions_localised_description_cha_objective_cha_asturias_primary_5_seal_6	Слава Європи - в єдності. Нехай же ніхто не посміє відокремитися від великої держави, створеної істинним королем!	true
missions_localised_description_cha_objective_cha_asturias_primary_1_seal_2	Дрібні правителі подібні до псів, що шматують тіло Європи. Істинний король повстане і розжене їх.	true
missions_localised_description_cha_objective_cha_asturias_primary_2_seal_3	Перш ніж істинний король затвердить свою владу над землею, його ім'я повинно прозвучати з усіх чотирьох сторін.	true
missions_localised_title_att_senate_nordic_raise_force_army_1	Заклик до зброї	true
missions_localised_description_att_victory_mp_versus	Перемога в змагальній мережевій грі	true
missions_localised_description_att_senate_nordic_construct_bch_barbarian_industry_1	Ми повинні більш дбайливо використовувати доступні ресурси. Цей край може дати нам набагато більше.	true
missions_localised_description_cha_mission_avars_1	Народ поважає силу, мій пане, а силу найкраще видно на війні. Вторгніться в землі цих нечестивців і заберіть усе цінне, що в них є, включно з їхніми життями. Нехай вони пізнають гнів нашого племені, а ви знайдете честь!	true
missions_localised_description_att_religious_arian_construct_bch_religion_arian_legendary_1	Єпископ просить, щоб ми побудували церкву для святої скинії і славили Всевишнього.	true
missions_localised_description_att_diplomatic_eastern_roman_capture_regions_port_1	Нас попросили завдати удару по торгових шляхах противника.	true
missions_localised_description_att_diplomatic_western_roman_capture_regions_port_1	Нас попросили завдати удару по торгових шляхах противника.	true
missions_localised_title_cha_objective_cha_lombards_primary_3_seal_4	Прибій війни	true
missions_localised_title_cha_objective_cha_lombards_primary_4_seal_5	Створена спадщина	true
missions_localised_title_cha_objective_cha_lombards_primary_5_seal_6	Відродження Європи	true
missions_localised_title_cha_objective_cha_lombards_primary_1_seal_2	Розколотий світ	true
missions_localised_title_cha_objective_cha_lombards_primary_2_seal_3	Королівське ім'я	true
missions_localised_title_att_senate_eastern_construct_bch_all_city_major_1	Міське будівництво	true
missions_localised_title_att_diplomatic_eastern_assassinate_character_agent_male_1	Взаємодія на війні	true
missions_localised_description_att_senate_nordic_assassinate_character_agent_male_1	Вожді хочуть, щоб ця людина забралася з нашої землі. Вони вважають, що він бажає нам зла.	true
missions_localised_description_att_senate_nordic_raise_force_navy_1	Якщо ми хочемо розорити ворожі порти і торгові шляхи, нам слід призначити нового флотоводця, який поведе кораблі до перемоги.	true
missions_localised_title_att_victory_mission_3_divine_triumph	Божественний тріумф	true
missions_localised_title_att_senate_nomadic_construct_bch_nomad_warriors_1	Військове будівництво	true
missions_localised_title_pro_recapture_olbia	Звільніть Ольвію	true
missions_localised_description_att_senate_eastern_construct_bch_all_industry_major_1	Цей край багатий, у ньому багато сировини. Воно має принести користь Царю царів.	true
missions_localised_description_att_senate_nordic_engage_force_navy_1	Море несе ворогів назустріч нам! Відправимо їх на дно, щоб вони вже ніколи не спливли!	true
missions_localised_title_att_objective_bel_franks_primary_1_seal_2	Глава I: По праву наше	true
missions_localised_title_att_objective_bel_franks_primary_2_seal_3	Глава II: Вільний і самостійний	true
missions_localised_title_att_objective_bel_franks_primary_5_seal_6	Глава V: Нестримний	true
missions_localised_title_att_objective_bel_franks_primary_3_seal_4	Розділ III: Королівство на руїнах імперії	true
missions_localised_title_att_objective_bel_franks_primary_4_seal_5	Розділ IV: Новий світ	true
missions_localised_description_att_objective_franks_primary_5_seal_6	Час відплати настав.	true
missions_localised_description_att_objective_franks_primary_4_seal_5	Немає пощади грішникам.	true
missions_localised_description_att_objective_franks_primary_3_seal_4	Залиш будь-яку надію.	true
missions_localised_description_att_objective_franks_primary_2_seal_3	Аттіла народився з темряви і відчаю.	true
missions_localised_description_att_objective_franks_primary_1_seal_2	Вони готувалися до війни.	true
missions_localised_description_mk_religious_cathar_convert_region_1	Побратими-християни і язичники живуть гріховним життям. Єпископ просить вказати їм належний спосіб життя, щоб ми разом могли відшукати шлях на Небеса.	true
missions_localised_description_att_diplomatic_barbarian_raid_region_1	Союзник попросив нас влаштувати наліт на цей регіон, щоб перешкодити ворожій торгівлі.	true
missions_localised_title_pro_trade_agreement	Укладіть торговельну угоду	true
missions_localised_description_pro_capture_petrodava	Минуло дев'ять років після першого нападу остготів. Тоді вони виступили з Петродави. Настав час помститися їм!	true
missions_localised_title_att_senate_nordic_construct_bch_barbarian_farming_1	Міське будівництво	true
missions_localised_description_att_senate_eastern_capture_regions_own_settlement_1	Наші воєначальники вимагають, щоб ми відновили землі, сплюндровані ворогом.	true
missions_localised_description_att_diplomatic_eastern_capture_regions_city_1	Союзники попросили нас захопити це поселення, щоб тим самим послабити наших ворогів.	true
missions_localised_title_att_diplomatic_eastern_roman_capture_regions_city_1	Взаємодія на війні	true
missions_localised_title_att_diplomatic_western_roman_capture_regions_city_1	Взаємодія на війні	true
missions_localised_description_att_senate_western_roman_recruit_unit_naval_1	Ніхто не будує кораблі так само надійні, як і римляни. Давай збільшимо наш флот і станемо правити морями.	true
missions_localised_title_att_diplomatic_barbarian_engage_force_army_1	Взаємодія на війні	true
missions_localised_description_att_senate_nordic_construct_bch_barbmigs_settlement_1	Ми повинні виказати повагу нашому народу, зводячи будівлі, що збагачують його культуру.	true
missions_localised_description_att_mp_versus_loyalist	Перемога лоялістів у режимі "Сам на сам"	true
missions_localised_title_mk_religious_baltic_recruit_agent_1	Релігійна вимога	true
missions_localised_title_att_diplomatic_eastern_roman_assassinate_character_agent_female_1	Взаємодія на війні	true
missions_localised_title_mk_religious_jewish_construct_bch_religion_jewish_major_1	Релігійна вимога	true
missions_localised_description_att_senate_eastern_roman_construct_bch_all_industry_minor_1	Наша торгівля, наші ринки занепали. Нам слід сприяти їхньому розвитку.	true
missions_localised_description_att_senate_western_roman_construct_bch_all_industry_minor_1	Наша торгівля, наші ринки занепали. Нам слід знайти нові способи поліпшити економіку.	true
missions_localised_description_mk_religious_baltic_assassinate_character_1	Він говорить чужими мовами і прославляє несправжніх богів. Його потрібно усунути.	true
missions_localised_description_att_objective_eastern_roman_empire_primary_4_seal_5	Немає пощади грішникам.	true
missions_localised_description_att_objective_eastern_roman_empire_primary_3_seal_4	Залиш будь-яку надію.	true
missions_localised_description_att_objective_eastern_roman_empire_primary_5_seal_6	Час відплати настав.	true
missions_localised_description_mk_religious_eastern_assassinate_character_1	Він зіб'є віруючих зі шляху істинного обіцянками і промовами про лжебогів. Патріарх просить нас усунути його.	true
missions_localised_description_att_objective_eastern_roman_empire_primary_2_seal_3	Аттіла народився з темряви і відчаю.	true
missions_localised_description_att_objective_eastern_roman_empire_primary_1_seal_2	Вони готувалися до війни.	true
missions_localised_description_att_objective_western_roman_empire_primary_5_seal_6	Час відплати настав.	true
missions_localised_description_att_objective_western_roman_empire_primary_4_seal_5	Немає пощади грішникам.	true
missions_localised_description_att_objective_western_roman_empire_primary_3_seal_4	Залиш будь-яку надію.	true
missions_localised_description_att_objective_western_roman_empire_primary_2_seal_3	Аттіла народився з темряви і відчаю.	true
missions_localised_description_att_objective_western_roman_empire_primary_1_seal_2	Вони готувалися до війни.	true
missions_localised_description_att_diplomatic_eastern_assassinate_character_agent_female_1	Союзник хоче, щоб цей спостерігач перестав докучати нам обом.	true
missions_localised_title_mk_religious_baltic_construct_bch_religion_baltic_minor_1	Релігійна вимога	true
missions_localised_title_att_eos_tanukhid_mission_3	Зустріч із Мавією - коронація	true
missions_localised_title_att_eos_tanukhid_mission_2	Зустріч із Мавією - звільнення	true
missions_localised_title_att_eos_tanukhid_mission_1	Зустріч із Мавією - загроза	true
missions_localised_description_att_objective_bel_ostrogoths_primary_2_seal_3	Сірі небеса віщують усім нам похмурі часи. Але ми вистоїмо і задушимо наших ворогів попелом і смогом.	true
missions_localised_description_att_objective_bel_ostrogoths_primary_1_seal_2	Результати важких перемог під загрозою. Минуле звернуло на нас свій похмурий і згубний погляд. У цьому важкому становищі імператор відправив війська в похід, щоб відновити колишню імперію. Вони неминуче зазнають поразки у війні з новим королівством!	true
missions_localised_description_att_diplomatic_barbarian_engage_force_navy_1	Наші союзники хочуть, щоб цей флот був знищений.	true
missions_localised_description_att_objective_bel_ostrogoths_primary_4_seal_5	Світ змінився назавжди. Старі імперії впали і звільнили дорогу новій великій державі. Розширимо ж її межі та закріпимо свій успіх навічно!	true
missions_localised_description_att_objective_bel_ostrogoths_primary_3_seal_4	Колишній світ імперій гине. Але приходить новий світ, світ королівств. Місце в ньому знайдеться тільки найсильнішим. І ми будемо серед них!	true
missions_localised_description_att_objective_bel_ostrogoths_primary_5_seal_6	Ми домоглися майже неможливого. Наші противники втрачають надію, довго вони не вистоять. Ми створимо новий світ із попелу старого!	true
missions_localised_description_att_mp_coop_separatist	Спільна перемога сепаратистів	true
missions_localised_title_att_objective_ostrogoths_primary_3_seal_4	Розділ III: Спустошення	true
missions_localised_title_att_objective_ostrogoths_primary_4_seal_5	Розділ IV: Відплата	true
missions_localised_title_att_objective_ostrogoths_primary_5_seal_6	Глава V: Виправдання	true
missions_localised_title_att_objective_ostrogoths_primary_1_seal_2	Глава I: Підготовка	true
missions_localised_title_att_objective_ostrogoths_primary_2_seal_3	Розділ II: Розорення	true
missions_localised_description_att_religious_tengri_convert_region_1	Потрібно об'єднати народи, які живуть на наших землях - так само, як Тенгрі об'єднала нас під вічним синім небом.	true
missions_localised_title_att_religious_celtic_construct_bch_religion_celtic_minor_1	Релігійна вимога	true
missions_localised_title_att_senate_nordic_construct_bch_barbmigs_community_1	Міське будівництво	true
missions_localised_description_att_senate_eastern_roman_construct_building_military_1	Армія - хребет країни. Сенат просить зберегти цю традицію.	true
missions_localised_description_att_diplomatic_barbarian_assassinate_character_agent_male_1	Союзник просить нас позбавити його цього неспокійного священника!	true
missions_localised_description_cha_mission_pope_attacked_1	Терміново провівши Льва III до Риму і вирішивши конфлікт мирним шляхом, ви зможете здійснити мрію про титул імператора Священної Римської імперії.	true
missions_localised_title_att_senate_eastern_capture_regions_city_1	Вторгнення	true
missions_localised_description_att_senate_eastern_roman_assassinate_character_agent_female_1	Сенат просить, щоб ми негайно підіслали до цієї жінки вбивць!	true
missions_localised_title_att_senate_eastern_roman_construct_bch_all_industry_major_1	Міське будівництво	true
missions_localised_title_att_senate_western_roman_construct_bch_all_industry_major_1	Міське будівництво	true
missions_localised_title_att_senate_eastern_construct_bch_all_agriculture_1	Міське будівництво	true
missions_localised_description_att_senate_eastern_roman_raise_force_army_1	Кордони імперії розширюються. Для їх охорони потрібно більше військ.	true
missions_localised_description_att_senate_western_roman_raise_force_army_1	Імперія розширюється. Потрібно набрати нові війська для охорони кордонів.	true
missions_localised_description_att_senate_nomadic_raise_force_army_1	Ми не знаємо поразок, проте наші сили розпорошені. Наберемо ще воїнів, щоб зміцнити наше становище.	true
missions_localised_description_mk_religious_eastern_construct_building_religious_1	Патріарх просить нас побудувати церкву, щоб про нашу віру дізналося більше людей.	true
missions_localised_title_att_religious_zoroastrian_recruit_agent_1	Релігійна вимога	true
missions_localised_description_mk_religious_jewish_convert_region_1	Синедріон вимагає навернути іноплемінників у наших землях, щоб забезпечити наш народ наступними поколіннями.	true
missions_localised_title_mk_religious_baltic_convert_region_1	Релігійна вимога	true
missions_localised_description_att_diplomatic_nomadic_mercenary_raid_region_1	Нам пропонують багату нагороду за те, що ми розоримо ці землі.	true
missions_localised_title_mk_religious_cathar_assassinate_character_1	Релігійна вимога	true
missions_localised_title_mk_religious_ibadi_convert_region_1	Релігійна вимога	true
missions_localised_description_mk_religious_cathar_recruit_agent_1	Ваші єпископи просять тебе збільшити кількість священників.	true
missions_localised_description_att_senate_nomadic_construct_bch_nomad_city_1	Набіги і збір данини не дадуть нам померти з голоду, але ми все-таки повинні розвивати нашу економіку.	true
missions_localised_title_att_senate_eastern_roman_capture_regions_own_settlement_1	Звільнення	true
missions_localised_title_mk_religious_eastern_recruit_agent_1	Релігійна вимога	true
missions_localised_title_att_senate_western_roman_recruit_agent_spy_1	Очі та вуха	true
missions_localised_title_att_senate_eastern_roman_recruit_agent_spy_1	Очі та вуха	true
missions_localised_description_att_diplomatic_eastern_assassinate_character_general_1	Наш союзник засудив цього полководця до смерті.	true
missions_localised_description_att_diplomatic_western_roman_assassinate_character_general_1	Наш союзник засудив цього полководця до смерті.	true
missions_localised_title_mk_religious_eastern_construct_bch_religion_eastern_major_1	Релігійна вимога	true
missions_localised_description_att_diplomatic_eastern_roman_assassinate_character_general_1	Наш союзник засудив цього полководця до смерті.	true
missions_localised_description_att_diplomatic_nomadic_capture_regions_port_1	Нас попросили завдати удару по торгових шляхах противника.	true
missions_localised_description_pro_capture_adrianople	Адріанополь більше непідвладний римлянам, і тепер може стати гарним домом для нашого народу. Захопи його, тоді ми зуміємо закріпитися в цьому краю.	true
missions_localised_title_pro_capture_apulum	Захопіть Апулу	true
missions_localised_description_att_senate_western_roman_construct_building_military_1	Легіони - хребет нашого народу. Сенат просить нас не забувати про це.	true
missions_localised_description_att_senate_nomadic_recruit_agent_spy_1	Вороги зловмишляють проти нас під захистом своїх міських стін. Відправимо туди наших агентів: вони повідомлятимуть нам про плани противника, щоб нам було легше вживати заходів у відповідь.	true
missions_localised_title_att_religious_manichaeism_recruit_agent_1	Релігійна вимога	true
missions_localised_description_cha_mission_frankish_kingdom	Здобудьте могутність, побудуйте своє королівство, створіть спадщину на століття - і ваше ім'я назавжди увійде в історію!	true
missions_localised_title_mk_religious_cathar_construct_bch_religion_cathar_major_1	Релігійна вимога	true
missions_localised_description_att_objective_himyar_primary_2_seal_3	Аттіла народився з темряви і відчаю.	true
missions_localised_description_att_objective_himyar_primary_1_seal_2	Вони готувалися до війни.	true
missions_localised_description_att_objective_himyar_primary_5_seal_6	Час відплати настав.	true
missions_localised_description_att_objective_himyar_primary_4_seal_5	Немає пощади грішникам.	true
missions_localised_title_att_religious_tengri_construct_bch_religion_tengri_major_1	Релігійна вимога	true
missions_localised_description_att_objective_himyar_primary_3_seal_4	Залиш будь-яку надію.	true
missions_localised_title_pro_engage_hun_second_wave	Нападіть на війська гунів	true
missions_localised_title_mk_religious_bogomilist_construct_bch_religion_bogomilist_major_1	Релігійна вимога	true
missions_localised_title_mk_religious_sunni_assassinate_character_1	Релігійна вимога	true
missions_localised_description_att_senate_eastern_assassinate_character_agent_male_1	Марзпан стверджує, що ця людина сіє смуту в наших землях. Нас просять із ним розібратися.	true
missions_localised_description_att_religious_zoroastrian_construct_bch_religion_zoroastrian_major_burial_1	Волхви просять нас побудувати храм одночасно і для Атара, і для Абана, щоб віряни могли кидати жертвоприношення в очищувальний вогонь.	true
missions_localised_description_att_senate_eastern_raise_force_navy_1	Нам потрібно побудувати великий флот і ввірити його одному з наших вузурганів.	true
missions_localised_description_att_senate_eastern_roman_recruit_unit_siege_1	Наші балістарії скаржаться на брак хороших облогових машин. Сенат попросив нас зайнятися цією справою.	true
missions_localised_description_att_objective_bel_expedition_primary_5_seal_6	“Тріумф імперії - доконаний факт. Інші народи могли тільки мріяти про таке піднесення. Рим вступив в епоху нескінченного процвітання. Хай живе вічний Рим!”	true
missions_localised_description_att_objective_bel_expedition_primary_3_seal_4	“Імперія знову на підйомі, і темрява, що накрила весь світ, відступає під яскравими променями сонця. Але землі імперії ще не повністю звільнені з-під влади варварів. Рим повинен виступити проти них.”	true
missions_localised_description_att_objective_bel_expedition_primary_4_seal_5	“Завдяки нашій могутності та божому попущенню ми повернули своє законне місце у світі. Імперію відновлено! Тепер ми твердо і рішуче виступимо проти всіх цих негідних і самозваних королів!”	true
missions_localised_description_att_objective_bel_expedition_primary_1_seal_2	“Періоди негараздів і відчаю тільки зміцнюють стійкість імперії. Імператор відправляє в похід того, хто поверне втрачене і відновить славу держави.”	true
missions_localised_description_att_objective_bel_expedition_primary_2_seal_3	“Небо затягують хмари, сьогодення і майбутнє в імлі. Але колиска імперії кличе її нащадків через Середземне море. Вкрадений трон чекає на звільнення. Ті, хто захопив його, нездатні усвідомити його справжню велич.”	true
missions_localised_description_pro_recapture_olbia	Ольвію захоплено! Ми не можемо допустити, щоб наше рідне місто залишилося в руках ворога! Його треба звільнити!	true
missions_localised_description_att_senate_eastern_raise_force_army_1	Ми повинні наслідувати приклад персів давнини і найняти нових спада для захисту кордонів.	true
missions_localised_title_cha_mission_frankish_kingdom	Королівство франків	true
missions_localised_title_att_objective_langobards_primary_1_seal_2	Глава I: Підготовка	true
missions_localised_title_att_objective_langobards_primary_2_seal_3	Розділ II: Розорення	true
missions_localised_title_att_objective_langobards_primary_3_seal_4	Розділ III: Спустошення	true
missions_localised_title_att_objective_langobards_primary_4_seal_5	Розділ IV: Відплата	true
missions_localised_title_att_objective_langobards_primary_5_seal_6	Глава V: Виправдання	true
missions_localised_title_att_religious_celtic_construct_bch_religion_celtic_major_1	Релігійна вимога	true
missions_localised_description_att_senate_nordic_research_technology_civil_1	Напевно є багато способів поліпшити життя народу, правда ж?	true
missions_localised_title_pro_engage_pirates	Очистити морські шляхи	true
missions_localised_description_pro_trade_agreement	Правителі Медіолана більш відкриті для торгівлі, ніж їхні константинопольські співвітчизники. Укладіть торговельну угоду із Західною Римською імперією.	true
missions_localised_title_att_senate_eastern_capture_regions_own_settlement_1	Звільнення	true
missions_localised_description_att_senate_nordic_construct_bch_barbarian_farming_1	Ми повинні більш дбайливо використовувати доступні ресурси. Цей край може дати нам набагато більше.	true
missions_localised_description_att_diplomatic_eastern_roman_capture_regions_city_1	Союзники попросили нас захопити це поселення, щоб тим самим послабити наших ворогів.	true
missions_localised_description_att_diplomatic_western_roman_capture_regions_city_1	Союзники попросили нас захопити це поселення, щоб тим самим послабити наших ворогів.	true
missions_localised_description_att_senate_western_roman_construct_building_cultural_1	Сенат вважає, що новий пам'ятник культури підвищить нашу популярність у народі.	true
missions_localised_title_att_diplomatic_western_roman_assassinate_character_general_1	Взаємодія на війні	true
missions_localised_title_att_diplomatic_eastern_roman_assassinate_character_general_1	Взаємодія на війні	true
missions_localised_description_pro_placate_petrodava	Мешканці Петродави ледве стримують ненависть до наших людей - проходячи повз, вони обсипають їх лайкою і кидають у них лайном. Їх потрібно втихомирити, інакше повстання неминуче.	true
missions_localised_description_mk_religious_baltic_recruit_agent_1	Коли ми піднімаємо чаші на честь богів, боги набувають сили. Наші жерці просять взяти на службу одного з них, щоб міць богів не вичерпувалася.	true
missions_localised_description_att_senate_western_roman_recruit_agent_spy_1	Іноді найбільше шкоди завдає прихований клинок. Нам потрібно більше шпигунів.	true
missions_localised_description_att_diplomatic_barbarian_assassinate_character_agent_female_1	Союзник хоче, щоб цей спостерігач перестав докучати нам обом.	true
missions_localised_title_mk_religious_baltic_assassinate_character_1	Релігійна вимога	true
missions_localised_title_mk_religious_shia_convert_region_1	Релігійна вимога	true
missions_localised_title_att_senate_eastern_roman_construct_bch_all_industry_minor_1	Міське будівництво	true
missions_localised_title_att_senate_western_roman_construct_bch_all_industry_minor_1	Міське будівництво	true
missions_localised_description_att_senate_eastern_roman_recruit_agent_spy_1	Іноді найбільше шкоди завдає прихований клинок. Нам потрібно більше шпигунів.	true
missions_localised_description_att_religious_celtic_convert_region_1	Старі боги незадоволені, адже жителі цих країв не поклоняються їм. Навчимо їх звичаїв нашого народу.	true
missions_localised_title_att_objective_eastern_roman_empire_primary_2_seal_3	Розділ II: Розорення	true
missions_localised_title_att_objective_eastern_roman_empire_primary_1_seal_2	Глава I: Підготовка	true
missions_localised_title_att_objective_eastern_roman_empire_primary_5_seal_6	Глава V: Виправдання	true
missions_localised_title_att_objective_eastern_roman_empire_primary_4_seal_5	Розділ IV: Відплата	true
missions_localised_title_att_objective_eastern_roman_empire_primary_3_seal_4	Розділ III: Спустошення	true
missions_localised_title_att_religious_arian_declare_war_1	Релігійна вимога	true
missions_localised_title_att_diplomatic_eastern_assassinate_character_agent_female_1	Взаємодія на війні	true
missions_localised_title_mk_religious_baltic_construct_building_religious_1	Релігійна вимога	true
missions_localised_title_att_objective_western_roman_empire_primary_2_seal_3	Розділ II: Розорення	true
missions_localised_title_att_objective_western_roman_empire_primary_1_seal_2	Глава I: Підготовка	true
missions_localised_title_att_objective_western_roman_empire_primary_4_seal_5	Розділ IV: Відплата	true
missions_localised_description_mk_religious_eastern_recruit_agent_1	Патріарх просить, щоб ми рукопоклали нового священика. Він буде вірно служити і принесе користь державі.	true
missions_localised_title_att_objective_western_roman_empire_primary_3_seal_4	Розділ III: Спустошення	true
missions_localised_title_att_objective_western_roman_empire_primary_5_seal_6	Глава V: Виправдання	true
missions_localised_title_att_senate_nordic_recruit_unit_infantry_1	Підкріплення	true
missions_localised_title_att_objective_garamantes_primary_2_seal_3	Розділ II: Розорення	true
missions_localised_title_att_objective_garamantes_primary_1_seal_2	Глава I: Підготовка	true
missions_localised_title_att_senate_eastern_construct_bch_eastern_sassanid_military_minor_1	Військове будівництво	true
missions_localised_title_att_objective_garamantes_primary_5_seal_6	Глава V: Виправдання	true
missions_localised_title_att_objective_garamantes_primary_4_seal_5	Розділ IV: Відплата	true
missions_localised_title_att_diplomatic_eastern_roman_raid_region_1	Взаємодія на війні	true
missions_localised_title_att_objective_garamantes_primary_3_seal_4	Розділ III: Спустошення	true
missions_localised_title_att_senate_nomadic_capture_regions_city_1	Вторгнення	true
missions_localised_title_mk_religious_jewish_convert_region_1	Релігійна вимога	true
missions_localised_title_mk_religious_eastern_construct_bch_religion_eastern_minor_1	Релігійна вимога	true
missions_localised_title_mk_religious_jewish_recruit_agent_1	Релігійна вимога	true
missions_localised_title_att_senate_eastern_recruit_agent_veteran_1	Герой із пустелі	true
missions_localised_description_mk_religious_jewish_assassinate_character_1	Ця людина - богохульник і невірний. Проти нього було видано фетву, що закликає до його смерті.	true
missions_localised_title_att_diplomatic_western_roman_assassinate_character_agent_female_1	Взаємодія на війні	true
missions_localised_description_att_senate_eastern_roman_raise_force_navy_1	Нашому пануванню на морі загрожують пірати. Давай призначимо нового флотоводця і доручимо йому підняти над морем наш прапор.	true
missions_localised_description_att_senate_western_roman_raise_force_navy_1	Наше панування на морі підривають пірати. Висунь нового флотоводця, щоб він приструнив цих тварюк.	true
missions_localised_title_mk_religious_ibadi_assassinate_character_1	Релігійна вимога	true
missions_localised_title_att_senate_nomadic_assassinate_character_general_1	Смерть до терміну	true
missions_localised_description_att_senate_eastern_roman_assassinate_character_agent_male_1	Ця людина занадто довго була скалкою в боці імперії. Розберіться з ним.	true
missions_localised_description_att_senate_western_roman_assassinate_character_agent_male_1	Ця людина занадто довго була скалкою в боці імперії. Розберіться з ним.	true
missions_localised_description_att_senate_nomadic_assassinate_character_agent_male_1	Своїми діями ця людина завдає ударів у саме серце племені. Тому ми просимо вирвати серце в нього!	true
missions_localised_description_mk_religious_sunni_convert_region_1	Халіф просить нас навернути невірних і зробити цей регіон територією ісламу.	true
missions_localised_title_cha_objective_cha_asturias_primary_1_seal_2	Розколотий світ	true
missions_localised_description_mk_religious_baltic_convert_region_1	Старі боги незадоволені, адже жителі цих країв не поклоняються їм. Навчимо їх звичаїв нашого народу.	true
missions_localised_title_cha_objective_cha_asturias_primary_2_seal_3	Королівське ім'я	true
missions_localised_title_cha_objective_cha_asturias_primary_5_seal_6	Відродження Європи	true
missions_localised_title_cha_objective_cha_asturias_primary_3_seal_4	Прибій війни	true
missions_localised_title_cha_objective_cha_asturias_primary_4_seal_5	Створена спадщина	true
missions_localised_description_att_diplomatic_nomadic_assassinate_character_agent_female_1	Союзник хоче, щоб цей спостерігач перестав докучати нам обом.	true
missions_localised_title_cha_mission_viking_kingdom	Королівство вікінгів	true
missions_localised_description_att_senate_eastern_roman_construct_building_cultural_1	Сенат вважає, що новий пам'ятник культури підвищить нашу популярність у народі.	true
missions_localised_title_mk_religious_eastern_declare_war_1	Релігійна вимога	true
missions_localised_title_mk_religious_cathar_construct_bch_religion_cathar_minor_1	Релігійна вимога	true
missions_localised_title_cha_mission_avars_1	Сумнівний каган	true
missions_localised_title_att_senate_nordic_lift_blockade_1	Прорив блокади	true
missions_localised_description_att_diplomatic_eastern_capture_regions_port_1	Нас попросили завдати удару по торгових шляхах противника.	true
missions_localised_description_cha_objective_cha_lombards_primary_1_seal_2	Дрібні правителі подібні до псів, що шматують тіло Європи. Істинний король повстане і розжене їх.	true
missions_localised_description_cha_objective_cha_lombards_primary_2_seal_3	Перш ніж істинний король затвердить свою владу над землею, його ім'я повинно прозвучати з усіх чотирьох сторін.	true
missions_localised_description_cha_objective_cha_lombards_primary_5_seal_6	Слава Європи - в єдності. Нехай же ніхто не посміє відокремитися від великої держави, створеної істинним королем!	true
missions_localised_description_cha_objective_cha_lombards_primary_3_seal_4	Вороги б'ються об армію істинного короля, немов хвилі об берег. Рішучий, він встоїть під їхніми ударами.	true
missions_localised_description_cha_objective_cha_lombards_primary_4_seal_5	Здійснюючи великі діяння, король створює спадщину, непідвладну часу і смерті.	true
missions_localised_title_att_religious_tengri_construct_bch_religion_tengri_minor_1	Релігійна вимога	true
missions_localised_title_att_diplomatic_eastern_roman_capture_regions_port_1	Взаємодія на війні	true
missions_localised_title_att_diplomatic_western_roman_capture_regions_port_1	Взаємодія на війні	true
missions_localised_title_pro_capture_romula	Захопіть Ромулу	true
missions_localised_description_att_religious_orthodox_construct_building_religious_1	Патріарх просить нас побудувати церкву, щоб про нашу віру дізналося більше людей.	true
missions_localised_title_mk_religious_bogomilist_construct_bch_religion_bogomilist_minor_1	Релігійна вимога	true
missions_localised_description_att_senate_nordic_construct_bch_barbmigs_community_1	Ми повинні виказати повагу нашому народу, зводячи будівлі, що збагачують його культуру.	true
missions_localised_description_att_senate_eastern_construct_bch_eastern_sassanid_military_infantry_1	Нові військові споруди лише зміцнять славу Царя царів.	true
missions_localised_description_att_objective_saxons_primary_5_seal_6	Час відплати настав.	true
missions_localised_description_att_objective_saxons_primary_3_seal_4	Залиш будь-яку надію.	true
missions_localised_description_att_objective_saxons_primary_4_seal_5	Немає пощади грішникам.	true
missions_localised_description_att_objective_saxons_primary_1_seal_2	Вони готувалися до війни.	true
missions_localised_description_att_objective_saxons_primary_2_seal_3	Аттіла народився з темряви і відчаю.	true
missions_localised_title_att_senate_nordic_make_alliance_1	Надійний друг	true
missions_localised_title_att_senate_nordic_construct_bch_barbmigs_herding_1	Міське будівництво	true
missions_localised_title_att_diplomatic_western_roman_raid_region_1	Взаємодія на війні	true
missions_localised_description_att_senate_eastern_roman_recruit_unit_naval_1	Римські кораблі - найкращі у відомому світі. Давайте ж збільшимо флот і станемо правити морями!	true
missions_localised_title_mk_religious_bogomillist_construct_building_religious_1	Релігійна вимога	true
missions_localised_description_pro_engage_pirates	Бунтівники всіх мастей заохочують і постачають піратів, які орудують у східному Середземномор'ї, і це завдає серйозної шкоди торгівлі. Сенат просить, щоб ми знайшли і переконали цих людей, у разі потреби застосувавши силу.	true
missions_localised_title_att_senate_western_roman_recruit_unit_siege_1	Підкріплення	true
missions_localised_title_att_diplomatic_nomadic_mercenary_capture_regions_city_1	Контракт із найманцями	true
missions_localised_title_att_senate_nordic_construct_bch_barbmigs_leadership_1	Міське будівництво	true
missions_localised_description_cha_objective_cha_mercia_primary_5_seal_6	Слава Європи - в єдності. Нехай же ніхто не посміє відокремитися від великої держави, створеної істинним королем!	true
missions_localised_description_cha_objective_cha_mercia_primary_4_seal_5	Здійснюючи великі діяння, король створює спадщину, непідвладну часу і смерті.	true
missions_localised_description_cha_objective_cha_mercia_primary_3_seal_4	Вороги б'ються об армію істинного короля, немов хвилі об берег. Рішучий, він встоїть під їхніми ударами.	true
missions_localised_description_cha_objective_cha_mercia_primary_2_seal_3	Перш ніж істинний король затвердить свою владу над землею, його ім'я повинно прозвучати з усіх чотирьох сторін.	true
missions_localised_description_cha_objective_cha_mercia_primary_1_seal_2	Дрібні правителі подібні до псів, що шматують тіло Європи. Істинний король повстане і розжене їх.	true
missions_localised_description_att_diplomatic_barbarian_capture_regions_port_1	Нас попросили завдати удару по торгових шляхах противника.	true
missions_localised_title_att_senate_eastern_construct_bch_all_industry_minor_1	Міське будівництво	true
missions_localised_title_att_religious_catholic_construct_building_religious_1	Релігійна вимога	true
missions_localised_description_pro_recruit_agent	Використання агентів - ефективний спосіб розладнати плани ворога. Найміть спостерігача, який служитиме вашим інтересам по всьому світу.	true
missions_localised_title_pro_recapture_petrodava	Звільніть Петродаву	true
missions_localised_description_att_religious_celtic_construct_bch_religion_celtic_major_1	Ми повинні будувати храми і монументи на честь богів, щоб заслужити їхнє благовоління.	true
missions_localised_description_att_religious_arian_construct_bch_religion_arian_minor_1	Єпископ просить, щоб ми побудували церкву для святої скинії і славили Всевишнього.	true
missions_localised_description_att_religious_zoroastrian_construct_bch_religion_zoroastrian_major_fire_1	Волхви просять нас побудувати храм одночасно і для Атара, і для Абана, щоб віряни могли кидати жертвоприношення в очищувальний вогонь.	true
missions_localised_title_att_diplomatic_nomadic_capture_regions_city_1	Взаємодія на війні	true
missions_localised_description_mk_religious_shia_construct_building_religious_1	Улеми просять нас побудувати мечеть, щоб про нашу віру дізналося більше людей.	true
missions_localised_description_mk_religious_baltic_construct_bch_religion_baltic_major_1	Ми повинні будувати храми і монументи на честь богів, щоб заслужити їхнє благовоління.	true
missions_localised_description_att_diplomatic_eastern_roman_raid_region_1	Союзник попросив нас влаштувати наліт на цей регіон, щоб перешкодити ворожій торгівлі.	true
missions_localised_title_mk_religious_ibadi_declare_war_1	Релігійна вимога	true
missions_localised_description_att_senate_eastern_construct_bch_eastern_sassanid_military_minor_1	Нові військові споруди лише зміцнять славу Царя царів.	true
missions_localised_title_att_objective_ebdani_primary_2_seal_3	Розділ II: Розорення	true
missions_localised_title_att_objective_ebdani_primary_1_seal_2	Глава I: Підготовка	true
missions_localised_title_att_objective_ebdani_primary_5_seal_6	Глава V: Виправдання	true
missions_localised_title_att_objective_ebdani_primary_4_seal_5	Розділ IV: Відплата	true
missions_localised_title_att_objective_ebdani_primary_3_seal_4	Розділ III: Спустошення	true
missions_localised_title_att_vc_wonder_civic_2	Божественний культурний тріумф	true
missions_localised_title_att_vc_wonder_civic_1	Культурна перемога	true
missions_localised_description_mk_religious_jewish_construct_bch_religion_jewish_minor_1	Синедріон просить нас побудувати церкву, щоб про нашу віру дізналося більше людей.	true
missions_localised_title_att_senate_western_roman_construct_building_cultural_1	Міське будівництво	true
missions_localised_description_mk_religious_shia_convert_region_1	Улеми просять нас навернути невірних і зробити цей регіон територією ісламу.	true
missions_localised_title_mk_religious_bogomilist_convert_region_1	Релігійна вимога	true
missions_localised_description_mk_religious_baltic_construct_building_religious_1	Ми повинні будувати храми і монументи на честь богів, щоб заслужити їхнє благовоління.	true
missions_localised_title_att_senate_nomadic_recruit_unit_ranged_1	Підкріплення	true
missions_localised_title_att_objective_venedi_primary_2_seal_3	Розділ II: Розорення	true
missions_localised_title_att_objective_venedi_primary_1_seal_2	Глава I: Підготовка	true
missions_localised_title_att_objective_venedi_primary_4_seal_5	Розділ IV: Відплата	true
missions_localised_description_att_senate_western_roman_capture_regions_own_settlement_1	Ворог захопив наше поселення! Сенат не стерпить такої образи! Він просить нас негайно звільнити ці землі.	true
missions_localised_title_att_objective_venedi_primary_3_seal_4	Розділ III: Спустошення	true
missions_localised_title_att_objective_venedi_primary_5_seal_6	Глава V: Виправдання	true
missions_localised_title_att_vc_2_imperial	Тріумф імперії	true
missions_localised_title_att_senate_nordic_construct_bch_barbarian_water_major_1	Міське будівництво	true
missions_localised_description_att_senate_eastern_roman_construct_bch_all_city_major_1	Сенат вважає, що новий пам'ятник культури підвищить нашу популярність у народі.	true
missions_localised_description_att_senate_western_roman_construct_bch_all_city_major_1	Сенат вважає, що новий пам'ятник культури підвищить нашу популярність у народі.	true
missions_localised_description_att_senate_eastern_recruit_unit_naval_1	Наші флоти потребують посилення. Побудуємо більше кораблів і посадимо на них ув'язнених.	true
missions_localised_description_att_diplomatic_nomadic_assassinate_character_agent_male_1	Союзник просить нас позбавити його цього неспокійного священника!	true
missions_localised_description_att_senate_nomadic_assassinate_character_general_1	Ця людина неймовірно небезпечна. Його потрібно усунути! Його смерть стане страшним ударом для наших ворогів!	true
missions_localised_description_pro_convert_christianity	Якщо ви приймете вчення Христа, константинопольський Сенат подивиться на вас більш прихильно. А ось громадський порядок на батьківщині може погіршитися.	true
missions_localised_description_mk_religious_ibadi_assassinate_character_1	Ця людина - богохульник і невірний. Проти нього було видано фетву, що закликає до його смерті.	true
missions_localised_title_att_religious_arian_construct_bch_religion_arian_major_1	Релігійна вимога	true
missions_localised_description_mk_religious_shia_declare_war_1	Наш обов'язок - сприяти справі ісламу в землях невірних, зокрема за допомогою меча. Аллах акбар!	true
missions_localised_title_att_senate_western_roman_assassinate_character_agent_female_1	Смерть до терміну	true
missions_localised_description_att_diplomatic_barbarian_blockade_port_1	Нас попросили блокувати морські торгові шляхи противника.	true
missions_localised_title_att_senate_eastern_roman_assassinate_character_general_1	Смерть до терміну	true
missions_localised_description_att_senate_eastern_recruit_agent_veteran_1	Хоча Цар царів - досвідчений, загартований у боях воїн, частина наших солдатів полохливі, немов миші. Потрібно найняти ветерана, щоб він навчив їх не боятися.	true
missions_localised_title_att_senate_western_roman_assassinate_character_general_1	Смерть до терміну	true
missions_localised_description_att_senate_nordic_blockade_port_1	Ворог отримує великий прибуток від морської торгівлі, і ці кошти йдуть на війну з нами. Якщо ми хочемо здобути перемогу, потрібно атакувати торгові шляхи.	true
missions_localised_description_pro_capture_romula	На півдні гепіди, як і раніше, підтримують остготів. За це їх потрібно покарати: захопи їхню столицю і страть знать, щоб інші не сміли допомагати нашим ворогам.	true
missions_localised_title_att_senate_nordic_engage_force_army_1	Військова слава	true
missions_localised_title_att_diplomatic_barbarian_capture_regions_city_1	Взаємодія на війні	true
missions_localised_description_att_senate_eastern_construct_bch_all_city_minor_1	Наші намісники просять Царя царів побудувати нові міські будівлі, щоб наш уряд був освіченим.	true
missions_localised_title_att_senate_nordic_capture_regions_city_1	Вторгнення	true
missions_localised_description_att_diplomatic_western_roman_raid_region_1	Союзник попросив нас влаштувати наліт на цей регіон, щоб перешкодити ворожій торгівлі.	true
missions_localised_description_att_senate_nordic_construct_bch_barbmigs_herding_1	Ми повинні виказати повагу нашому народу, зводячи будівлі, що збагачують його культуру.	true
missions_localised_description_att_diplomatic_nomadic_mercenary_capture_regions_port_1	Нам пропонують нагороду - за умови, що наша орда нападе на цей порт.	true
missions_localised_description_att_senate_eastern_capture_regions_port_1	Захопивши такий порт, ми отримаємо доступ до торгового шляху і, отже, до прянощів, коштовностей і тканин.	true
missions_localised_description_cha_mission_viking_kingdom	Здобудьте могутність, побудуйте своє королівство, створіть спадщину на століття - і ваше ім'я назавжди увійде в історію!	true
missions_localised_title_att_religious_hellenic_construct_building_religious_1	Релігійна вимога	true
missions_localised_title_att_senate_eastern_roman_construct_building_cultural_1	Міське будівництво	true
missions_localised_title_att_religious_germanic_construct_building_religious_1	Релігійна вимога	true
missions_localised_title_att_senate_nomadic_declare_war_1	Барабани війни	true
missions_localised_description_mk_religious_eastern_declare_war_1	Єретики з цього народу переслідують і принижують послідовників істинної віри. Патріарх просить нас втрутитися.	true
missions_localised_description_cha_mission_saxon_kingdom	Здобудьте могутність, побудуйте своє королівство, створіть спадщину на століття - і ваше ім'я назавжди увійде в історію!	true
missions_localised_description_att_religious_tengri_construct_bch_religion_tengri_minor_1	Умай змушує трави рости і дарує добробут нашому народу. Так і ми повинні вшанувати богів, побудувавши монумент на честь наших предків.	true
missions_localised_title_att_senate_western_roman_recruit_unit_naval_1	Підкріплення	true
missions_localised_title_att_diplomatic_eastern_capture_regions_city_1	Взаємодія на війні	true
missions_localised_title_att_senate_nordic_recruit_unit_ranged_1	Підкріплення	true
missions_localised_title_att_senate_nordic_construct_bch_barbarian_civic_major_1	Міське будівництво	true
missions_localised_title_att_senate_eastern_roman_construct_building_military_1	Військове будівництво	true
missions_localised_description_att_senate_nordic_capture_regions_city_1	Наші вожді та радники рекомендують нам напасти на це місто.	true
missions_localised_title_pro_capture_petrodava	Захопіть Петродаву	true
missions_localised_description_att_senate_eastern_assassinate_character_agent_female_1	Вона нещодавно втекла з темниці, в яку її посадив бозорган. Її потрібно зупинити.	true
missions_localised_title_att_objective_franks_primary_5_seal_6	Глава V: Виправдання	true
missions_localised_title_att_objective_franks_primary_3_seal_4	Розділ III: Спустошення	true
missions_localised_title_att_objective_franks_primary_4_seal_5	Розділ IV: Відплата	true
missions_localised_title_att_objective_franks_primary_1_seal_2	Глава I: Підготовка	true
missions_localised_title_att_objective_franks_primary_2_seal_3	Розділ II: Розорення	true
missions_localised_description_att_objective_bel_franks_primary_2_seal_3	Сірі небеса віщують усім нам похмурі часи. Але ми вистоїмо і задушимо наших ворогів попелом і смогом.	true
missions_localised_description_att_objective_bel_franks_primary_1_seal_2	Результати важких перемог під загрозою. Минуле звернуло на нас свій похмурий і згубний погляд. У цьому важкому становищі імператор відправив війська в похід, щоб відновити колишню імперію. Вони неминуче зазнають поразки у війні з новим королівством!	true
missions_localised_description_att_objective_bel_franks_primary_5_seal_6	Ми домоглися майже неможливого. Наші противники втрачають надію, довго вони не вистоять. Ми створимо новий світ із попелу старого!	true
missions_localised_description_att_objective_bel_franks_primary_4_seal_5	Світ змінився назавжди. Старі імперії впали і звільнили дорогу новій великій державі. Розширимо ж її межі та закріпимо свій успіх навічно!	true
missions_localised_description_att_objective_bel_franks_primary_3_seal_4	Колишній світ імперій гине. Але приходить новий світ, світ королівств. Місце в ньому знайдеться тільки найсильнішим. І ми будемо серед них!	true
missions_localised_description_att_senate_nomadic_declare_war_1	Вони відмовилися платити данину і висміяли нашу пропозицію взяти їх під захист. Покажемо їм, що буває з тими, хто кидає виклик орді.	true
missions_localised_title_att_senate_nordic_engage_force_navy_1	У глибини	true
missions_localised_title_att_senate_eastern_construct_bch_all_industry_major_1	Міське будівництво	true
missions_localised_description_att_religious_celtic_construct_bch_religion_celtic_minor_1	Ми повинні будувати храми і монументи на честь богів, щоб заслужити їхнє благовоління.	true
missions_localised_description_att_religious_arian_construct_bch_religion_arian_major_1	Єпископ просить, щоб ми побудували церкву для святої скинії і славили Всевишнього.	true
missions_localised_title_att_senate_eastern_roman_capture_regions_city_1	Вторгнення	true
missions_localised_title_att_senate_western_roman_capture_regions_city_1	Вторгнення	true
missions_localised_description_att_objective_ostrogoths_primary_4_seal_5	Немає пощади грішникам.	true
missions_localised_description_att_objective_ostrogoths_primary_3_seal_4	Залиш будь-яку надію.	true
missions_localised_description_att_objective_ostrogoths_primary_5_seal_6	Час відплати настав.	true
missions_localised_description_att_objective_ostrogoths_primary_2_seal_3	Аттіла народився з темряви і відчаю.	true
missions_localised_description_att_objective_ostrogoths_primary_1_seal_2	Вони готувалися до війни.	true
missions_localised_title_att_diplomatic_nomadic_mercenary_raid_region_1	Контракт із найманцями	true
missions_localised_title_att_objective_bel_ostrogoths_primary_1_seal_2	Глава I: По праву наше	true
missions_localised_title_att_objective_bel_ostrogoths_primary_2_seal_3	Глава II: Вільний і самостійний	true
missions_localised_title_att_objective_bel_ostrogoths_primary_3_seal_4	Розділ III: Королівство на руїнах імперії	true
missions_localised_title_att_objective_bel_ostrogoths_primary_4_seal_5	Розділ IV: Новий світ	true
missions_localised_title_att_objective_bel_ostrogoths_primary_5_seal_6	Глава V: Нестримний	true
missions_localised_title_pro_convert_christianity	Навернути в християнство	true
missions_localised_description_mk_religious_baltic_construct_bch_religion_baltic_minor_1	Ми повинні будувати храми і монументи на честь богів, щоб заслужити їхнє благовоління.	true
missions_localised_description_att_diplomatic_eastern_roman_assassinate_character_agent_female_1	Союзник хоче, щоб цей спостерігач перестав докучати нам обом.	true
missions_localised_description_att_senate_eastern_roman_assassinate_character_general_1	Одна його присутність надихає ворогів на подвиги. Сенат наполягає на його усуненні.	true
missions_localised_description_mk_religious_jewish_construct_bch_religion_jewish_major_1	Синедріон просить нас побудувати церкву, щоб про нашу віру дізналося більше людей.	true
missions_localised_description_att_vc_wonder_1	Мала перемога	true
missions_localised_description_att_senate_western_roman_assassinate_character_general_1	Ця людина надихає наших ворогів однією своєю присутністю. Його потрібно усунути...	true
missions_localised_title_att_senate_nordic_construct_bch_barbmigs_settlement_1	Міське будівництво	true
missions_localised_title_att_senate_nomadic_recruit_unit_siege_1	Підкріплення	true
missions_localised_description_att_senate_eastern_construct_bch_all_agriculture_1	Цей край багатий, у ньому багато сировини. Воно має принести користь Царю царів.	true
missions_localised_title_att_diplomatic_barbarian_blockade_port_1	Взаємодія на війні	true
missions_localised_description_mk_religious_ibadi_declare_war_1	Наш обов'язок - сприяти справі ісламу в землях невірних, зокрема за допомогою меча. Аллах акбар!	true
missions_localised_description_pro_capture_apulum	Ми взяли Петродаву, але ворог ще сильний. Його столиця Апула занадто близька до наших нових володінь. Якщо ми хочемо остаточно розгромити остготів, це місто має впасти.	true
missions_localised_title_cha_objective_cha_westphalia_primary_5_seal_6	Відродження Європи	true
missions_localised_title_cha_objective_cha_westphalia_primary_3_seal_4	Прибій війни	true
missions_localised_title_cha_objective_cha_westphalia_primary_4_seal_5	Створена спадщина	true
missions_localised_title_cha_objective_cha_westphalia_primary_1_seal_2	Розколотий світ	true
missions_localised_title_cha_objective_cha_westphalia_primary_2_seal_3	Королівське ім'я	true
missions_localised_title_att_senate_nordic_construct_bch_barbarian_water_minor_1	Міське будівництво	true
missions_localised_description_att_senate_eastern_recruit_unit_siege_1	Цар царів може пробивати стіни диханням, але нашим арміям для цього потрібні облогові машини.	true
missions_localised_title_att_senate_nordic_declare_war_1	Барабани війни	true
missions_localised_title_att_senate_nomadic_recruit_agent_spy_1	Очі та вуха	true
missions_localised_description_att_senate_eastern_roman_construct_bch_all_city_minor_1	Сенат вважає, що новий пам'ятник культури підвищить нашу популярність у народі.	true
missions_localised_description_att_senate_western_roman_construct_bch_all_city_minor_1	Сенат вважає, що новий пам'ятник культури підвищить нашу популярність у народі.	true
missions_localised_title_att_senate_western_roman_construct_building_military_1	Військове будівництво	true
missions_localised_title_mk_religious_shia_construct_building_religious_1	Релігійна вимога	true
missions_localised_title_att_religious_arian_construct_bch_religion_arian_minor_1	Релігійна вимога	true
missions_localised_description_att_senate_nomadic_capture_regions_port_1	Якщо ми захопимо цей порт, море з усіма його багатствами стане нашим!	true
missions_localised_description_mk_religious_bogomilist_convert_region_1	Побратими-християни і язичники живуть гріховним життям. Давайте вкажемо їм належний спосіб життя, щоб ми разом могли відшукати шлях на Небеса.	true
missions_localised_description_att_senate_nomadic_recruit_unit_ranged_1	Наша кіннота - найкраща у світі, але її можливості обмежені. Потрібно набрати стрільців, щоб вони її підтримували.	true
missions_localised_description_att_senate_eastern_roman_capture_regions_port_1	Народ просить нас захопити цей порт на славу імперії.	true
missions_localised_description_att_senate_western_roman_capture_regions_port_1	Народ просить нас захопити цей порт на славу імперії.	true
missions_localised_title_att_diplomatic_eastern_assassinate_character_general_1	Взаємодія на війні	true
missions_localised_title_mk_religious_bogomilist_assassinate_character_1	Релігійна вимога	true
missions_localised_description_mk_religious_bogomilist_recruit_agent_1	Наші молитви мають бути почуті в усіх містах і царствах, щоб ми могли протистояти підступам Сатани. Вчені послідовники нашої віри мають вирушити в далекі краї, щоб допомогти нашій справі.	true
missions_localised_title_pro_capture_adrianople	Захопити Адріанополь	true
missions_localised_description_att_senate_nomadic_construct_bch_nomad_warriors_1	Побудувавши нові табори для навчання, ми отримаємо потужнішу і швидшу кінноту, яка поставить ворогів на коліна.	true
missions_localised_title_att_senate_nomadic_assassinate_character_agent_female_1	Смерть до терміну	true
missions_localised_title_att_diplomatic_eastern_roman_assassinate_character_agent_male_1	Взаємодія на війні	true
missions_localised_title_att_diplomatic_western_roman_assassinate_character_agent_male_1	Взаємодія на війні	true
missions_localised_description_att_diplomatic_eastern_assassinate_character_agent_male_1	Союзник просить нас позбавити його цього неспокійного священника!	true
missions_localised_description_att_senate_eastern_construct_bch_all_city_major_1	Наші намісники просять Царя царів побудувати нові міські будівлі, щоб наш уряд був освіченим.	true
missions_localised_description_pro_engage_hun_second_wave	Гуни знову пішли в набіг. Їх потрібно за всяку ціну зупинити.	true
missions_localised_description_mk_religious_sunni_assassinate_character_1	Ця людина - богохульник і невірний. Проти нього було видано фетву, що закликає до його смерті.	true
missions_localised_title_cha_mission_pope_help_1	Обіцянка франків	true
missions_localised_title_att_victory_mp_versus	Перемога в мережевому бою	true
missions_localised_description_att_religious_tengri_construct_bch_religion_tengri_major_1	Умай змушує трави рости і дарує добробут нашому народу. Так і ми повинні вшанувати богів, побудувавши монумент на честь наших предків.	true
missions_localised_description_att_religious_manichaeism_recruit_agent_1	Слухачі переконані, що призначення нового обраного допоможе поширенню нашої віри.	true
missions_localised_title_att_senate_eastern_roman_construct_bch_all_city_major_1	Міське будівництво	true
missions_localised_title_att_senate_western_roman_construct_bch_all_city_major_1	Міське будівництво	true
missions_localised_description_att_senate_nordic_construct_bch_barbarian_water_major_1	Ми повинні виказати повагу нашому народу, зводячи будівлі, що збагачують його культуру.	true
missions_localised_description_att_senate_nomadic_construct_bch_nomad_artisan_1	Вожді втомилися від нескінченних воєн. Потрібно організувати для них що-небудь особливе.	true
missions_localised_title_att_senate_eastern_recruit_unit_naval_1	Підкріплення	true
missions_localised_description_att_senate_nomadic_recruit_agent_veteran_1	У нас багато досвідчених воїнів. Може, доручимо одному з них навчати рекрутів?	true
missions_localised_description_mk_religious_ibadi_recruit_agent_1	Улеми просять, щоб ми заснували медресе і найняли більше імамів. Громадам ісламу потрібно більше лідерів.	true
missions_localised_title_att_diplomatic_nomadic_capture_regions_port_1	Взаємодія на війні	true
missions_localised_title_mk_religious_shia_declare_war_1	Релігійна вимога	true
missions_localised_description_att_senate_western_roman_construct_bch_all_agriculture_1	Наша торгівля, наші ринки занепали. Нам слід знайти нові способи поліпшити економіку.	true
missions_localised_title_att_eos_axum_mission_2	Нехай прянощі течуть рікою. Ч.2	true
missions_localised_title_att_eos_axum_mission_3	Усе, що блищить	true
missions_localised_title_att_eos_axum_mission_1	Нехай прянощі течуть рікою. Ч.1	true
missions_localised_description_att_senate_eastern_roman_construct_bch_all_agriculture_1	Наша торгівля, наші ринки занепали. Нам слід сприяти їхньому розвитку.	true
missions_localised_title_att_senate_eastern_roman_recruit_agent_veteran_1	Загартований у боях ветеран	true
missions_localised_description_att_senate_eastern_assassinate_character_general_1	Самим своїм існуванням він ображає наших воєначальників. Його потрібно відправити в інший світ!	true
missions_localised_title_att_senate_western_roman_recruit_agent_veteran_1	Загартований у боях ветеран	true
missions_localised_title_att_objective_bel_expedition_primary_5_seal_6	Глава V: Вічний Рим	true
missions_localised_title_att_objective_bel_expedition_primary_4_seal_5	Розділ IV: Королі-самозванці	true
missions_localised_title_att_objective_bel_expedition_primary_3_seal_4	Глава III: Піднесення імперії	true
missions_localised_title_att_objective_bel_expedition_primary_2_seal_3	Розділ II: Вкрадений трон	true
missions_localised_title_att_objective_bel_expedition_primary_1_seal_2	Розділ I: Той, хто поверне все	true
missions_localised_title_att_senate_eastern_roman_recruit_unit_siege_1	Підкріплення	true
missions_localised_description_att_senate_nordic_construct_bch_all_city_major_1	Ми повинні виказати повагу нашому народу, зводячи будівлі, що збагачують його культуру.	true
missions_localised_title_att_senate_eastern_raise_force_navy_1	Заклик до зброї	true
missions_localised_title_att_senate_eastern_assassinate_character_agent_male_1	Смерть до терміну	true
missions_localised_description_att_diplomatic_barbarian_capture_regions_city_1	Союзники попросили нас захопити це поселення, щоб тим самим послабити наших ворогів.	true
missions_localised_description_mk_religious_bogomilist_construct_bch_religion_bogomilist_major_1	Вкрай важливо будувати молитовні будинки, щоб послідовники нашої віри могли жити в спілкуванні з Господом, подалі від утисків з боку чужоземних правителів.	true
missions_localised_title_att_senate_eastern_declare_war_1	Барабани війни	true
missions_localised_title_att_objective_himyar_primary_1_seal_2	Глава I: Підготовка	true
missions_localised_title_att_objective_himyar_primary_2_seal_3	Розділ II: Розорення	true
missions_localised_title_att_objective_himyar_primary_5_seal_6	Глава V: Виправдання	true
missions_localised_title_att_objective_himyar_primary_3_seal_4	Розділ III: Спустошення	true
missions_localised_title_att_objective_himyar_primary_4_seal_5	Розділ IV: Відплата	true
missions_localised_title_att_diplomatic_nomadic_mercenary_capture_regions_port_1	Контракт із найманцями	true
missions_localised_description_att_religious_hellenic_construct_bch_religion_grecoroman_major_1	Оракул каже, що на нас чекають великі нещастя, якщо ми не будемо шанувати богів. Жерці пропонують умилостивити їх, побудувавши храм.	true
missions_localised_description_mk_religious_cathar_construct_bch_religion_cathar_major_1	Єпископ просить, щоб ми побудували церкву для святої скинії і славили Всевишнього.	true
missions_localised_description_pro_achieve_food_surplus	Люди голодують, і якщо нічого не зробити, їхні біди скоро стануть нашими. Забезпеч їх продовольством, щоб наповнити їхні шлунки і розігнати погані думки.	true
missions_localised_title_att_senate_nomadic_construct_bch_nomad_herders_1	Міське будівництво	true
missions_localised_title_ch_vc_2_long	Довга перемога	true
missions_localised_description_mk_religious_bogomillist_construct_building_religious_1	Вкрай важливо будувати молитовні будинки, щоб послідовники нашої віри могли жити в спілкуванні з Господом, подалі від утисків з боку чужоземних правителів.	true
missions_localised_description_att_diplomatic_nomadic_mercenary_capture_regions_city_1	Нам пропонують нагороду - за умови, що наша орда нападе на це поселення.	true
missions_localised_description_att_senate_eastern_capture_regions_city_1	Ця країна стане ще однією перлиною в короні могутнього Царя царів!	true
missions_localised_title_att_diplomatic_barbarian_raid_region_1	Взаємодія на війні	true
missions_localised_title_att_eos_religious_mission_build_att_rel_semitic_paganism	Верховний жрець Альмакі - благочестя	true
missions_localised_title_att_senate_nordic_construct_bch_all_city_minor_1	Міське будівництво	true
missions_localised_title_att_religious_tengri_convert_region_1	Релігійна вимога	true
missions_localised_title_att_diplomatic_barbarian_capture_regions_port_1	Взаємодія на війні	true
missions_localised_description_pro_recapture_petrodava	Петродава в руках ворога! Втрата цього міста і його околиць завдасть нам серйозної шкоди! Звільніть його!	true
missions_localised_title_att_religious_hellenic_construct_bch_religion_grecoroman_minor_1	Релігійна вимога	true
missions_localised_title_att_senate_nordic_capture_regions_port_1	Вторгнення	true
missions_localised_title_mk_religious_sunni_declare_war_1	Релігійна вимога	true
missions_localised_description_att_senate_eastern_roman_capture_regions_own_settlement_1	Наші вороги захопили це поселення! Сенат не потерпить такої образи! Звільни ці землі!	true
missions_localised_title_att_senate_nomadic_construct_bch_nomad_city_1	Міське будівництво	true
missions_localised_description_att_eos_tanukhid_mission_3	Вибери поселення, гідне стати колискою нашої імперії на Сході! Там оселиться наш народ, який напише нову велику сторінку нашої історії!	true
missions_localised_description_att_eos_tanukhid_mission_2	Досліджуй римські землі, звільняючи народи і пов'язуючи їх із нами клятвами скрізь, де існує опір. Троє таких союзників - і нас уже не зупинити!	true
missions_localised_description_att_eos_tanukhid_mission_1	Кажуть, що римляни, як метелики, нестримно прагнуть до вогню. Запали п'ять вогнів, п'ять міст, щоб приманити цих невгамовних метеликів до їхньої погибелі.	true
missions_localised_title_att_senate_eastern_recruit_unit_ranged_1	Підкріплення	true
missions_localised_title_att_mp_coop_separatist	Спільна перемога сепаратистів	true
missions_localised_description_att_religious_zoroastrian_recruit_agent_1	Волхви стверджують, що підвищення мобеда допоможе поширенню нашої віри.	true
missions_localised_title_att_senate_nomadic_raise_force_army_1	Заклик до зброї	true
missions_localised_description_att_vc_wonder_military_1	Військова перемога	true
missions_localised_description_att_vc_wonder_military_2	Божественний військовий тріумф	true
missions_localised_title_att_senate_eastern_roman_assassinate_character_agent_female_1	Смерть до терміну	true
missions_localised_title_att_mp_versus_loyalist	Перемога лоялістів у режимі "Сам на сам"	true
missions_localised_description_att_senate_eastern_recruit_unit_ranged_1	Наші лучники славляться по всьому світу, але в наших арміях, на жаль, їх не вистачає.	true
missions_localised_title_att_senate_nomadic_assassinate_character_agent_male_1	Смерть до терміну	true
missions_localised_title_att_senate_eastern_roman_construct_bch_all_city_minor_1	Міське будівництво	true
missions_localised_title_att_senate_western_roman_construct_bch_all_city_minor_1	Міське будівництво	true
missions_localised_description_att_senate_nordic_declare_war_1	Ми занадто довго терпіли цих дурнів. Але тепер наші воєначальники підняли прапори - ми йдемо війною на ворогів!	true
missions_localised_title_att_senate_eastern_recruit_unit_siege_1	Підкріплення	true
missions_localised_description_att_senate_nordic_construct_bch_barbarian_water_minor_1	Ми повинні виказати повагу нашому народу, зводячи будівлі, що збагачують його культуру.	true
missions_localised_title_att_diplomatic_nomadic_assassinate_character_general_1	Взаємодія на війні	true
missions_localised_title_att_senate_eastern_roman_capture_regions_port_1	Вторгнення	true
missions_localised_title_att_senate_western_roman_capture_regions_port_1	Вторгнення	true
missions_localised_description_mk_religious_bogomilist_assassinate_character_1	Ця людина - агент іноземної держави, вона загрожує спокою і свободі наших громад. Його слід негайно зупинити!	true
missions_localised_description_att_diplomatic_western_roman_assassinate_character_agent_female_1	Союзник хоче, щоб цей спостерігач перестав докучати нам обом.	true
missions_localised_title_att_senate_eastern_recruit_agent_spy_1	Очі та вуха	true
missions_localised_title_mk_religious_bogomilist_recruit_agent_1	Релігійна вимога	true
missions_localised_title_att_vc_wonder_military_1	Військова перемога	true
missions_localised_title_att_vc_wonder_military_2	Божественний військовий тріумф	true
missions_localised_title_att_senate_eastern_roman_recruit_unit_naval_1	Підкріплення	true
missions_localised_title_att_senate_western_roman_raid_region_1	Набіги та грабежі	true
missions_localised_title_att_objective_saxons_primary_5_seal_6	Глава V: Виправдання	true
missions_localised_description_att_senate_nomadic_assassinate_character_agent_female_1	Ця підступна жінка постійно зриває наші плани. Потрібно відправити її в інший світ.	true
missions_localised_title_att_objective_saxons_primary_4_seal_5	Розділ IV: Відплата	true
missions_localised_title_att_objective_saxons_primary_3_seal_4	Розділ III: Спустошення	true
missions_localised_description_att_senate_nordic_make_alliance_1	Наші народи зріднилися. Вожді наполягають на тому, щоб ми поклялися на крові в дружбі цьому народу.	true
missions_localised_title_att_objective_saxons_primary_2_seal_3	Розділ II: Розорення	true
missions_localised_title_att_objective_saxons_primary_1_seal_2	Глава I: Підготовка	true
missions_localised_description_att_senate_nordic_construct_bch_all_city_minor_1	Ми повинні виказати повагу нашому народу, зводячи будівлі, що збагачують його культуру.	true
missions_localised_description_att_diplomatic_eastern_roman_assassinate_character_agent_male_1	Союзник просить нас позбавити його цього неспокійного священника!	true
missions_localised_description_att_diplomatic_western_roman_assassinate_character_agent_male_1	Союзник просить нас позбавити його цього неспокійного священника!	true
missions_localised_title_att_religious_orthodox_construct_building_religious_1	Релігійна вимога	true
missions_localised_title_att_senate_western_roman_construct_bch_all_military_upgrades_1	Військове будівництво	true
missions_localised_description_mk_religious_bogomilist_construct_bch_religion_bogomilist_minor_1	Вкрай важливо будувати молитовні будинки, щоб послідовники нашої віри могли жити в спілкуванні з Господом, подалі від утисків з боку чужоземних правителів.	true
missions_localised_title_att_senate_eastern_construct_bch_eastern_sassanid_military_infantry_1	Військове будівництво	true
missions_localised_description_mk_religious_sunni_recruit_agent_1	Халіф просить призначити нового священнослужителя, який допоміг би зміцнити ісламську віру як усередині країни, так і за її межами.	true
missions_localised_description_att_eos_religious_mission_build_att_rel_semitic_paganism	Смиренно благаємо повелителя повернутися до обрядів, які служили нам вірою і правдою. Зведи чотири релігійні споруди - і ти будеш винагороджений терпінням і побожністю своїх підданих.	true
missions_localised_title_att_diplomatic_eastern_capture_regions_port_1	Взаємодія на війні	true
missions_localised_description_mk_religious_sunni_declare_war_1	Наш обов'язок - сприяти справі ісламу в землях невірних, зокрема за допомогою меча. Аллах акбар!	true
missions_localised_description_att_senate_nordic_lift_blockade_1	Ворог вважає, що може блокувати наші порти. Покажемо йому, хто тут головний!	true
missions_localised_description_cha_mission_pope_help_1	Дезидерій відмовляється повертати Равенну. Захопіть столицю Ломбардії та проголосіть себе захисником Святого престолу.	true
missions_localised_description_ch_vc_3_domination	Перемога через домінування	true
missions_localised_title_att_senate_western_roman_construct_bch_all_livestock_1	Міське будівництво	true
missions_localised_description_att_religious_hellenic_construct_bch_religion_grecoroman_minor_1	Оракул каже, що на нас чекають великі нещастя, якщо ми не будемо шанувати богів. Жерці пропонують умилостивити їх, побудувавши храм.	true
missions_localised_description_mk_religious_cathar_construct_bch_religion_cathar_minor_1	Єпископ просить, щоб ми побудували церкву для святої скинії і славили Всевишнього.	true
missions_localised_description_att_senate_nordic_capture_regions_port_1	Радники стверджують, що цей порт - чудова мета для наших сил.	true
missions_localised_title_att_senate_eastern_roman_construct_building_economic_1	Міське будівництво	true
missions_localised_description_att_senate_nordic_recruit_unit_ranged_1	Камінь або стріла можуть вбити людину або коня нітрохи не гірше, ніж спис. Нам слід перевірити цю теорію в полі.	true
missions_localised_description_att_senate_nordic_construct_bch_barbarian_civic_major_1	Ми повинні виказати повагу нашому народу, зводячи будівлі, що збагачують його культуру.	true
missions_localised_description_att_senate_eastern_declare_war_1	У них свій цар, але він - не Цар царів. Їхні землі по праву належать нам.	true
missions_localised_title_att_senate_nordic_construct_bch_all_city_major_1	Міське будівництво	true
missions_localised_title_att_senate_eastern_assassinate_character_agent_female_1	Смерть до терміну	true
missions_localised_description_ch_vc_2_long	Довга перемога	true
missions_localised_title_att_senate_nordic_research_technology_civil_1	Розвиток суспільства	true
missions_localised_description_att_objective_langobards_primary_2_seal_3	Аттіла народився в темряві та відчаї.	true
missions_localised_description_att_objective_langobards_primary_1_seal_2	Вони готувалися до війни.	true
missions_localised_description_att_objective_langobards_primary_4_seal_5	Немає пощади грішникам.	true
missions_localised_description_att_objective_langobards_primary_3_seal_4	Залиш надію.	true
missions_localised_description_att_objective_langobards_primary_5_seal_6	Час відплати настав.	true
missions_localised_description_att_senate_nomadic_construct_bch_nomad_herders_1	Набіги і збір данини не дадуть нам померти з голоду, але ми все-таки повинні розвивати нашу економіку.	true
missions_localised_title_pro_achieve_food_surplus	Забезпечте надлишок продовольства	true
missions_localised_title_att_senate_eastern_raise_force_army_1	Військова експансія	true
missions_localised_title_att_religious_hellenic_construct_bch_religion_grecoroman_major_1	Релігійна вимога	true
missions_localised_description_att_senate_nomadic_capture_regions_city_1	Ці невірні противляться нашій волі! Спалимо їхні будинки і переріжемо їхню худобу.	true
missions_localised_description_att_objective_garamantes_primary_1_seal_2	Вони готувалися до війни.	true
missions_localised_description_att_objective_garamantes_primary_2_seal_3	Аттіла народився з темряви і відчаю.	true
missions_localised_description_att_senate_eastern_roman_capture_regions_city_1	Сенат просить нас захопити це місто заради слави імперії!	true
missions_localised_description_att_senate_western_roman_capture_regions_city_1	Сенат просить нас захопити це місто заради слави імперії.	true
missions_localised_description_att_objective_garamantes_primary_5_seal_6	Час відплати настав.	true
missions_localised_description_att_objective_garamantes_primary_3_seal_4	Залиш будь-яку надію.	true
missions_localised_description_att_objective_garamantes_primary_4_seal_5	Немає пощади грішникам.	true
missions_localised_title_att_senate_eastern_roman_raid_region_1	Набіги та грабежі	true
missions_localised_description_att_senate_nordic_recruit_unit_infantry_1	Давай наймемо нові загони, щоб вони нагнали страху на наших ворогів.	true
missions_localised_title_att_senate_eastern_roman_construct_bch_all_military_upgrades_1	Військове будівництво	true
missions_localised_title_att_senate_nomadic_construct_bch_nomad_artisan_1	Міське будівництво	true
missions_localised_description_mk_religious_jewish_construct_building_religious_1	Синедріон просить нас побудувати церкву, щоб про нашу віру дізналося більше людей.	true
missions_localised_description_att_religious_arian_declare_war_1	Ці єретики творять страшні справи в ім'я своїх хибних богів. Ми повинні нести їм слово боже вогнем і мечем!	true
missions_localised_title_att_religious_celtic_convert_region_1	Релігійна вимога	true
missions_localised_description_att_senate_eastern_roman_recruit_agent_veteran_1	Сенат обрав досвідчених воїнів, які могли б краще послужити країні, навчаючи новобранців.	true
missions_localised_title_att_senate_eastern_roman_construct_bch_all_livestock_1	Міське будівництво	true
missions_localised_description_att_senate_nomadic_recruit_unit_siege_1	Стіни ворожої фортеці високі й міцні, але ми розколемо їх, немов яєчну шкаралупу!	true
missions_localised_description_att_senate_western_roman_recruit_agent_veteran_1	Сенат вважає, що багато ветеранів принесуть більше користі, якщо стануть навчати легіони.	true
missions_localised_title_att_vc_wonder_1	Мала перемога	true
missions_localised_title_att_senate_western_roman_construct_building_economic_1	Міське будівництво	true
missions_localised_title_att_diplomatic_barbarian_assassinate_character_agent_female_1	Взаємодія на війні	true
missions_localised_title_pro_placate_petrodava	Приборкайте Петродаву	true
missions_localised_title_att_senate_western_roman_construct_bch_all_agriculture_1	Міське будівництво	true
missions_localised_title_att_senate_eastern_roman_construct_bch_all_agriculture_1	Міське будівництво	true
missions_localised_description_mk_religious_cathar_construct_building_religious_1	Єпископ просить, щоб ми побудували церкву для святої скинії і славили Всевишнього.	true
missions_localised_title_att_senate_nomadic_engage_force_army_1	Військова слава	true
missions_localised_description_att_senate_eastern_make_trade_agreement_1	Ми повинні відправити торговців у далекі краї, щоб вони привезли нам заморські товари.	true
missions_localised_title_att_senate_nordic_assassinate_character_agent_female_1	Смерть до терміну	true
missions_localised_title_mk_religious_sunni_construct_bch_religion_sunni_minor_1	Релігійна вимога	true
missions_localised_description_att_senate_nomadic_construct_building_cultural_1	Вожді втомилися від нескінченних воєн. Потрібно організувати для них що-небудь особливе.	true
missions_localised_title_att_religious_manichaeism_construct_building_1	Релігійна вимога	true
missions_localised_title_att_diplomatic_nomadic_blockade_port_1	Взаємодія на війні	true
missions_localised_title_att_senate_western_roman_lift_blockade_1	Прорив блокади	true
missions_localised_description_att_senate_nomadic_make_alliance_1	Може, забезпечити їх зброєю? Тоді після закінчення війни вони напевно захочуть нам віддячити.	true
missions_localised_title_att_senate_eastern_roman_lift_blockade_1	Прорив блокади	true
missions_localised_title_mk_religious_eastern_convert_region_1	Релігійна вимога	true
missions_localised_description_att_bel_request_antoninia_gems_1	То ти зазирнеш у Кесарію за камінчиками, милий? Тільки будь обережний: кажуть, бербери дуже люті, а я не хочу, щоб мій чоловік був мертвим героєм. Набагато краще, коли він живий і дарує мені коштовності...	true
missions_localised_title_att_senate_western_roman_make_alliance_1	Надійний друг	true
missions_localised_title_att_senate_nomadic_construct_building_military_1	Військове будівництво	true
missions_localised_title_att_senate_eastern_roman_make_alliance_1	Надійний друг	true
missions_localised_description_mk_religious_sunni_construct_building_religious_1	Халіф просить нас побудувати мечеть, щоб про нашу віру дізналося більше людей.	true
missions_localised_description_att_senate_eastern_roman_construct_bch_roman_east_civic_major_1	Сенат вважає, що новий пам'ятник культури підвищить нашу популярність у народі.	true
missions_localised_title_pro_political_actions	Беріть участь у політиці	true
missions_localised_title_att_senate_eastern_construct_bch_all_military_upgrades_1	Військове будівництво	true
missions_localised_title_att_senate_nordic_recruit_unit_cavalry_1	Підкріплення	true
missions_localised_title_pro_upgrade_city_apulum	Відбудуйте Апулу	true
missions_localised_title_cha_mission_carloman_succession	Спадщина Карломана	true
missions_localised_title_att_religious_zoroastrian_construct_building_religious_1	Релігійна вимога	true
missions_localised_title_att_senate_eastern_raid_region_1	Набіги та грабежі	true
missions_localised_title_att_objective_lakhmids_primary_5_seal_6	Глава V: Виправдання	true
missions_localised_title_att_objective_lakhmids_primary_3_seal_4	Розділ III: Спустошення	true
missions_localised_title_att_objective_lakhmids_primary_4_seal_5	Розділ IV: Відплата	true
missions_localised_title_att_objective_lakhmids_primary_1_seal_2	Глава I: Підготовка	true
missions_localised_title_att_objective_lakhmids_primary_2_seal_3	Розділ II: Розорення	true
missions_localised_description_att_religious_catholic_convert_region_1	Його святійшество папа римський помітив, що жителі недостатньо благочестиві, і просить тебе виправити це.	true
missions_localised_description_att_senate_eastern_construct_bch_eastern_sassanid_water_minor_1	Наші намісники просять Царя царів побудувати нові міські будівлі, щоб наш уряд був освіченим.	true
missions_localised_description_att_senate_eastern_roman_construct_bch_roman_water_major_1	Сенат вважає, що новий пам'ятник культури підвищить нашу популярність у народі.	true
missions_localised_description_pro_build_farm_adrianople	Тепер, коли наші люди знову оселилися в містах, їм ніде пасти худобу. Нам варто перетворити на пасовища частину земель, прилеглих до Адріанополя.	true
missions_localised_title_att_senate_eastern_construct_bch_all_livestock_1	Міське будівництво	true
missions_localised_description_pro_destroy_rebels_marcianopolis	Римляни ніяк не можуть придушити заколоти у Фракії і просять нас допомогти нам у цьому.	true
missions_localised_title_ch_vc_1_short	Швидка перемога	true
missions_localised_description_att_vc_1_jewish	Перемога іудеїв	true
missions_localised_description_att_vc_2_jewish	Релігійна перемога іудеїв	true
missions_localised_title_att_senate_western_roman_construct_bch_roman_west_civic_major_1	Міське будівництво	true
missions_localised_description_att_objective_sclaveni_primary_3_seal_4	Залиш будь-яку надію.	true
missions_localised_description_att_objective_sclaveni_primary_4_seal_5	Немає пощади грішникам.	true
missions_localised_description_att_objective_sclaveni_primary_5_seal_6	Час відплати настав.	true
missions_localised_description_att_objective_sclaveni_primary_1_seal_2	Вони готувалися до війни.	true
missions_localised_description_att_objective_sclaveni_primary_2_seal_3	Аттіла народився з темряви і відчаю.	true
missions_localised_description_att_senate_nomadic_research_technology_military_1	Будемо вчитися у наших ворогів. Їхні армії добре озброєні й забезпечені, вони готові до того, щоб пережити довгу, повну поневірянь кампанію.	true
missions_localised_description_mk_religious_ibadi_construct_bch_religion_ibadi_minor_1	Улеми просять нас побудувати мечеть, щоб про нашу віру дізналося більше людей.	true
missions_localised_description_att_senate_eastern_roman_research_technology_military_1	Римська імперія затьмарює своєю міццю всі інші народи. Наші воєначальники хочуть, щоб ми вели дослідження в певних галузях - тоді наше панування не похитнеться.	true
missions_localised_description_att_senate_western_roman_research_technology_military_1	Римська імперія затьмарює своєю міццю всі інші народи. Наші воєначальники хочуть, щоб ми вели дослідження в певних галузях - тоді наше панування не похитнеться.	true
missions_localised_title_att_religious_catholic_construct_bch_religion_catholic_major_1	Релігійна вимога	true
missions_localised_title_att_religious_germanic_construct_bch_religion_germanic_major_1	Релігійна вимога	true
missions_localised_title_att_religious_orthodox_construct_bch_religion_orthodox_major_1	Релігійна вимога	true
missions_localised_description_mk_religious_baltic_declare_war_1	Авгури одностайні: боги вимагають крові. Будемо готуватися до війни.	true
missions_localised_description_att_senate_nomadic_recruit_unit_infantry_1	Наша кіннота - найкраща у світі, але без піхоти нам не обійтися. Натиск кінноти можуть зупинити списоносці. Хтось має їх затримати, щоб кіннота могла обійти їх із флангу.	true
missions_localised_description_att_religious_tengri_declare_war_1	Ками поспілкувалися з духами предків. Нам потрібно готуватися до війни з цим народом.	true
missions_localised_title_att_religious_hellenic_assassinate_character_1	Релігійна вимога	true
missions_localised_description_att_senate_nomadic_better_king_1	Ця людина зломислить проти законного державця. Він вважає, що у нього більше прав на корону - і відкрито заявляє про це. Потрібно розібратися з ним, поки він не завдав удару.	true
missions_localised_title_att_senate_nordic_recruit_unit_siege_1	Підкріплення	true
missions_localised_title_att_senate_nordic_construct_building_cultural_1	Міське будівництво	true
missions_localised_title_att_senate_western_roman_recruit_unit_infantry_1	Підкріплення	true
missions_localised_description_slav_mission_sclaveneans_1	Настав час перейти в наступ і показати гунам, хто тут господар. Нанесіть удар і знищіть якомога більше гунських армій. Так ви зможете зломити їхній дух і підкорити їх собі!	true
missions_localised_description_slav_mission_sclaveneans_2	Гуни наближаються, але ми готові їх зустріти. Не допускайте жодних проявів слабкості. Якщо вони вступлять у бій, отримайте перемогу. Якщо вони піднімуть руку на наше поселення, зітріть їх з лиця землі.	true
missions_localised_title_att_senate_eastern_roman_recruit_unit_infantry_1	Підкріплення	true
missions_localised_description_pro_build_farm_petrodava	У Петродаві є вільне місце для нових будівель. Зведи там ферму. Це забезпечить місцевих жителів їстівними припасами.	true
missions_localised_title_att_victory_mission_1_success	Успіх	true
missions_localised_description_att_diplomatic_western_roman_engage_force_navy_1	Наші союзники хочуть, щоб цей флот був знищений.	true
missions_localised_description_att_diplomatic_eastern_roman_engage_force_navy_1	Наші союзники хочуть, щоб цей флот був знищений.	true
missions_localised_description_att_religious_germanic_convert_region_1	Старі боги незадоволені, адже жителі цих країв не поклоняються їм. Навчимо їх звичаїв нашого народу.	true
missions_localised_title_mk_religious_bogomilist_declare_war_1	Релігійна вимога	true
missions_localised_description_mk_religious_shia_recruit_agent_1	Улеми просять, щоб ми заснували медресе і найняли більше імамів. Громадам ісламу потрібно більше лідерів.	true
missions_localised_description_att_victory_mission_2_cultural_victory	Культурна перемога	true
missions_localised_title_att_eos_religious_mission_build_att_rel_judaism	Верховний рабин - благочестя	true
missions_localised_description_att_religious_celtic_declare_war_1	Авгури одностайні: боги вимагають крові. Будемо готуватися до війни.	true
missions_localised_description_att_diplomatic_eastern_engage_force_navy_1	Наші союзники хочуть, щоб цей флот був знищений.	true
missions_localised_title_att_bel_request_justinian_amalasuntha_1	Прохання Юстиніана: Амаласунта	true
missions_localised_description_att_religious_hellenic_convert_region_1	Мешканці цього краю не поклоняються нашим богам. Клянуся Зевсом, ми повинні їх цього навчити.	true
missions_localised_description_att_senate_eastern_construct_bch_eastern_sassanid_civic_major_1	Наші намісники просять Царя царів побудувати нові міські будівлі, щоб наш уряд був освіченим.	true
missions_localised_title_att_senate_eastern_construct_building_economic_1	Міське будівництво	true
missions_localised_description_att_religious_arian_construct_building_religious_1	Єпископ просить, щоб ми побудували церкву для святої скинії і славили Всевишнього.	true
missions_localised_description_att_senate_western_roman_construct_bch_roman_water_major_1	Сенат вважає, що новий пам'ятник культури підвищить нашу популярність у народі.	true
missions_localised_title_att_diplomatic_eastern_roman_engage_force_army_1	Взаємодія на війні	true
missions_localised_title_att_diplomatic_western_roman_engage_force_army_1	Взаємодія на війні	true
missions_localised_description_att_objective_alamanii_primary_2_seal_3	Аттіла народився в темряві та відчаї.	true
missions_localised_description_att_objective_alamanii_primary_1_seal_2	Вони готувалися до війни.	true
missions_localised_description_att_objective_alamanii_primary_4_seal_5	Немає пощади грішникам.	true
missions_localised_description_att_objective_alamanii_primary_3_seal_4	Залиш надію.	true
missions_localised_description_att_objective_alamanii_primary_5_seal_6	Час відплати настав.	true
missions_localised_description_att_senate_nordic_raid_region_1	Наші війська повинні розорити землі ворогів і вселити жах у їхні жалюгідні душі!	true
missions_localised_title_mk_religious_sunni_construct_bch_religion_sunni_major_1	Релігійна вимога	true
missions_localised_title_att_diplomatic_western_roman_engage_force_navy_1	Взаємодія на війні	true
missions_localised_title_att_diplomatic_eastern_roman_engage_force_navy_1	Взаємодія на війні	true
missions_localised_description_att_diplomatic_eastern_roman_engage_force_army_1	Союзники попросили нас стерти цю армію в порох.	true
missions_localised_title_att_religious_catholic_recruit_agent_1	Релігійна вимога	true
missions_localised_description_att_objective_white_huns_primary_5_seal_6	Час відплати настав.	true
missions_localised_description_att_objective_white_huns_primary_4_seal_5	Немає пощади грішникам.	true
missions_localised_description_att_objective_white_huns_primary_3_seal_4	Залиш будь-яку надію.	true
missions_localised_description_att_diplomatic_western_roman_engage_force_army_1	Союзники попросили нас стерти цю армію в порох.	true
missions_localised_description_att_objective_white_huns_primary_2_seal_3	Аттіла народився з темряви і відчаю.	true
missions_localised_description_att_objective_white_huns_primary_1_seal_2	Вони готувалися до війни.	true
missions_localised_title_att_objective_tanukhid_primary_1_seal_2	Глава I: Підготовка	true
missions_localised_title_att_objective_tanukhid_primary_2_seal_3	Розділ II: Розорення	true
missions_localised_title_att_objective_tanukhid_primary_3_seal_4	Розділ III: Спустошення	true
missions_localised_title_att_objective_tanukhid_primary_4_seal_5	Розділ IV: Відплата	true
missions_localised_title_att_objective_tanukhid_primary_5_seal_6	Глава V: Виправдання	true
missions_localised_description_att_senate_eastern_construct_building_economic_1	Цей край багатий, у ньому багато сировини. Воно має принести користь Царю царів.	true
missions_localised_description_att_senate_eastern_blockade_port_1	Наш спахбед радить блокувати цей порт, щоб позбавити ворога доходів від торгівлі.	true
missions_localised_description_att_diplomatic_eastern_engage_force_army_1	Союзники попросили нас стерти цю армію в порох.	true
missions_localised_description_pro_destroy_rebels_thessalonica	Наші люди поклали все, що можуть забрати, і продали або спалили все інше. Римляни готові нам допомогти, але натомість вимагають від нас виступити проти заколотників, які стоять біля Фессалонік. Вдаримо по них швидше, щоб заслужити вдячність наших нових друзів у Константинополі.	true
missions_localised_title_att_senate_nordic_recruit_agent_spy_1	Очі та вуха	true
missions_localised_description_att_senate_nordic_recruit_agent_veteran_1	Про наших ветеранів складають легенди. Нехай вони розповідають новачкам про війну і свої подвиги.	true
missions_localised_title_att_senate_eastern_roman_recruit_unit_ranged_1	Підкріплення	true
missions_localised_description_att_senate_eastern_roman_make_trade_agreement_1	Римська імперія - це центр торгівлі, від східних до західних кордонів. Сенат вважає, що ми повинні поділитися багатством з нашими меншими братами.	true
missions_localised_description_att_senate_western_roman_make_trade_agreement_1	Імперія - це центр торгівлі, від східних до західних кордонів. Сенат вважає, що ми повинні поділитися багатством із простими, але тим не менш гідними громадянами.	true
missions_localised_title_att_senate_western_roman_declare_war_1	Барабани війни	true
missions_localised_title_att_senate_nordic_construct_building_military_1	Військове будівництво	true
missions_localised_title_att_vc_1_historical_separatist	Перемога експедиції	true
missions_localised_description_att_religious_christian_reform_pentarchy_1	Один зі Святих престолів перетворився на лігво єретиків. Єпископ вимагає, щоб усі добрі християни допомогли відновити там істинну віру.	true
missions_localised_title_pro_build_farm_petrodava	Побудуйте садибу в Петродаві	true
missions_localised_description_att_senate_eastern_construct_bch_eastern_sassanid_water_major_1	Наші намісники просять Царя царів побудувати нові міські будівлі, щоб наш уряд був освіченим.	true
missions_localised_description_att_senate_western_roman_recruit_unit_infantry_1	З часів Марія правою рукою держави була армія. Ми повинні зробити все, щоб так було і далі.	true
missions_localised_description_att_senate_eastern_roman_recruit_unit_infantry_1	З часів Марія хребтом нашої армії є піхота. Сенат просить її посилити.	true
missions_localised_title_att_senate_nomadic_construct_bch_nomad_noble_1	Міське будівництво	true
missions_localised_title_att_senate_nomadic_better_king_1	Хороший цар?	true
missions_localised_description_att_senate_western_roman_construct_bch_roman_civic_major_1	Сенат вважає, що новий пам'ятник культури підвищить нашу популярність у народі.	true
missions_localised_description_att_senate_eastern_roman_construct_bch_roman_water_minor_1	Сенат вважає, що новий пам'ятник культури підвищить нашу популярність у народі.	true
missions_localised_description_att_religious_zoroastrian_construct_building_religious_1	Волхви просять нас побудувати храм одночасно і для Атара, і для Абана, щоб віряни могли кидати жертвоприношення в очищувальний вогонь.	true
missions_localised_title_att_senate_western_roman_construct_bch_roman_west_civic_minor_1	Міське будівництво	true
missions_localised_description_att_senate_eastern_raid_region_1	Розоримо землі ворога, спалимо його ферми!	true
missions_localised_title_att_religious_orthodox_convert_region_1	Релігійна вимога	true
missions_localised_description_mk_religious_ibadi_construct_bch_religion_ibadi_major_1	Улеми просять нас побудувати мечеть, щоб про нашу віру дізналося більше людей.	true
missions_localised_description_att_senate_nordic_recruit_unit_cavalry_1	Піхота діє ефективніше, якщо її фланги прикриває кіннота. Нам потрібно якомога швидше набрати кілька кінних загонів.	true
missions_localised_title_cha_mission_asturias_1	Прохання понтифіка	true
missions_localised_description_att_senate_eastern_construct_bch_all_military_upgrades_1	Нові військові споруди лише зміцнять славу Царя царів.	true
missions_localised_title_att_religious_catholic_construct_bch_religion_catholic_minor_1	Релігійна вимога	true
missions_localised_title_att_religious_germanic_construct_bch_religion_germanic_minor_1	Релігійна вимога	true
missions_localised_title_att_religious_orthodox_construct_bch_religion_orthodox_minor_1	Релігійна вимога	true
missions_localised_description_mk_religious_ibadi_construct_building_religious_1	Улеми просять нас побудувати мечеть, щоб про нашу віру дізналося більше людей.	true
missions_localised_title_att_senate_nordic_recruit_unit_naval_1	Підкріплення	true
missions_localised_description_att_senate_eastern_construct_bch_all_livestock_1	Цей край багатий, у ньому багато сировини. Воно має принести користь Царю царів.	true
missions_localised_title_pro_destroy_rebels_marcianopolis	Перемогти заколотників у Маркіанополі.	true
missions_localised_description_att_senate_nordic_construct_building_economic_1	Ми повинні більш дбайливо використовувати доступні ресурси. Цей край може дати нам набагато більше.	true
missions_localised_title_cha_mission_cordoba_caliphate	Кордовський халіфат	true
missions_localised_description_pro_build_torp_adrianople	Якщо ми хочемо отримати максимум користі з муніципальних будівель Адріанополя, їх потрібно перебудувати. Доручи це своїм людям.	true
missions_localised_description_pro_engage_hun_third_wave	Римляни, наші нові друзі, навряд чи зрадіють тому, що гуни перейшли через Дунай. Потрібно відтіснити загарбників, поки вони не встигли завдати великої шкоди.	true
missions_localised_description_att_senate_eastern_research_technology_military_1	Наші найбільші мудреці повинні зайнятися розробкою нових військових стратегій.	true
missions_localised_title_att_objective_vandals_primary_1_seal_2	Глава I: Підготовка	true
missions_localised_title_att_objective_vandals_primary_2_seal_3	Розділ II: Розорення	true
missions_localised_title_att_objective_vandals_primary_3_seal_4	Розділ III: Спустошення	true
missions_localised_title_att_objective_vandals_primary_4_seal_5	Розділ IV: Відплата	true
missions_localised_title_att_objective_vandals_primary_5_seal_6	Глава V: Виправдання	true
missions_localised_title_att_senate_eastern_roman_recruit_unit_cavalry_1	Підкріплення	true
missions_localised_title_att_senate_western_roman_recruit_unit_cavalry_1	Підкріплення	true
missions_localised_title_att_senate_western_roman_recruit_unit_ranged_1	Підкріплення	true
missions_localised_title_att_senate_eastern_roman_declare_war_1	Барабани війни	true
missions_localised_title_att_senate_eastern_research_technology_civil_1	Розвиток суспільства	true
missions_localised_description_att_senate_western_roman_lift_blockade_1	Судноплавство морськими торговельними шляхами імперії перервано. Сенат хоче, щоб ми негайно його відновили.	true
missions_localised_description_att_senate_eastern_roman_lift_blockade_1	Судноплавство морськими торговельними шляхами імперії перервано. Сенат хоче, щоб ми негайно його відновили.	true
missions_localised_title_att_senate_nomadic_construct_building_cultural_1	Міське будівництво	true
missions_localised_title_att_vc_1_pagan	Перемога язичників	true
missions_localised_title_att_vc_2_pagan	Релігійна перемога язичників	true
missions_localised_title_att_religious_germanic_recruit_agent_1	Релігійна вимога	true
missions_localised_title_att_religious_orthodox_recruit_agent_1	Релігійна вимога	true
missions_localised_description_att_senate_eastern_construct_bch_eastern_sassanid_civic_minor_1	Наші намісники просять Царя царів побудувати нові міські будівлі, щоб наш уряд був освіченим.	true
missions_localised_description_att_senate_nomadic_construct_building_military_1	Побудувавши нові табори для навчання, ми отримаємо потужнішу і швидшу кінноту, яка поставить ворогів на коліна.	true
missions_localised_description_att_senate_western_roman_make_alliance_1	Це буде непросто, але Сенат переконаний, що союз із цим народом принесе імперії чималу вигоду.	true
missions_localised_description_att_senate_eastern_roman_make_alliance_1	Це буде непросто, але Сенат переконаний, що союз із цим народом принесе імперії чималу вигоду.	true
missions_localised_description_att_senate_eastern_roman_construct_bch_roman_civic_major_1	Сенат вважає, що новий пам'ятник культури підвищить нашу популярність у народі.	true
missions_localised_description_att_senate_western_roman_construct_bch_roman_water_minor_1	Сенат вважає, що новий пам'ятник культури підвищить нашу популярність у народі.	true
missions_localised_title_att_bel_request_antoninia_gems_1	Прохання Антоніни: самоцвіти	true
missions_localised_description_pro_engage_hun_first_wave	Гуни готуються до атаки! Вони численні, але ми повинні перемогти їх. Подбай про це.	true
missions_localised_description_att_objective_burgundians_primary_5_seal_6	Час відплати настав.	true
missions_localised_description_att_objective_burgundians_primary_3_seal_4	Залиш надію.	true
missions_localised_description_att_objective_burgundians_primary_4_seal_5	Немає пощади грішникам.	true
missions_localised_description_att_test_victory_mission_military	Тестова військова перемога	true
missions_localised_description_att_objective_burgundians_primary_1_seal_2	Вони готувалися до війни.	true
missions_localised_description_att_objective_burgundians_primary_2_seal_3	Аттіла народився в темряві та відчаї.	true
missions_localised_title_att_objective_sclaveni_primary_1_seal_2	Глава I: Підготовка	true
missions_localised_title_att_objective_sclaveni_primary_2_seal_3	Розділ II: Розорення	true
missions_localised_title_att_objective_sclaveni_primary_5_seal_6	Глава V: Виправдання	true
missions_localised_title_att_objective_sclaveni_primary_3_seal_4	Розділ III: Спустошення	true
missions_localised_title_att_objective_sclaveni_primary_4_seal_5	Розділ IV: Відплата	true
missions_localised_description_att_senate_nomadic_weak_leader_5	Наш цар хворий і слабкий, він діє необачно, і через це сусіди вважають нас слабаками. Його потрібно усунути, щоб орда обрала собі гідного ватажка.	true
missions_localised_description_att_senate_nomadic_weak_leader_4	Наш цар хворий і слабкий, він діє необачно, і через це сусіди вважають нас слабаками. Його потрібно усунути, щоб орда обрала собі гідного ватажка.	true
missions_localised_description_att_senate_nomadic_weak_leader_7	Наш цар хворий і слабкий, він діє необачно, і через це сусіди вважають нас слабаками. Його потрібно усунути, щоб орда обрала собі гідного ватажка.	true
missions_localised_description_att_senate_nomadic_weak_leader_6	Наш цар хворий і слабкий, він діє необачно, і через це сусіди вважають нас слабаками. Його потрібно усунути, щоб орда обрала собі гідного ватажка.	true
missions_localised_description_att_senate_western_roman_construct_bch_roman_west_civic_major_1	Сенат вважає, що новий пам'ятник культури підвищить нашу популярність у народі.	true
missions_localised_description_att_senate_nomadic_weak_leader_1	Наш цар хворий і слабкий, він діє необачно, і через це сусіди вважають нас слабаками. Його потрібно усунути, щоб орда обрала собі гідного ватажка.	true
missions_localised_description_att_senate_nomadic_weak_leader_3	Наш цар хворий і слабкий, він діє необачно, і через це сусіди вважають нас слабаками. Його потрібно усунути, щоб орда обрала собі гідного ватажка.	true
missions_localised_description_att_senate_eastern_recruit_unit_cavalry_1	Нам би побільше кінноти, і тоді ми поженемо ворога, немов вітер - сухе листя!	true
missions_localised_description_att_senate_nomadic_weak_leader_2	Наш цар хворий і слабкий, він діє необачно, і через це сусіди вважають нас слабаками. Його потрібно усунути, щоб орда обрала собі гідного ватажка.	true
missions_localised_title_att_senate_eastern_roman_research_technology_military_1	Прогрес військової справи	true
missions_localised_title_att_senate_western_roman_research_technology_military_1	Прогрес військової справи	true
missions_localised_title_mk_religious_ibadi_construct_bch_religion_ibadi_minor_1	Релігійна вимога	true
missions_localised_title_att_religious_hellenic_recruit_agent_1	Релігійна вимога	true
missions_localised_description_cha_objective_cha_avars_primary_5_seal_6	Слава Європи - в єдності. Нехай же ніхто не посміє відокремитися від великої держави, створеної істинним королем!	true
missions_localised_description_cha_objective_cha_avars_primary_4_seal_5	Здійснюючи великі діяння, король створює спадщину, непідвладну часу і смерті.	true
missions_localised_description_cha_objective_cha_avars_primary_3_seal_4	Вороги б'ються об армію істинного короля, немов хвилі об берег. Рішучий, він встоїть під їхніми ударами.	true
missions_localised_description_cha_objective_cha_avars_primary_2_seal_3	Перш ніж істинний король затвердить свою владу над землею, його ім'я повинно прозвучати з усіх чотирьох сторін.	true
missions_localised_description_cha_objective_cha_avars_primary_1_seal_2	Дрібні правителі подібні до псів, що шматують тіло Європи. Істинний король повстане і розжене їх.	true
missions_localised_description_att_senate_nordic_construct_building_cultural_1	Ми повинні виказати повагу нашому народу, зводячи будівлі, що збагачують його культуру.	true
missions_localised_description_att_senate_eastern_recruit_unit_infantry_1	Воєначальників непокоїть нестача піхоти. Вони просять нас зайнятися цим питанням.	true
missions_localised_title_mk_religious_shia_construct_bch_religion_shia_minor_1	Релігійна вимога	true
missions_localised_title_att_religious_germanic_convert_region_1	Релігійна вимога	true
missions_localised_description_mk_religious_shia_assassinate_character_1	Ця людина - богохульник і невірний. Проти нього було видано фетву, що закликає до його смерті.	true
missions_localised_description_att_senate_nordic_research_technology_military_1	Інші народи шукають нові способи посилити свою бойову міць. Ми повинні наслідувати їхній приклад - інакше нас зметуть з дороги.	true
missions_localised_title_att_senate_nomadic_construct_building_economic_1	Міське будівництво	true
missions_localised_title_att_senate_nordic_make_trade_agreement_1	Справи торговельні	true
missions_localised_description_att_eos_religious_mission_build_att_rel_judaism	Смиренно благаємо повелителя повернутися до обрядів, які служили нам вірою і правдою. Зведи чотири релігійні споруди - і ти будеш винагороджений терпінням і побожністю своїх підданих.	true
missions_localised_description_att_bel_request_justinian_amalasuntha_1	Вирушай до Реати і звільни царицю остготів. Зробивши це, ти врятуєш незліченні життя і наблизиш повернення Італії в лоно імперії. Я розраховую на тебе, Велісарій.	true
missions_localised_title_att_senate_eastern_construct_bch_eastern_sassanid_civic_major_1	Міське будівництво	true
missions_localised_title_att_religious_hellenic_convert_region_1	Релігійна вимога	true
missions_localised_description_att_senate_western_roman_blockade_port_1	Наші торговці підтверджують: цей порт - головна частина ворожої торговельної мережі. Нам потрібно негайно його блокувати.	true
missions_localised_description_att_senate_eastern_roman_blockade_port_1	Торговці стверджують, що цей порт приносить величезний дохід нашим ворогам. Його потрібно блокувати.	true
missions_localised_title_att_objective_primary_2_seal_3	Розділ II: Розорення	true
missions_localised_title_att_objective_primary_1_seal_2	Глава I: Підготовка	true
missions_localised_title_att_objective_primary_5_seal_6	Глава V: Виправдання	true
missions_localised_title_att_objective_primary_4_seal_5	Розділ IV: Відплата	true
missions_localised_title_att_objective_primary_3_seal_4	Розділ III: Спустошення	true
missions_localised_title_att_diplomatic_barbarian_assassinate_character_general_1	Взаємодія на війні	true
missions_localised_description_att_religious_zoroastrian_convert_region_1	Мобеди терпимо ставляться до чужої віри, проте наш народ потерпає від релігійних чвар. Люди просять нас придушити заворушення.	true
missions_localised_description_att_diplomatic_nomadic_engage_force_navy_1	Наші союзники хочуть, щоб цей флот був знищений.	true
missions_localised_description_cha_mission_avar_khaganate	Здобудьте могутність, побудуйте своє королівство, створіть спадщину на століття - і ваше ім'я назавжди увійде в історію!	true
missions_localised_description_mk_religious_sunni_construct_bch_religion_sunni_minor_1	Халіф просить нас побудувати мечеть, щоб про нашу віру дізналося більше людей.	true
missions_localised_description_att_objective_sassanids_primary_5_seal_6	Час відплати настав.	true
missions_localised_description_att_objective_sassanids_primary_3_seal_4	Залиш будь-яку надію.	true
missions_localised_description_cha_objective_cha_danes_primary_1_seal_2	Дрібні правителі подібні до псів, що шматують тіло Європи. Істинний король повстане і розжене їх.	true
missions_localised_description_att_objective_sassanids_primary_4_seal_5	Немає пощади грішникам.	true
missions_localised_description_cha_objective_cha_danes_primary_2_seal_3	Перш ніж істинний король затвердить свою владу над землею, його ім'я повинно прозвучати з усіх чотирьох сторін.	true
missions_localised_description_att_objective_sassanids_primary_1_seal_2	Вони готувалися до війни.	true
missions_localised_description_cha_objective_cha_danes_primary_3_seal_4	Вороги б'ються об армію істинного короля, немов хвилі об берег. Рішучий, він встоїть під їхніми ударами.	true
missions_localised_description_att_objective_sassanids_primary_2_seal_3	Аттіла народився з темряви і відчаю.	true
missions_localised_description_cha_objective_cha_danes_primary_4_seal_5	Здійснюючи великі діяння, король створює спадщину, непідвладну часу і смерті.	true
missions_localised_description_cha_objective_cha_danes_primary_5_seal_6	Слава Європи - в єдності. Нехай же ніхто не посміє відокремитися від великої держави, створеної істинним королем!	true
missions_localised_title_att_senate_eastern_construct_building_military_1	Військове будівництво	true
missions_localised_description_att_senate_eastern_lift_blockade_1	Ворожий флот блокував наш порт і, безсумнівно, готується до нападу. Наші воєначальники просять нас усунути цю загрозу.	true
missions_localised_description_att_mp_versus_separatist	Перемога сепаратистів у режимі "Сам на сам"	true
missions_localised_title_att_senate_eastern_engage_force_army_1	Військова слава	true
missions_localised_description_att_senate_eastern_construct_building_cultural_1	Наші намісники просять Царя царів побудувати нові міські будівлі, щоб наш уряд був освіченим.	true
missions_localised_title_att_diplomatic_eastern_blockade_port_1	Взаємодія на війні	true
missions_localised_description_att_senate_eastern_make_alliance_1	Якщо ми укладемо союз із цим народом, він сильно виграє від нашої освіченості.	true
missions_localised_description_att_victory_mission_2_military_victory	Військова перемога	true
missions_localised_title_att_senate_eastern_roman_construct_bch_roman_east_civic_major_1	Міське будівництво	true
missions_localised_description_cha_mission_carloman_succession	Не пропустіть шанс, мій пане! Якщо ми захопимо столицю Карломана і покінчимо з його прихильниками одним ударом, більше ніхто не засумнівається в нашій владі над цими землями.	true
missions_localised_description_pro_upgrade_city_apulum	Укріплення Апули, що служили зримим втіленням могутності вестготів, сильно постраждали під час нещодавньої атаки. Відбудуйте та укріпіть місто, щоб затвердити нашу владу над провінцією.	true
missions_localised_title_att_vc_1_historical_expedition	Перемога сепаратистів	true
missions_localised_description_att_objective_lakhmids_primary_1_seal_2	Вони готувалися до війни.	true
missions_localised_description_att_objective_lakhmids_primary_2_seal_3	Аттіла народився з темряви і відчаю.	true
missions_localised_description_att_objective_lakhmids_primary_3_seal_4	Залиш будь-яку надію.	true
missions_localised_description_att_objective_lakhmids_primary_4_seal_5	Немає пощади грішникам.	true
missions_localised_description_att_objective_lakhmids_primary_5_seal_6	Час відплати настав.	true
missions_localised_title_att_senate_eastern_construct_bch_eastern_sassanid_water_minor_1	Міське будівництво	true
missions_localised_title_att_religious_catholic_convert_region_1	Релігійна вимога	true
missions_localised_description_att_objective_visigoths_primary_5_seal_6	Час відплати настав.	true
missions_localised_description_att_objective_visigoths_primary_4_seal_5	Немає пощади грішникам.	true
missions_localised_description_att_objective_visigoths_primary_3_seal_4	Залиш будь-яку надію.	true
missions_localised_description_att_objective_visigoths_primary_2_seal_3	Аттіла народився з темряви і відчаю.	true
missions_localised_description_att_objective_visigoths_primary_1_seal_2	Вони готувалися до війни.	true
missions_localised_title_att_senate_nomadic_raid_region_1	Набіги та грабежі	true
missions_localised_description_att_test_victory_mission_economic	Тестова економічна перемога	true
missions_localised_title_att_vc_1_jewish	Перемога іудеїв	true
missions_localised_title_att_vc_2_jewish	Релігійна перемога іудеїв	true
missions_localised_description_att_senate_western_roman_construct_bch_roman_west_civic_minor_1	Сенат вважає, що новий пам'ятник культури підвищить нашу популярність у народі.	true
missions_localised_title_mk_religious_ibadi_construct_bch_religion_ibadi_major_1	Релігійна вимога	true
missions_localised_description_att_religious_orthodox_convert_region_1	Патріарх надіслав листа. Він просить навернути цей край до істинної віри.	true
missions_localised_description_att_senate_nomadic_raid_region_1	Ворог не відчуває жодної поваги до нас. Розграбуємо його землю, щоб він зрозумів, із ким має справу.	true
missions_localised_title_cha_objective_cha_charlemagne_primary_3_seal_4	Прибій війни	true
missions_localised_title_cha_objective_cha_charlemagne_primary_4_seal_5	Створена спадщина	true
missions_localised_title_att_senate_nordic_construct_building_economic_1	Міське будівництво	true
missions_localised_title_cha_objective_cha_charlemagne_primary_5_seal_6	Відродження Європи	true
missions_localised_title_cha_objective_cha_charlemagne_primary_1_seal_2	Розколотий світ	true
missions_localised_title_cha_objective_cha_charlemagne_primary_2_seal_3	Королівське ім'я	true
missions_localised_title_att_objective_visigoths_primary_1_seal_2	Глава I: Підготовка	true
missions_localised_title_att_objective_visigoths_primary_2_seal_3	Розділ II: Розорення	true
missions_localised_title_att_objective_visigoths_primary_5_seal_6	Глава V: Виправдання	true
missions_localised_title_att_objective_visigoths_primary_3_seal_4	Розділ III: Спустошення	true
missions_localised_title_att_objective_visigoths_primary_4_seal_5	Розділ IV: Відплата	true
missions_localised_description_att_religious_manichaeism_convert_region_1	Наш ватажок терпимо ставиться до чужої віри, проте наш народ потерпає від релігійних чвар. Люди просять нас придушити заворушення.	true
missions_localised_title_att_senate_eastern_engage_force_navy_1	У глибини	true
missions_localised_title_mk_religious_shia_construct_bch_religion_shia_major_1	Релігійна вимога	true
missions_localised_title_att_mp_versus_separatist	Перемога сепаратистів у режимі "Сам на сам"	true
missions_localised_description_att_senate_eastern_roman_recruit_unit_cavalry_1	Успішна армія - це армія збалансована. У нас не вистачає кінноти, і це потрібно виправити.	true
missions_localised_description_att_senate_western_roman_recruit_unit_cavalry_1	Досвідчений полководець знає, що найкраща армія - це армія збалансована. Тому нам потрібно якнайшвидше найняти кінноту.	true
missions_localised_description_att_senate_nomadic_recruit_unit_cavalry_1	Наші кіннотники наводять жах на ворогів. Нехай вороги тремтять ще сильніше!	true
missions_localised_description_att_senate_eastern_construct_building_military_1	Нові військові споруди лише зміцнять славу Царя царів.	true
missions_localised_description_cha_objective_cha_cordoba_primary_5_seal_6	Слава Європи - в єдності. Нехай же ніхто не посміє відокремитися від великої держави, створеної істинним королем!	true
missions_localised_description_cha_objective_cha_cordoba_primary_4_seal_5	Здійснюючи великі діяння, король створює спадщину, непідвладну часу і смерті.	true
missions_localised_description_cha_objective_cha_cordoba_primary_3_seal_4	Вороги б'ються об армію істинного короля, немов хвилі об берег. Рішучий, він встоїть під їхніми ударами.	true
missions_localised_description_cha_objective_cha_cordoba_primary_2_seal_3	Перш ніж істинний король затвердить свою владу над землею, його ім'я повинно прозвучати з усіх чотирьох сторін.	true
missions_localised_description_cha_objective_cha_cordoba_primary_1_seal_2	Дрібні правителі подібні до псів, що шматують тіло Європи. Істинний король повстане і розжене їх.	true
missions_localised_title_att_objective_sassanids_primary_2_seal_3	Розділ II: Розорення	true
missions_localised_title_cha_objective_cha_danes_primary_4_seal_5	Створена спадщина	true
missions_localised_title_att_objective_sassanids_primary_1_seal_2	Глава I: Підготовка	true
missions_localised_title_cha_objective_cha_danes_primary_3_seal_4	Прибій війни	true
missions_localised_title_cha_objective_cha_danes_primary_5_seal_6	Відродження Європи	true
missions_localised_title_att_objective_sassanids_primary_5_seal_6	Глава V: Виправдання	true
missions_localised_title_att_objective_sassanids_primary_4_seal_5	Розділ IV: Відплата	true
missions_localised_title_cha_objective_cha_danes_primary_2_seal_3	Королівське ім'я	true
missions_localised_title_att_objective_sassanids_primary_3_seal_4	Розділ III: Спустошення	true
missions_localised_title_cha_objective_cha_danes_primary_1_seal_2	Розколотий світ	true
missions_localised_title_att_religious_orthodox_assassinate_character_1	Релігійна вимога	true
missions_localised_title_att_religious_germanic_assassinate_character_1	Релігійна вимога	true
missions_localised_title_att_senate_eastern_construct_bch_eastern_sassanid_civic_minor_1	Міське будівництво	true
missions_localised_title_att_senate_nomadic_research_technology_civil_1	Розвиток суспільства	true
missions_localised_description_att_objective_bel_vandals_primary_2_seal_3	Сірі небеса віщують усім нам похмурі часи. Але ми вистоїмо і задушимо наших ворогів попелом і смогом.	true
missions_localised_description_att_objective_bel_vandals_primary_1_seal_2	Результати важких перемог під загрозою. Минуле звернуло на нас свій похмурий і згубний погляд. У цьому важкому становищі імператор відправив війська в похід, щоб відновити колишню імперію. Вони неминуче зазнають поразки у війні з новим королівством!	true
missions_localised_title_att_senate_eastern_construct_building_cultural_1	Міське будівництво	true
missions_localised_description_att_objective_bel_vandals_primary_5_seal_6	Ми домоглися майже неможливого. Наші противники втрачають надію, довго вони не вистоять. Ми створимо новий світ із попелу старого!	true
missions_localised_description_att_objective_bel_vandals_primary_4_seal_5	Світ змінився назавжди. Старі імперії впали і звільнили дорогу новій великій державі. Розширимо ж її межі та закріпимо свій успіх навічно!	true
missions_localised_description_att_objective_bel_vandals_primary_3_seal_4	Колишній світ імперій гине. Але приходить новий світ, світ королівств. Місце в ньому знайдеться тільки найсильнішим. І ми будемо серед них!	true
missions_localised_description_att_objective_caledonians_primary_3_seal_4	Залиш надію.	true
missions_localised_description_att_objective_caledonians_primary_4_seal_5	Немає пощади грішникам.	true
missions_localised_description_att_objective_caledonians_primary_5_seal_6	Час відплати настав.	true
missions_localised_description_att_objective_caledonians_primary_1_seal_2	Вони готувалися до війни.	true
missions_localised_description_att_objective_caledonians_primary_2_seal_3	Аттіла народився з темряви і відчаю.	true
missions_localised_title_att_objective_alamanii_primary_5_seal_6	Глава V: Виправдання	true
missions_localised_title_att_objective_alamanii_primary_4_seal_5	Розділ IV: Відплата	true
missions_localised_title_att_objective_alamanii_primary_3_seal_4	Розділ III: Спустошення	true
missions_localised_title_att_objective_alamanii_primary_2_seal_3	Розділ II: Розорення	true
missions_localised_title_att_objective_alamanii_primary_1_seal_2	Глава I: Підготовка	true
missions_localised_description_mk_religious_sunni_construct_bch_religion_sunni_major_1	Халіф просить нас побудувати мечеть, щоб про нашу віру дізналося більше людей.	true
missions_localised_title_att_senate_nordic_raid_region_1	Набіги та грабежі	true
missions_localised_description_att_senate_nomadic_construct_building_economic_1	Набіги і збір данини не дадуть нам померти з голоду, але ми все-таки повинні розвивати нашу економіку.	true
missions_localised_description_att_senate_nordic_make_trade_agreement_1	Якщо ворог отримує прибуток від торгівлі, то чому цього не можемо робити ми? Відправимо торговців у далеку дорогу, нехай вони наб'ють нашу скарбницю.	true
missions_localised_description_mk_religious_cathar_declare_war_1	Безневинні жителі зазнають нападів з боку фанатичних і жорстоких людей, і ми змушені взятися за зброю, щоб захистити їх в ім'я Господа.	true
missions_localised_description_att_senate_nomadic_construct_bch_nomad_community_1	Вожді втомилися від нескінченних воєн. Потрібно організувати для них що-небудь особливе.	true
missions_localised_title_att_senate_nordic_research_technology_military_1	Прогрес військової справи	true
missions_localised_description_att_diplomatic_nomadic_engage_force_army_1	Союзники попросили нас стерти цю армію в порох.	true
missions_localised_description_att_test_victory_mission_cultural	Тестова культурна перемога	true
missions_localised_description_att_objective_tanukhid_primary_5_seal_6	Час відплати настав.	true
missions_localised_title_cha_mission_vikings_1	Неспокійні воїни	true
missions_localised_description_att_objective_tanukhid_primary_3_seal_4	Залиш будь-яку надію.	true
missions_localised_description_att_objective_tanukhid_primary_4_seal_5	Немає пощади грішникам.	true
missions_localised_description_att_objective_tanukhid_primary_1_seal_2	Вони готувалися до війни.	true
missions_localised_description_att_objective_tanukhid_primary_2_seal_3	Аттіла народився з темряви і відчаю.	true
missions_localised_title_att_religious_catholic_assassinate_character_1	Релігійна вимога	true
missions_localised_description_att_diplomatic_barbarian_assassinate_character_general_1	Наш союзник засудив цього полководця до смерті.	true
missions_localised_title_att_senate_western_roman_blockade_port_1	Блокада	true
missions_localised_description_att_senate_nordic_capture_regions_own_settlement_1	Наші вожді вимагають крові! Ворог завдав нам серйозної рани, тож ми повинні дати йому урок. Нехай більше не сміє оскверняти наші землі.	true
missions_localised_description_att_religious_catholic_construct_bch_religion_catholic_legendary_1	Його святість просить тебе побудувати монумент, що прославляє Господа, щоб благочестиві могли молитися.	true
missions_localised_description_att_religious_orthodox_construct_bch_religion_orthodox_legendary_1	Патріарх просить нас побудувати церкву, щоб про нашу віру дізналося більше людей.	true
missions_localised_title_att_senate_eastern_roman_blockade_port_1	Блокада	true
missions_localised_title_pro_destroy_rebels_thessalonica	Перемогти заколотників у Фессалоніках	true
missions_localised_description_att_senate_nordic_assassinate_character_general_1	Ця людина заслужила опинитися в крижаних обіймах смерті. Ми повинні подбати про це.	true
missions_localised_title_att_senate_eastern_roman_make_trade_agreement_1	Справи торговельні	true
missions_localised_title_att_senate_western_roman_make_trade_agreement_1	Справи торговельні	true
missions_localised_description_att_vc_1_christian	Перемога християн	true
missions_localised_description_att_vc_2_christian	Релігійна перемога християн	true
missions_localised_description_att_senate_nordic_construct_building_military_1	Побудуємо поліпшені тренувальні майданчики й арсенали, щоб кожен громадянин володів списом і пращею.	true
missions_localised_title_att_senate_nomadic_weak_leader_1	Слабкий лідер	true
missions_localised_title_att_senate_nomadic_weak_leader_2	Слабкий лідер	true
missions_localised_title_att_senate_nomadic_weak_leader_3	Слабкий лідер	true
missions_localised_title_att_senate_nomadic_weak_leader_4	Слабкий лідер	true
missions_localised_title_att_senate_nomadic_weak_leader_5	Слабкий лідер	true
missions_localised_title_att_senate_nomadic_weak_leader_6	Слабкий лідер	true
missions_localised_title_att_senate_nomadic_weak_leader_7	Слабкий лідер	true
missions_localised_title_att_senate_eastern_construct_bch_eastern_sassanid_water_major_1	Міське будівництво	true
missions_localised_description_mk_religious_jewish_declare_war_1	Обраний народ не може не діяти, поки його вороги оточують його кордони. Війна має вестися на наших власних умовах.	true
missions_localised_title_cha_objective_cha_avars_primary_1_seal_2	Розколотий світ	true
missions_localised_title_cha_objective_cha_avars_primary_2_seal_3	Королівське ім'я	true
missions_localised_title_cha_objective_cha_avars_primary_5_seal_6	Відродження Європи	true
missions_localised_title_cha_objective_cha_avars_primary_3_seal_4	Прибій війни	true
missions_localised_title_cha_objective_cha_avars_primary_4_seal_5	Створена спадщина	true
