key	text	tooltip
#Loc;1;text/db/mkscript_message_event_text.loc		
message_event_text_text_mk_event_14th_century_primary	XIV століття	true
message_event_text_text_mk_event_14th_century_secondary	Кінець XIII століття ознаменувався закінченням своєрідної золотої епохи в Європі, оскільки XIV століття принесло тільки смерть і відчай. Катастрофічна зміна клімату, спустошливі епідемії та масові повстання ознаменували собою це століття.	true
message_event_text_text_mk_event_14th_century_title	На рубежі століть	true
message_event_text_text_mk_event_15th_century_primary	XV століття	true
message_event_text_text_mk_event_15th_century_secondary	У міру того як 1300-ті роки переходили в 1400-ті, світ побачив безліч змін. Використання пороху ставало все більш поширеним явищем, і все більше і більше артилерійських знарядь почали брати участь на полі бою.	true
message_event_text_text_mk_event_15th_century_title	На рубежі століть	true
message_event_text_text_mk_event_albigensian_crusade_title	Альбігойський хрестовий похід	true
message_event_text_text_mk_event_annexation_aborted_secondary	Анексія цієї васальної держави була перервана, тому що вона більше не є вашим васалом або вона була знищена.	true
message_event_text_text_mk_event_annexation_aborted_secondary_manual	Анексія цієї васальної держави була перервана вручну.	true
message_event_text_text_mk_event_annexation_aborted_title	Анексія перервана!	true
message_event_text_text_mk_event_annexed_vassal_secondary	Ця васальна держава була анексована дипломатичним шляхом і тепер повністю включена до складу вашої фракції.	true
message_event_text_text_mk_event_annexed_vassal_title	Анексований васал	true
message_event_text_text_mk_event_armenian_kingdom_formed_primary	Вірменське царство	true
message_event_text_text_mk_event_armenian_kingdom_formed_secondary	Вірменське царство, яке довгий час вважалося завойованим сельджуками, тепер відроджується з попелу. Мало хто міг передбачити, що Кілікійське царство відвоює свої споконвічні землі, але тепер Вірменія тріумфує, готова помститися всім своїм недоброзичливцям.	true
message_event_text_text_mk_event_armenian_kingdom_formed_title	Заснування царства	true
message_event_text_text_mk_event_black_death_primary	Спалах чуми	true
message_event_text_text_mk_event_black_death_secondary	З чуток з далеких країв доходять страшні звістки про жахливе море на сході, яке залишає за собою слід з почорнілих гнилих трупів. З цих розповідей зрозуміло одне: вона поширюється стрімко і вбиває без жалю. Найкращим варіантом було б підготуватися, бо насувається Чорна смерть.	true
message_event_text_text_mk_event_black_death_title	Чорна смерть	true
message_event_text_text_mk_event_byz_africa_reconquered_primary	Африка	true
message_event_text_text_mk_event_byz_africa_reconquered_secondary	Північна Африка, втрачена протягом більш ніж півтисячі років, нарешті була знову завойована Римською імперією. Повернення житниці Риму увійде в історію! Це славний день!	true
message_event_text_text_mk_event_byz_anatolia_reconquered_primary	Анатолія	true
message_event_text_text_mk_event_byz_anatolia_reconquered_secondary	Анатолія, що була полем битви між візантійцями і тюрками протягом останніх кількох століть, нарешті була повністю завойована імперією. Новоспечені грекомовні піддані тюрків тепер радіють, оскільки вони знову перебувають під владою Римської імперії.	true
message_event_text_text_mk_event_byz_antioch_reconquered_primary	Божий град Антіохія	true
message_event_text_text_mk_event_byz_antioch_reconquered_secondary	Велике місто Антіохія було знову завойоване своїми законними власниками - римлянами. Сподіваємося, що цього разу назавжди.	true
message_event_text_text_mk_event_byz_dalmatia_reconquered_primary	Далмація	true
message_event_text_text_mk_event_byz_dalmatia_reconquered_secondary	Фема Далмація, завойована Хорватією та Угорщиною понад сто років тому, нарешті була повернута імперії. Незважаючи на своє ненадійне розташування, Далмація, тим не менш, є цінним регіоном завдяки своїм прибережним містам і торговому потенціалу.	true
message_event_text_text_mk_event_byz_egypt_reconquered_primary	Єгипет	true
message_event_text_text_mk_event_byz_egypt_reconquered_secondary	Житниця Константинополя знову під візантійським контролем вперше з моменту його втрати в ході перших мусульманських завоювань. Єгипет знову стане важливим наріжним каменем подальшого процвітання славної Римської держави.	true
message_event_text_text_mk_event_byz_empire_restored_primary	Візантійська імперія	true
message_event_text_text_mk_event_byz_empire_restored_secondary_mk_fact_epirus	Більше немає ніякого Епірського царства, оскільки справжні римляни знову правлять в Константинополі. Справжня Римська імперія була відновлена, хоча претенденти на Заході і відмовилися б назвати її такою. Багато хто в межах імперії сподівається, що вона незабаром повернеться до своєї колишньої слави епохи до Франкократії. Незважаючи на своє хитке становище, Візантія повинна знову стати великою державою, як тільки тюрки в Анатолії та її суперники на Заході будуть переможені.	true
message_event_text_text_mk_event_byz_empire_restored_secondary_mk_fact_nicaea	Більше немає ніякої Нікейської імперії, оскільки справжні римляни знову правлять в Константинополі. Справжня Римська імперія була відновлена, хоча претенденти на Заході і відмовилися б назвати її такою. Багато хто в межах кордонів імперії сподівається, що вона незабаром повернеться до своєї колишньої слави епохи до Франкократії. Незважаючи на своє хитке становище, Візантія повинна знову стати великою державою, як тільки тюрки в Анатолії і її суперники на Заході будуть переможені.	true
message_event_text_text_mk_event_byz_empire_restored_secondary_mk_fact_trebizond	Більше немає ніякої Трапезундської імперії, оскільки справжні римляни знову правлять в Константинополі. Справжня Римська імперія була відновлена, хоча претенденти на Заході і відмовилися б назвати її такою. Багато хто в межах кордонів імперії сподіваються, що вона незабаром повернеться до своєї колишньої слави епохи до Франкократії. Незважаючи на своє хитке становище, Візантія повинна знову стати великою державою, як тільки тюрки в Анатолії та її суперники на Заході будуть переможені.	true
message_event_text_text_mk_event_byz_empire_restored_title	Відновлення імперії	true
message_event_text_text_mk_event_byz_greece_reconquered_primary	Греція	true
message_event_text_text_mk_event_byz_greece_reconquered_secondary	Латиняни нарешті були витіснені з Греції, і Візантійська імперія знову стала сильною. Цей день надовго запам'ятають в історії!	true
message_event_text_text_mk_event_byz_imperial_reconquest_title	Відвоювання імперії	true
message_event_text_text_mk_event_byz_italy_reconquered_primary	Італія	true
message_event_text_text_mk_event_byz_italy_reconquered_secondary	Мало хто міг уявити, що цей день колись настане. Після стількох років Італія нарешті була повернена назад. Рим знову знаходиться в руках справжніх римлян, і з часів великого Юстиніана римське панування в Італії жодного разу не було таким міцним. Не так давно Константинополь був захоплений латинянами. Тепер же духовна батьківщина латинян взята римлянами, і ніхто не зможе засумніватися в тому, чия імперія є по-справжньому римською.	true
message_event_text_text_mk_event_byz_oriens_reconquered_primary	Схід	true
message_event_text_text_mk_event_byz_oriens_reconquered_secondary	Палестина і Сирія тепер знаходяться під візантійським пануванням, і разом з встановленням контролю над святими землями зростає і повага до імперії.	true
message_event_text_text_mk_event_byz_pentarchy_primary	Відновлення Пентархії	true
message_event_text_text_mk_event_byz_pentarchy_secondary	Пентархія відновлена, оскільки Александрія, Антіохія, Константинополь, Єрусалим і Рим тепер знаходяться під владою римлян. Контроль над цими регіонами зміцнив авторитет православної церкви перед католицизмом. Мало хто тепер засумнівається в тому, що православна церква - єдина, істинна і первісна гілка християнства.	true
message_event_text_text_mk_event_byz_roman_empire_restored_primary	Римська імперія	true
message_event_text_text_mk_event_byz_roman_empire_restored_secondary	Тепер вже ніхто не зможе засумніватися в законності претензій Візантійської імперії на спадщину Риму. Як передова світова держава і володар території, небаченої в руках римлян з часів правління Юстиніана, Візантія тепер знаходиться в незаперечному становищі, щоб проголосити себе справжньою Римською імперією.	true
message_event_text_text_mk_event_college_of_cardinals_cardinal_added_secondary	Цей персонаж був визнаний Папою як людина виняткової віри і, таким чином, був призначений до Колегії кардиналів.	true
message_event_text_text_mk_event_college_of_cardinals_cardinal_added_title	Кардинал призначений	true
message_event_text_text_mk_event_crusade_5_title	П'ятий хрестовий похід	true
message_event_text_text_mk_event_crusade_6_title	Шостий хрестовий похід	true
message_event_text_text_mk_event_crusade_7_title	Сьомий хрестовий похід	true
message_event_text_text_mk_event_crusade_8_title	Восьмий хрестовий похід	true
message_event_text_text_mk_event_crusade_9_title	Дев'ятий хрестовий похід	true
message_event_text_text_mk_event_crusade_aborted_primary	Хрестовий похід скасовано!	true
message_event_text_text_mk_event_crusade_aborted_secondary	Для хрестового походу більше немає мети, і тому Папа Римський скасував його.	true
message_event_text_text_mk_event_crusade_abstain_primary	Відмова від участі в хрестовому поході!	true
message_event_text_text_mk_event_crusade_abstain_secondary	Ви вирішили не брати участь у цьому хрестовому поході, а це означає, що ваше королівство може і не буде виснажене у виснажливій і, можливо, безглуздій війні, але й те, що ви також не отримаєте жодних вигод, якщо хрестовий похід увінчається успіхом.	true
message_event_text_text_mk_event_crusade_go_aegyptus_alexandria_primary	Хрестовий похід на Александрію!	true
message_event_text_text_mk_event_crusade_go_aegyptus_alexandria_secondary	Папа Римський офіційно оголосив про початок священної війни проти іновірців в Александрії. Армії християнського світу скоро обрушаться на землі її власника, несучи за собою спустошення.	true
message_event_text_text_mk_event_crusade_go_aegyptus_oxyrhynchus_primary	Хрестовий похід на Каїр!	true
message_event_text_text_mk_event_crusade_go_aegyptus_oxyrhynchus_secondary	Папа Римський офіційно оголосив про початок священної війни проти іновірців в Каїрі. Армії християнського світу скоро обрушаться на землі його власника, несучи за собою спустошення.	true
message_event_text_text_mk_event_crusade_go_africa_carthago_primary	Хрестовий похід на Туніс!	true
message_event_text_text_mk_event_crusade_go_africa_carthago_secondary	Папа Римський офіційно оголосив про початок священної війни проти іновірців в Тунісі. Армії християнського світу скоро обрушаться на землі його власника, несучи за собою спустошення.	true
message_event_text_text_mk_event_crusade_go_aquitania_elusa_primary	Хрестовий похід на Тулузу!	true
message_event_text_text_mk_event_crusade_go_aquitania_elusa_secondary	Папа Римський офіційно оголосив про початок священної війни проти іновірців в Тулузі. Армії християнського світу скоро обрушаться на землі її власника, несучи за собою спустошення.	true
message_event_text_text_mk_event_crusade_go_baetica_corduba_primary	Хрестовий похід на Кордову!	true
message_event_text_text_mk_event_crusade_go_baetica_corduba_secondary	Папа Римський офіційно оголосив про початок священної війни проти іновірців в Кордові. Армії християнського світу скоро обрушаться на землі її власника, несучи за собою спустошення.	true
message_event_text_text_mk_event_crusade_go_britannia_superior_londinium_primary	Хрестовий похід на Лондон!	true
message_event_text_text_mk_event_crusade_go_britannia_superior_londinium_secondary	Папа Римський офіційно оголосив про початок священної війни проти іновірців в Лондоні. Армії християнського світу скоро обрушаться на землі його власника, несучи за собою спустошення.	true
message_event_text_text_mk_event_crusade_go_carthaginensis_toletum_primary	Хрестовий похід на Толедо!	true
message_event_text_text_mk_event_crusade_go_carthaginensis_toletum_secondary	Папа Римський офіційно оголосив про початок священної війни проти іновірців у Толедо. Армії християнського світу незабаром обрушаться на землі його власника, несучи за собою спустошення.	true
message_event_text_text_mk_event_crusade_go_crusade_5_primary	Хрестовий похід на Каїр!	true
message_event_text_text_mk_event_crusade_go_crusade_5_secondary	Папа Римський офіційно оголосив про початок священної війни проти мусульман Єгипту, прагнучи відновити християнське правління на землях, давно завойованих сарацинами. Якщо Каїр буде взятий, то незабаром впаде решта Єгипту, який потім може бути використаний як плацдарм для вторгнення і відвоювання Єрусалиму!	true
message_event_text_text_mk_event_crusade_go_germania_uburzis_primary	Хрестовий похід на Франкфурт!	true
message_event_text_text_mk_event_crusade_go_germania_uburzis_secondary	Папа Римський офіційно оголосив про початок священної війни проти іновірців у Франкфурті. Армії християнського світу скоро обрушаться на землі його власника, несучи за собою спустошення.	true
message_event_text_text_mk_event_crusade_go_italia_roma_primary	Хрестовий похід на Рим!	true
message_event_text_text_mk_event_crusade_go_italia_roma_secondary	Папа Римський офіційно оголосив про початок священної війни проти іновірців у Римі. Армії християнського світу скоро обрушаться на землі його власника, несучи за собою спустошення.	true
message_event_text_text_mk_event_crusade_go_lugdunensis_turonum_primary	Хрестовий похід на Париж!	true
message_event_text_text_mk_event_crusade_go_lugdunensis_turonum_secondary	Папа Римський офіційно оголосив про початок священної війни проти іновірців у Парижі. Армії християнського світу скоро обрушаться на землі його власника, несучи за собою спустошення.	true
message_event_text_text_mk_event_crusade_go_macedonia_thessalonica_primary	Хрестовий похід на Фессалоніки!	true
message_event_text_text_mk_event_crusade_go_macedonia_thessalonica_secondary	Папа Римський офіційно оголосив про початок священної війни проти іновірців у Фессалоніках. Армії християнського світу скоро обрушаться на землі їхнього власника, несучи за собою спустошення.	true
message_event_text_text_mk_event_crusade_go_palaestinea_aelia_capitolina_primary	Хрестовий похід на Єрусалим!	true
message_event_text_text_mk_event_crusade_go_palaestinea_aelia_capitolina_secondary	Папа Римський офіційно оголосив про початок священної війни проти іновірців в Єрусалимі. Армії християнського світу скоро обрушаться на землі його власника, несучи за собою спустошення.	true
message_event_text_text_mk_event_crusade_go_syria_antiochia_primary	Хрестовий похід на Антіохію!	true
message_event_text_text_mk_event_crusade_go_syria_antiochia_secondary	Папа Римський офіційно оголосив про початок священної війни проти іновірців в Антиохії. Армії християнського світу скоро обрушаться на землі її власника, несучи за собою спустошення.	true
message_event_text_text_mk_event_crusade_go_tarraconensis_tarraco_primary	Хрестовий похід на Барселону!	true
message_event_text_text_mk_event_crusade_go_tarraconensis_tarraco_secondary	Папа Римський офіційно оголосив про початок священної війни проти іновірців в Барселоні. Армії християнського світу скоро обрушаться на землі її власника, несучи за собою спустошення.	true
message_event_text_text_mk_event_crusade_go_thracia_constantinopolis_primary	Хрестовий похід на Константинополь!	true
message_event_text_text_mk_event_crusade_go_thracia_constantinopolis_secondary	Папа Римський офіційно оголосив про початок священної війни проти іновірців у Константинополі. Армії християнського світу скоро обрушаться на землі його власника, несучи за собою спустошення.	true
message_event_text_text_mk_event_crusade_joined_primary	Приєднання до хрестового походу!	true
message_event_text_text_mk_event_crusade_joined_secondary	Ваша фракція приєдналася до хрестового походу і тепер буде воювати з фракцією, яка утримує мету походу, до тих пір, поки мета не буде взята або вторгнення не буде відбито.	true
message_event_text_text_mk_event_crusade_lost_primary	Поразка хрестоносців!	true
message_event_text_text_mk_event_crusade_lost_secondary	Хрестовий похід припинився через повсюдні поразки і застій. Мета його залишається в руках іновірців, і будь-яка надія коли-небудь знову відвоювати її для християнського світу може бути назавжди втрачена.	true
message_event_text_text_mk_event_crusade_preliminary_5_primary	Четвертий Латеранський собор	true
message_event_text_text_mk_event_crusade_preliminary_5_secondary	Папа Римський Інокентій III проголосив новий хрестовий похід за звільнення Святої землі від сарацинів на Четвертому Латеранському соборі, що відбувся цього року. Незабаром до участі в хрестовому поході будуть запрошені різні католицькі державці, хоча безпосередня його мета точно не відома.	true
message_event_text_text_mk_event_crusade_won_jerusalem_secondary	Незважаючи ні на що, хрестоносці змогли відібрати намічену мету у іновірців. Оскільки і вона, і Єрусалим тепер знаходяться в руках християн, ісламу завдано важкого удару і невідомо, чи останнього.	true
message_event_text_text_mk_event_crusade_won_jerusalem_taken_secondary	Незважаючи ні на що, хрестоносці змогли відібрати намічену мету у іновірців. Хоча місто Єрусалим і не було головною метою хрестового походу, армії хрестоносців змогли взяти його. Цей хрестовий похід надовго залишиться в пам'яті християн.	true
message_event_text_text_mk_event_crusade_won_jerusalem_target_secondary	Хрестоносцями була взята найсвятіша з усіх нагород: місто Єрусалим. Церковні дзвони дзвонять по всіх католицьких землях на честь цієї знаменної перемоги.	true
message_event_text_text_mk_event_crusade_won_primary	Перемога хрестоносців!	true
message_event_text_text_mk_event_crusade_won_secondary	Незважаючи ні на що, хрестоносці змогли здобути перемогу, відібравши у іновірців намічену мету. Після того, як їхні нові володіння будуть консолідовані, хрестоносці будуть готові вторгнутися в Святу землю, можливо остаточно забравши її назад раз і назавжди.	true
message_event_text_text_mk_event_cumans_rejected_primary	Кордони перекриті	true
message_event_text_text_mk_event_cumans_rejected_secondary	Ви вирішили, що кордони повинні залишитися закритими, затиснувши тим самим половецьких біженців між вами і монгольськими ордами. В результаті вони можуть спробувати прорватися на ваші землі силою, і всі переваги, отримані від добровільного дозволу їм розселитися, будуть втрачені. Однак монголи залишилися задоволені вашим рішенням і тепер навряд чи зважаться на вторгнення.	true
message_event_text_text_mk_event_cumans_settled_primary	Розселення половців	true
message_event_text_text_mk_event_cumans_settled_secondary	Ви вирішили відкрити кордони свого королівства для половецьких біженців, дозволивши їм оселитися на ваших землях в обмін на їх військову службу. Вони можуть забезпечити вас корисними допоміжними загонами завдяки своїй майстерності верхової їзди.	true
message_event_text_text_mk_event_cumans_situation_title	Доля половців	true
message_event_text_text_mk_event_eng_civil_war_primary	Перша баронська війна	true
message_event_text_text_mk_event_eng_civil_war_secondary	Ваші незадоволені васали розпалили відкрите повстання з метою нав'язати свої вимоги короні. Захопивши Лондон, вони тепер погрожують силою захопити всю решту Англії! На довершення всього деякі бунтівні барони оголосили, що король Франції Людовик претендує на англійський престол, тим самим запрошуючи Францію допомогти їм у їхньому заколоті.	true
message_event_text_text_mk_event_eng_civil_war_title	Громадянська війна!	true
message_event_text_text_mk_event_eng_magna_carta_peace_secondary	Показавши себе боягузом, король Англії тепер повинен зустрітися віч-на-віч зі своїми честолюбними дворянами. Вони підготували документ, який обмежить владу англійської корони. Підписати його було б найбільшим приниженням. Відмова підписати його, безсумнівно, призведе до громадянської війни.	true
message_event_text_text_mk_event_eng_magna_carta_primary	Велика хартія вольностей	true
message_event_text_text_mk_event_eng_magna_carta_title	Доля Анжуйської династії	true
message_event_text_text_mk_event_eng_magna_carta_war_secondary	Показавши себе нездатним воєначальником, король Англії тепер повинен зустрітися віч-на-віч зі своїми честолюбними дворянами. Вони підготували документ, який обмежить владу англійської корони. Підписати його було б найбільшим приниженням. Відмова підписати його, безсумнівно, призведе до громадянської війни.	true
message_event_text_text_mk_event_faction_rank_secondary_2	Ваша фракція досягла рангу «королівства», що вказує на її статус регіональної держави.	true
message_event_text_text_mk_event_faction_rank_secondary_3	Ваша фракція досягла рангу «імперії», що вказує на її статус великої держави.	true
message_event_text_text_mk_event_faction_rank_title_2	Заснування королівства	true
message_event_text_text_mk_event_faction_rank_title_3	Заснування імперії	true
message_event_text_text_mk_event_fra_aragon_intervenes_bad_primary	Вторгнення арагонців!	true
message_event_text_text_mk_event_fra_aragon_intervenes_bad_secondary	Арагонська корона пов'язала свою долю з графством Тулуза, її король оголосив про свій намір протистояти впливу Франції в Лангедоці. Якщо катараську єресь слід приборкати, то те саме слід зробити і з королем Арагону.	true
message_event_text_text_mk_event_fra_aragon_intervenes_primary	Арагон приєднується до Альбігойського хрестового походу!	true
message_event_text_text_mk_event_fra_aragon_intervenes_secondary	Арагонська корона приєдналася до нас у нашому хрестовому поході проти катарів. Такий могутній союзник, безсумнівно, стане останнім цвяхом у труну графства Тулуза.	true
message_event_text_text_mk_event_fra_aragon_support_bad_primary	Зрада Арагона	true
message_event_text_text_mk_event_fra_aragon_support_bad_secondary	Арагонська корона, занадто боягузлива для прямої участі в Альбігойському хрестовому поході на чиємусь боці, вирішила підтримати графство Тулуза фінансово, набираючи величезну армію під тулузьким командуванням.	true
message_event_text_text_mk_event_fra_cathar_revolt_primary	Повстання катарів!	true
message_event_text_text_mk_event_fra_cathar_revolt_secondary	Прийшла звістка, що в недавно завойованому графстві Тулуза спалахнуло велике повстання, і окситанські війська збираються майже в усіх містах регіону. Вони прагнуть обернути нинішнє становище Альбігойського хрестового походу на свою користь і тому повинні бути негайно придушені, поки не досягли успіху.	true
message_event_text_text_mk_event_fra_cathars_crushed_primary	Катари розгромлені!	true
message_event_text_text_mk_event_fra_cathars_crushed_secondary	Альбігойський хрестовий похід закінчився, і єретики, що населяли Тулузу, були розгромлені найрішучішим чином. Графство було включено до складу Королівства Франція. Однак очікується, що в регіоні буде неспокійно протягом багатьох наступних років, поки решта єретиків не буде виявлена інквізицією і знищена.	true
message_event_text_text_mk_event_fra_english_invasion_primary	Вторгнення в Нормандію!	true
message_event_text_text_mk_event_fra_english_invasion_secondary	Ненависний король Англії Іоанн почав підготовку до вторгнення в Нормандію! До англійців приєднуються графство Фландрія і Священна Римська імперія. Настав час організувати оборону і відкинути цих англійських псів назад у море!	true
message_event_text_text_mk_event_fra_english_invasion_title	Вторгнення англійців	true
message_event_text_text_mk_event_fra_english_invasion_victory_primary	Перемога!	true
message_event_text_text_mk_event_fra_english_invasion_victory_secondary	Англійська знать, преситившись некомпетентністю свого короля, підняла проти нього повстання! Наші землі тепер у безпеці, і ми отримали значну контрибуцію від англійського короля при укладенні миру.	true
message_event_text_text_mk_event_golden_bull_1222_refused_primary	Золота булла відхилена!	true
message_event_text_text_mk_event_golden_bull_1222_refused_secondary	Ви відмовилися прийняти Золоту буллу. Це дуже розлютить дворянство. Можливо, незабаром може спалахнути громадянська війна.	true
message_event_text_text_mk_event_golden_bull_1222_signed_primary	Золота булла прийнята!	true
message_event_text_text_mk_event_golden_bull_1222_signed_secondary	Ви неохоче прийняли Золоту буллу, що неабияк вдарило по вашій владі і стані вашого королівства, але хоча б вгамувало жагу влади ваших дворян на деякий час...	true
message_event_text_text_mk_event_golden_bull_1222_title	Золота булла 1222 року	true
message_event_text_text_mk_event_golden_horde_formed_primary	Золота Орда	true
message_event_text_text_mk_event_golden_horde_formed_secondary	Племена великого трав'яного моря були підкорені і тепер підкоряються нам. Багато хто з наших ворогів називають нас Золотою Ордою, і відтепер наші володіння будуть носити цю назву.	true
message_event_text_text_mk_event_golden_horde_formed_title	Заснування Золотої Орди	true
message_event_text_text_mk_event_great_famine_primary	Великий голод	true
message_event_text_text_mk_event_great_famine_secondary	Протягом довгого часу, довше, ніж будь-коли раніше, безперервні дощі мучили більшу частину Європи. Гостра нестача зерна і солі різко підвищила ціни на продовольство, і багато селян почали голодувати. Залишається тільки сподіватися, що це лихо скоро закінчиться.	true
message_event_text_text_mk_event_great_famine_title	Зміна клімату	true
message_event_text_text_mk_event_greek_fire_lost_primary	Грецький вогонь загублений!	true
message_event_text_text_mk_event_greek_fire_lost_secondary	Ви відмовилися оплачувати поповнення запасів «грецького вогню» і всі вони були вичерпані, позбавивши в результаті ваші армії зброї. Ви більше не зможете набирати загони з «грецьким вогнем», а всі нинішні загони втратили припаси, необхідні для використання їхніх знарядь.	true
message_event_text_text_mk_event_greek_fire_saved_primary	Грецький вогонь збережено!	true
message_event_text_text_mk_event_greek_fire_saved_secondary	Своїми діями ви забезпечили подальше виробництво «грецького вогню», але через дорожнечу і складні обставини, пов'язані зі збором його складових, одного дня може настати день, коли його поповнення знову опиниться під загрозою.	true
message_event_text_text_mk_event_greek_fire_title	Грецький вогонь	true
message_event_text_text_mk_event_hre_decree_primary_hre_decree_encourage_development	Стимулювання будівництва	true
message_event_text_text_mk_event_hre_decree_primary_hre_decree_expand_bureaucracy	Розширення чиновницького апарату	true
message_event_text_text_mk_event_hre_decree_primary_hre_decree_imperial_levies	Призов імперських новобранців	true
message_event_text_text_mk_event_hre_decree_primary_hre_decree_lessen_tax_burdens	Зниження податкового тягаря	true
message_event_text_text_mk_event_hre_decree_primary_hre_decree_patronize_universities	Покровительство університетам	true
message_event_text_text_mk_event_hre_decree_primary_hre_decree_promote_commerce	Розвиток торгівлі	true
message_event_text_text_mk_event_hre_decree_secondary	Імператор видав указ, який тепер буде діяти протягом 15 ходів або ж до обрання нового імператора.	true
message_event_text_text_mk_event_hre_decree_title	Імператорський указ	true
message_event_text_text_mk_event_hre_destroyed_primary	Падіння Священної Римської імперії	true
message_event_text_text_mk_event_hre_destroyed_secondary	Священна Римська імперія, яка довгий час панувала в Європі і була оплотом католицької віри, в кінці кінців була скасована, а всі її держави-члени знищені або поневолені.	true
message_event_text_text_mk_event_hre_destroyed_title	Священна Римська імперія знищена	true
message_event_text_text_mk_event_hre_english_invasion_primary	Війна на заході	true
message_event_text_text_mk_event_hre_english_invasion_secondary	Наш союзник, Королівство Англія, здійснило вторгнення в Нормандію, щоб повернути землі, завойовані французькою короною десятиліттям раніше. Як учасник союзу, заснованого Папою Римським, ми зобов'язані надати англійцям допомогу в цій справі, хоча претендент на трон нашої держави з півдня може ускладнити це підприємство.	true
message_event_text_text_mk_event_hre_english_invasion_title	Англія вторглася в Нормандію	true
message_event_text_text_mk_event_hre_excommunication_primary	Відлучення Оттона IV	true
message_event_text_text_mk_event_hre_excommunication_secondary	Образивши Папу Римського особисто і зайнявши папські землі, імператор Священної Римської імперії Оттон IV був відлучений від церкви в 1210 році.	true
message_event_text_text_mk_event_hre_excommunication_title	Відлучення!	true
message_event_text_text_mk_event_hre_fealty_decrease_secondary_decay	Лояльність цієї фракції до імператора знизилася з плином часу, можливо, через те, що її ігнорували або з інших причин.	true
message_event_text_text_mk_event_hre_fealty_decrease_secondary_withdrew_support	Лояльність цієї фракції до імператора знизилася через вашу відмову підтримати їхнього кандидата.	true
message_event_text_text_mk_event_hre_fealty_decrease_title	Лояльність знижена	true
message_event_text_text_mk_event_hre_fealty_increase_secondary_boosted	Лояльність цієї фракції до імператора підвищилася завдяки милості, наданій імператором.	true
message_event_text_text_mk_event_hre_fealty_increase_secondary_supported_candidate	Лояльність цієї фракції до імператора підвищилася в результаті підтримки їхнього кандидата на виборах.	true
message_event_text_text_mk_event_hre_fealty_increase_title	Лояльність підвищена	true
message_event_text_text_mk_event_hre_imperial_succession_secondary	Новий імператор Священної Римської імперії, що походить з іншої фракції, зайняв трон після смерті попереднього правителя, тим самим позбавивши влади його фракцію.	true
message_event_text_text_mk_event_hre_imperial_succession_title	Імперська спадкоємність	true
message_event_text_text_mk_event_hre_imperial_title_retained_secondary	Новий імператор Священної Римської імперії зайняв трон після смерті попереднього правителя, хоча вони належать до однієї фракції. Влада правлячої фракції поки що в безпеці...	true
message_event_text_text_mk_event_hre_imperial_title_retained_title	Імперська спадкоємність	true
message_event_text_text_mk_event_hre_pretender_nominated_secondary	Папа Римський висунув претендента на імператорський престол, тим самим оскаржуючи право нинішнього імператора правити Священною Римською імперією.	true
message_event_text_text_mk_event_hre_pretender_nominated_title	Претендент на трон	true
message_event_text_text_mk_event_hre_reform_primary_1	Заснування постійних курфюрстів	true
message_event_text_text_mk_event_hre_reform_primary_2	Оформлення Рейхстагу	true
message_event_text_text_mk_event_hre_reform_primary_3	Введення загального пфенніга	true
message_event_text_text_mk_event_hre_reform_primary_4	Організація імперських округів	true
message_event_text_text_mk_event_hre_reform_primary_5	Встановлення Вічного земського миру	true
message_event_text_text_mk_event_hre_reform_primary_6	Створення Імперського камерального суду	true
message_event_text_text_mk_event_hre_reform_primary_7	Створення Імперського управління	true
message_event_text_text_mk_event_hre_reform_primary_8	Затвердження престолонаслідування	true
message_event_text_text_mk_event_hre_reform_primary_9	Renovatio Imperii	true
message_event_text_text_mk_event_hre_reform_secondary	Імператор забезпечив собі достатню підтримку, щоб провести імперську реформу, тим самим посиливши централізацію держави.	true
message_event_text_text_mk_event_hre_reform_title	Імперська реформа	true
message_event_text_text_mk_event_hre_region_lost_secondary_emperor	Регіон, що по праву належав Священній Римській імперії, був втрачений, тим самим послабивши вашу владу.	true
message_event_text_text_mk_event_hre_region_lost_secondary_member	Регіон, що по праву належав Священній Римській імперії, був втрачений, тим самим послабивши владу імператора.	true
message_event_text_text_mk_event_hre_region_lost_title	Імперська територія втрачена	true
message_event_text_text_mk_event_hre_region_reconquered_secondary_emperor	Регіон, що по праву належить Священній Римській імперії, був відвойований назад, зміцнивши тим самим вашу владу.	true
message_event_text_text_mk_event_hre_region_reconquered_secondary_member	Регіон, що по праву належить Священній Римській імперії, був відвойований назад, зміцнивши тим самим владу імператора.	true
message_event_text_text_mk_event_hre_region_reconquered_title	Імперська територія відвойована	true
message_event_text_text_mk_event_hre_sicilian_invasion_primary	Претендент на трон	true
message_event_text_text_mk_event_hre_sicilian_invasion_secondary	Простий юнак, хоча і підтриманий Папою Римським, тепер вступає в боротьбу за імператорський трон після того, як його обрали своїм представником незадоволені партії імперії.	true
message_event_text_text_mk_event_hre_sicilian_invasion_title	Гнів Інокентія	true
message_event_text_text_mk_event_hre_unlawful_territory_secondary	Ваша окупація цього регіону була оголошена імператором Священної Римської імперії незаконною. Як наслідок цього, багато ваших підданих в регіоні незадоволені.	true
message_event_text_text_mk_event_hre_unlawful_territory_title	Незаконна територія	false
message_event_text_text_mk_event_ilkhanate_formed_primary	Ільханат	true
message_event_text_text_mk_event_ilkhanate_formed_secondary	Землі цих стародавніх цивілізацій тепер належать нам. Підкоривши собі могутні царства і держави Персії, тепер настав час скористатися їх великою мудрістю і державним апаратом. Природно, це стосується і їх назви нашої імперії, якою ми відтепер будемо користуватися - Ільханат.	true
message_event_text_text_mk_event_ilkhanate_formed_title	Заснування Ільханату	true
message_event_text_text_mk_event_Italian_kingdom_formed_primary	Італійське королівство	true
message_event_text_text_mk_event_Italian_kingdom_formed_secondary	Минуло вже багато століть з тих пір, як востаннє Італія була єдиною, але тепер набирає силу Італійське королівство, підкоривши собі Апеннінський півострів.	true
message_event_text_text_mk_event_Italian_kingdom_formed_title	Заснування королівства	true
message_event_text_text_mk_event_little_ice_age_primary	Малий льодовиковий період	true
message_event_text_text_mk_event_little_ice_age_secondary	Безперервні зливи нарешті припинилися, але багато хто помітив, що зими стали дещо суворішими, а посівні сезони - менш стійкими.	true
message_event_text_text_mk_event_little_ice_age_title	Зміна клімату	true
message_event_text_text_mk_event_mk1212_intro_primary	Творці модифікації	true
message_event_text_text_mk_event_mk1212_intro_secondary	Учасники:\\n\\nWarman222 - Головний розробник/Дизайн загонів\\nYou_Guess_Who - Бази даних/Дизайн кораблів/Дизайн загонів\\nLtd. - Дизайн загонів/Розробка моделей/Такелаж\\nFinix - 2D-художник\\nJan_Boruta - 2D-художник/Історичні дослідження\\nSlytacular - Дизайн загонів/Дизайн поселень/Розробка моделей\\ndontfearme22 - Дизайн загонів/Розробка моделей\\nzsimmortal - Опрацювання кампанії/Дизайн загонів/Розробка моделей\\nHessam - Дизайн загонів/Розробка моделей\\nLucem Mundum - Дизайн загонів\\nThe Fawn Rescuer - Дизайн загонів\\nAzrien Fox - Дизайн загонів\\nbanskie100 - Дизайн загонів/Розробка моделей\\nBaron279 - Дизайн загонів\\nAlexios - Дизайн загонів\\nThe_Culverin - Дизайн загонів\\nGearhawk - Дизайн поселень\\nFuzFuzFuz - Опрацювання кампанії/Дизайн загонів/Допоміжний 2D-художник\\nDETrooper - Написання скриптів/Опрацювання кампанії/Музичне оформлення модифікації\\nFjodor - Дизайн загонів\\nGhost - Дизайн загонів/Дизайн кораблів/Дизайн будівель\\nKalpok - Дизайн загонів\\nKublaioi - Завантажувальні екрани\\nPapy11 - Дизайн загонів/Розробка моделей\\n\\nСтороння підтримка:\\n\\nPino69\\nLucas the Benevolent\\nMr. Crow\\nNarf\\nDejawolf\\nPacco\\nAl Mansur\\nRus 13th Century\\nPaleogios\\nThick1988\\nRusichi Total War\\nMarka\\nFantasyWarrior\\nLord SzentgyÃ¶rgyi\\ndome\\nRathos\\nWe's\\nMr.Master\\nYamabusi\\nGrudgeNL\\nCrusaders Way to Expiation Team\\nThe Byzantine\\nLord Hamilton\\nPercus\\nKnights of the GarterSacred Stone Head\\nMandible\\nLife Erickson\\nNarf of Picklestink\\nSonyer\\n\\nОсоблива подяка:\\n\\nCauseless - Поради щодо скриптингу/Інструменти для модифікації музичного оформлення\\nMr. Jox - Допомога в C++/Допомога з поселеннями\\nDrunk Flamingo - Поради щодо скриптингу\\nMarthenil - Поради щодо скриптингу\\nHardballer - Поради щодо правки користувацького інтерфейсу\\nOle - Редагування ассетів\\nPhazer - Редагування «твердих» моделей\\nsimivs - Допомога з анімаціями\\nOcramium - Вступний ролик для Візантії\\nCreative Assembly - за створення чудової гри!\\nА також дякуємо всім тестувальникам на нашому Discord!	true
message_event_text_text_mk_event_mk1212_intro_title	Medieval Kingdoms: Total War - 1212 AD	true
message_event_text_text_mk_event_mk1212_popeintro_primary	Папа Римський	true
message_event_text_text_mk_event_mk1212_popeintro_secondary	Будучи католицькою фракцією, ви повинні грати в небезпечну гру впливу на думку духовенства. На чолі духовенства стоїть Папа Римський, верховний глава католицької церкви. Умиротворення Папи може служити вашим інтересам, його невдоволення, в свою чергу, може спричинити жахливі наслідки.	true
message_event_text_text_mk_event_mk1212_popeintro_title	Medieval Kingdoms: Total War - 1212 AD	true
message_event_text_text_mk_event_mk1212_wwintro_primary	Втома від воєн	true
message_event_text_text_mk_event_mk1212_wwintro_secondary	Справжній правитель повинен точно знати, до яких меж можна пригнічувати свій народ. Кожна війна - це справжня драма у відносинах між королівствами, і безтурботне ставлення до них може обернутися бідою.	true
message_event_text_text_mk_event_mk1212_wwintro_title	Medieval Kingdoms: Total War - 1212 AD	true
message_event_text_text_mk_event_mongol_invasion_primary	Монгольська імперія	true
message_event_text_text_mk_event_mongol_invasion_secondary	Прийшли звістки про появу на сході великої держави, яка сповнена рішучості завоювати або знищити все на своєму шляху. Монгольські армії являють собою жахливу силу, що складається з великої кількості легкої кінноти, що забезпечує їх військам надзвичайну мобільність. Монголи також використовують у своїх арміях зброю, про яку ще не чули в Європі та на Близькому Сході. Тим, хто став їм на заваді, зрозуміло лише одне: здавайтеся або будете знищені.	true
message_event_text_text_mk_event_mongol_invasion_title	Вторгнення монголів!	true
message_event_text_text_mk_event_mongol_invasion_upkeep_primary	Період безкоштовного утримання армій добігає кінця	true
message_event_text_text_mk_event_mongol_invasion_upkeep_secondary	Великий хан скоро припинить підтримку ваших армій, оскільки вважає, що вони зможуть забезпечувати себе доходами з завойованих територій. Тоді підтримка цих військ ляже на ваші плечі.	true
message_event_text_text_mk_event_mongol_invasion_upkeep_title	Закінчення періоду безкоштовного утримання армій	true
message_event_text_text_mk_event_polish_kingdom_formed_primary	Королівство Польське	true
message_event_text_text_mk_event_polish_kingdom_formed_secondary	Більше не розділене кордонами, польське панування встановилося над усіма колишніми землями нинішнього королівства. Виникло справжнє польське королівство, готове відбити будь-якого іноземного загарбника і розширити свої кордони за межі володінь навіть найвеличніших з Пястів.	true
message_event_text_text_mk_event_polish_kingdom_formed_title	Заснування королівства	true
message_event_text_text_mk_event_pope_enemy_of_christendom_primary	Лють Європи	true
message_event_text_text_mk_event_pope_enemy_of_christendom_secondary	Неймовірно похмура новина. Оголошення вами війни Папській області змусило Папу згуртувати добрих християн по всьому світу проти вас. В єдиному пориві вони засуджують ваші дії і незабаром можуть почати війну, щоб повернути Рим.	true
message_event_text_text_mk_event_pope_enemy_of_christendom_title	Крик обурення християнського світу	true
message_event_text_text_mk_event_pope_excommunication_lifted_other_secondary	Ця фракція, колись відлучена Папою Римським від церкви за свої гріхи, приймається назад з розпростертими обіймами.	true
message_event_text_text_mk_event_pope_excommunication_lifted_other_title	Прийняття фракції до церкви	true
message_event_text_text_mk_event_pope_excommunication_lifted_primary	Ваше відлучення від церкви скасовано!	true
message_event_text_text_mk_event_pope_excommunication_lifted_secondary	Ваша фракція була прийнята назад до католицької церкви з розпростертими обіймами, і всі штрафи, пов'язані з вашим відлученням, були скасовані.	true
message_event_text_text_mk_event_pope_excommunication_lifted_title	Відлучення скасовано!	true
message_event_text_text_mk_event_pope_excommunication_other_secondary	Ця фракція була відлучена Папою Римським від церкви за свої гріхи, будь то злочини проти віри або непокора волі Папи.	true
message_event_text_text_mk_event_pope_excommunication_other_title	Відлучення фракції	true
message_event_text_text_mk_event_pope_excommunication_primary	Вас відлучили від церкви!	true
message_event_text_text_mk_event_pope_excommunication_secondary	Неймовірно жахлива новина! Ви були відлучені від церкви Папою Римським! Хоча ваш лідер фракції може продовжувати правити, зараз він знаходиться в протиріччях з католицькою церквою. Відлучення від церкви сильно шкодить вашому ставленню до інших католицьких фракцій, поки ваш нинішній лідер фракції залишається при владі. Війська інших католицьких фракцій будуть битися з ще більшою енергією проти ваших власних, і всі благочестиві католики вашого народу, ймовірно, скоро виявлять своє невдоволення!	true
message_event_text_text_mk_event_pope_excommunication_title	Відлучення!	true
message_event_text_text_mk_event_pope_favour_decrease_primary_abstained_crusade	Відмова від участі в хрестовому поході!	true
message_event_text_text_mk_event_pope_favour_decrease_primary_borrowed_money	Вимога грошей!	true
message_event_text_text_mk_event_pope_favour_decrease_primary_declared_war	Оголошення війни!	true
message_event_text_text_mk_event_pope_favour_decrease_primary_failed_to_join_albigensian_crusade	Відмова приєднатися до Альбігойського хрестового походу!	true
message_event_text_text_mk_event_pope_favour_decrease_primary_joined_toulouse	Відсіч Альбігойському хрестовому походу!	true
message_event_text_text_mk_event_pope_favour_decrease_primary_mission_fail_generic	Завдання провалено!	true
message_event_text_text_mk_event_pope_favour_decrease_primary_mission_fail_peace	Завдання провалено!	true
message_event_text_text_mk_event_pope_favour_decrease_primary_mission_fail_take_jerusalem_dilemma	Завдання провалено!	true
message_event_text_text_mk_event_pope_favour_decrease_primary_refused_but_gave_target	Незначні поступки	true
message_event_text_text_mk_event_pope_favour_decrease_primary_refused_demands	Відхилені вимоги	true
message_event_text_text_mk_event_pope_favour_decrease_primary_refused_pretender	Відмова від висунення!	true
message_event_text_text_mk_event_pope_favour_decrease_primary_sacked_settlement	Поселення розграбоване!	true
message_event_text_text_mk_event_pope_favour_decrease_primary_slaughtered_captives	Полонені вбиті!	true
message_event_text_text_mk_event_pope_favour_decrease_primary_supported_toulouse	Підтримка Тулузи!	true
message_event_text_text_mk_event_pope_favour_decrease_secondary_abstained_crusade	Недостатня ревність, яку ви проявили, відмовившись від хрестового походу в ім'я Господа, сильно засмутила Його Святість. Прихильність Папи Римського до вас значно знизилася.	true
message_event_text_text_mk_event_pope_favour_decrease_secondary_borrowed_money	Його Святість задовольнив ваше прохання про фінансову допомогу, хоча після запиту такої суми грошей ваше ставлення до Папи стало напруженим. Прихильність Папи Римського до вас значно знизилася.	true
message_event_text_text_mk_event_pope_favour_decrease_secondary_declared_war	Ви засмутили Папу, оголосивши війну одновірцям-католикам. В результаті прихильність Папи Римського до вас знизилася.	true
message_event_text_text_mk_event_pope_favour_decrease_secondary_failed_to_join_albigensian_crusade	Ви розчарували Його Святість, відмовившись брати участь в Альбігойському хрестовому поході. Прихильність Папи Римського до вас знизилася.	true
message_event_text_text_mk_event_pope_favour_decrease_secondary_joined_toulouse	Його Святість засуджує вас, бо ви пішли проти його волі, виступивши проти Альбігойського хрестового походу. Прихильність Папи Римського до вас значно знизилася.	true
message_event_text_text_mk_event_pope_favour_decrease_secondary_mission_fail_generic	Ви викликали невдоволення Його Святості тим, що не виконали його завдання. В результаті прихильність Папи Римського до вас знизилася.	true
message_event_text_text_mk_event_pope_favour_decrease_secondary_mission_fail_peace	Ви сильно розгнівали Його Святість, не зумівши укласти мир з вашими братами-християнами, що призвело до сильного зниження прихильності до вас Папи Римського.	true
message_event_text_text_mk_event_pope_favour_decrease_secondary_mission_fail_take_jerusalem_dilemma	Ви не виконали обіцянки, дані Його Святості після останнього хрестового походу, і це сильно його розлютило. Прихильність Папи Римського до вас надзвичайно сильно впала.	true
message_event_text_text_mk_event_pope_favour_decrease_secondary_refused_but_gave_target	Ви знехтували волею Папи, відмовившись тільки від цільового міста хрестового походу. Прихильність Папи Римського до вас значно зменшилася, але ви зберегли за собою всі інші землі, завойовані під час хрестового походу.	true
message_event_text_text_mk_event_pope_favour_decrease_secondary_refused_demands	Ви відмовили Папі в його вимогах, чим сильно його розгнівали. Прихильність Папи Римського до вас знизилася до надзвичайно високого рівня.	true
message_event_text_text_mk_event_pope_favour_decrease_secondary_refused_pretender	Ви відмовилися від запропонованого Папою Римським висунення на титул імператора Священної Римської імперії, тим самим уникаючи втягування себе у війну з нинішнім імператором, але розгнівавши при цьому Папу. Прихильність Папи Римського до вас зменшилася.	true
message_event_text_text_mk_event_pope_favour_decrease_secondary_sacked_settlement	Ви розорили беззахисне християнське поселення після того, як воно здалося вашим військам, і Папа дуже цим розчарований. Прихильність Папи Римського до вас знизилася.	true
message_event_text_text_mk_event_pope_favour_decrease_secondary_slaughtered_captives	Навіть якщо б вони це заслужили, масове вбивство вами беззахисних полонених-християн засмутило Папу. Прихильність Папи Римського до вас знизилася.	true
message_event_text_text_mk_event_pope_favour_decrease_secondary_supported_toulouse	Ви викликали невдоволення Його Святості, підтримавши графство Тулуза зброєю і людьми. Прихильність Папи Римського до вас знизилася.	true
message_event_text_text_mk_event_pope_favour_decrease_title	Зниження прихильності Папи Римського	true
message_event_text_text_mk_event_pope_favour_increase_primary_crusade_victory	Переможна хрестова похід!	true
message_event_text_text_mk_event_pope_favour_increase_primary_joined_albigensian_crusade	Приєднання до Альбігойського хрестового походу!	true
message_event_text_text_mk_event_pope_favour_increase_primary_joined_crusade	Приєднання до хрестового походу!	true
message_event_text_text_mk_event_pope_favour_increase_primary_mission_succeed_generic	Завдання виконано!	true
message_event_text_text_mk_event_pope_favour_increase_primary_mission_succeed_peace	Завдання виконано!	true
message_event_text_text_mk_event_pope_favour_increase_primary_released_captives	Звільнені полонені!	true
message_event_text_text_mk_event_pope_favour_increase_secondary_crusade_victory	Ви дуже порадували Його Святість, виконавши свої обітниці хрестового походу. Прихильність Папи Римського до вас зросла до максимального значення.	true
message_event_text_text_mk_event_pope_favour_increase_secondary_joined_albigensian_crusade	Ви догодили Його Святості, приєднавшись до Альбігойського хрестового походу. Прихильність Папи Римського до вас збільшилася.	true
message_event_text_text_mk_event_pope_favour_increase_secondary_joined_crusade	Старанність, яку ви проявили в своєму бажанні здійснити хрестовий похід в ім'я Господа, дуже порадувала Його Святість. Прихильність Папи Римського до вас значно збільшилася.	true
message_event_text_text_mk_event_pope_favour_increase_secondary_mission_succeed_generic	Ви догодили Його Святості, виконавши його завдання. Прихильність Папи Римського до вас збільшилася.	true
message_event_text_text_mk_event_pope_favour_increase_secondary_mission_succeed_peace	Ви догодили Його Святості, відклавши свої розбіжності з вашими братами-християнами і уклавши мир. Прихильність Папи Римського до вас збільшилася.	true
message_event_text_text_mk_event_pope_favour_increase_secondary_released_captives	Проявивши милосердя до полонених після вашої останньої битви, ви догодили Його Святості. Прихильність Папи Римського до вас збільшилася.	true
message_event_text_text_mk_event_pope_favour_increase_title	Збільшення прихильності Папи Римського	true
message_event_text_text_mk_event_pope_new_pope_primary_detail	Обрано нового Папу Римського	true
message_event_text_text_mk_event_pope_new_pope_primary_detail_coelestinus_4	Папа Целестин IV	true
message_event_text_text_mk_event_pope_new_pope_primary_detail_gregorius_9	Папа Григорій IX	true
message_event_text_text_mk_event_pope_new_pope_primary_detail_honorious_3	Папа Гонорій III	true
message_event_text_text_mk_event_pope_new_pope_primary_detail_innocentius_3	Папа Інокентій III	true
message_event_text_text_mk_event_pope_new_pope_primary_detail_innocentius_4	Папа Інокентій IV	true
message_event_text_text_mk_event_pope_new_pope_secondary_detail	Його Святість Папа Римський постав перед Господом, завершивши тим самим плідний розділ в історії Церкви. Новий Папа був обраний без зволікання; у цієї людини є шанс стати на чолі всього християнського світу, і лише невелика частина з них є значно більш значущими або мають більшу владу, ніж він. Всім добрим християнським правителям слід підтримати нового Папу, якщо їх закличуть до цього, що буде тільки на благо їх королівств. Але пам'ятайте, що переступивши йому дорогу, ви накличете на себе жахливі наслідки.	true
message_event_text_text_mk_event_pope_new_pope_title	Обрано нового Папу Римського	true
message_event_text_text_mk_event_pope_papacy_restored_primary	Відновлено Папську область	true
message_event_text_text_mk_event_pope_papacy_restored_secondary	Настав славний день для католиків, Папська область була відновлена в Італії, і Папа Римський знову панує над католицькими монархами Європи.	true
message_event_text_text_mk_event_pope_papacy_restored_title	Інститут папства відновлено!	true
message_event_text_text_mk_event_pope_rome_attacked_nonchrist_primary	Рим більше не вічний	true
message_event_text_text_mk_event_pope_rome_attacked_nonchrist_secondary	Це день, який потрібно запам'ятати! Рим був підкорений, папський престол знову зазнав руйнівного впливу війни. Не дивно, що християни по всьому світу жахливо засмучені таким поворотом подій. Однак ваш народ завжди знав, що падіння цього фальшивого бога і його послідовників неминуче.	true
message_event_text_text_mk_event_pope_rome_attacked_nonchrist_title	Падіння Риму	true
message_event_text_text_mk_event_sic_lost_claim_primary	Втрачені претензії	true
message_event_text_text_mk_event_sic_lost_claim_secondary	Ви занадто довго відкладали прийняття рішучих заходів, і багато дворян Священної Римської імперії з тих пір стали підтримувати правлячого імператора. Так само і Папа Римський відвернувся від вас заради більш стабільної влади в Італії. Ваш шанс отримати імператорську корону був втрачений...	true
message_event_text_text_mk_event_sic_lost_claim_secondary_death	Смерть вашого короля знаменує собою кінець будь-яких короткострокових перспектив здобути імператорський трон, і претензії вашої фракції на Священну Римську імперію тепер не значать нічого.	true
message_event_text_text_mk_event_sic_lost_claim_title	Гнів Інокентія	true
message_event_text_text_mk_event_sic_no_war_hre_primary	Король сицилійців	true
message_event_text_text_mk_event_sic_no_war_hre_secondary	Вирішивши, що Королівство Сицилія для вас важливіше, ніж ризикована війна проти Священної Римської імперії, ви відмовилися від війни і залишили свої претензії на імператорський трон.	true
message_event_text_text_mk_event_sic_no_war_hre_title	Гнів Інокентія	true
message_event_text_text_mk_event_spa_reconquista_success_primary	Реконкіста закінчена	true
message_event_text_text_mk_event_spa_reconquista_success_secondary	Реконкіста, нарешті, була закінчена, відкривши тим самим нову еру католицького панування на Піренейському півострові. Багато іновірців в межах королівства зараз знаходяться перед непростим вибором, звернутися в християнство або покинути півострів, що негативно позначається на стабільності королівства.	true
message_event_text_text_mk_event_spa_reconquista_title	Реконкіста	true
message_event_text_text_mk_event_spanish_kingdom_formed_primary	Королівство Іспанія	true
message_event_text_text_mk_event_spanish_kingdom_formed_secondary_mk_fact_aragon	Більше немає ніякої Арагонської корони. Іспанія тепер об'єднана і формується нове Королівство Іспанія.	true
message_event_text_text_mk_event_spanish_kingdom_formed_secondary_mk_fact_castile	Більше немає ніякого Королівства Кастилія. Іспанія тепер об'єднана і формується нове Королівство Іспанія.	true
message_event_text_text_mk_event_spanish_kingdom_formed_secondary_mk_fact_navarre	Більше немає ніякого Королівства Наварра. Іспанія тепер об'єднана і формується нове Королівство Іспанія.	true
message_event_text_text_mk_event_spanish_kingdom_formed_title	Заснування королівства	true
message_event_text_text_mk_event_timurd_invasion_primary	Імперія Тимуридів	true
message_event_text_text_mk_event_timurid_invasion_secondary	Півтора століття тому монголи вперше вийшли зі східних степів, щоб посіяти хаос у світі. Про спустошення, спричинені монголами, ходять легенди, але державам, які були побудовані на попелищі, тепер загрожує новий ворог. Великий полководець об'єднав сили Чагатайського улусу і переправився через річку Окс. Тепер він прагне розпочати війну з нащадками Чингісхана і знову об'єднати Монгольську імперію, і тих, хто стане на його невблаганному шляху, ймовірно, чекає та ж доля, що і тих, хто протистояв Великому хану багато років тому.	true
message_event_text_text_mk_event_timurid_invasion_title	Вторгнення Тимуридів!	true
message_event_text_text_mk_event_tou_aragon_intervenes_bad_primary	Арагон обернувся проти нас!	true
message_event_text_text_mk_event_tou_aragon_intervenes_bad_secondary	Арагонська корона, яка здобула на півдні перемогу над маврами, тепер приєдналася до хрестоносців, відкривши з півдня другий фронт. Ситуація стає жахливо суворою.	true
message_event_text_text_mk_event_tou_aragon_intervenes_primary	Арагон йде нам на допомогу!	true
message_event_text_text_mk_event_tou_aragon_intervenes_secondary	Арагонська корона приєдналася до нас у війні проти Франції та її хрестоносців. Нехай буде благословенний цей день!	true
message_event_text_text_mk_event_tou_aragon_support_primary	Підтримка від Арагону	true
message_event_text_text_mk_event_tou_aragon_support_secondary	Арагонська корона щедро забезпечила нас людьми та спорядженням для формування нової армії на наших землях, що складається з арагонських та місцевих солдатів. Маючи таку підтримку, ми зможемо незабаром дати відсіч загарбникам.	true
message_event_text_text_mk_event_pope_favour_decrease_primary_relations_decay	Зіпсовані відносини з Папою Римським	true
message_event_text_text_mk_event_pope_favour_decrease_secondary_relations_decay	Недоброзичливі відносини між вашою фракцією і Папською областю погіршили думку про вас Папи. В результаті знизився ваш рівень Прихильності Папи Римського.	true
message_event_text_text_mk_event_pope_favour_increase_primary_relations_increase	Дружні відносини з Папою	true
message_event_text_text_mk_event_pope_favour_increase_secondary_relations_increase	Дружні відносини між вашою фракцією і Папською областю поліпшили думку Папи про вас. В результаті підвищився ваш рівень прихильності Папи Римського.	true
message_event_text_text_mk_event_mk1212_hreintro_primary	Священна Римська імперія	true
message_event_text_text_mk_event_mk1212_hreintro_secondary	Пануючи над Центральною Європою, Священна Римська імперія простягається від Північного моря до Адріатики. Хоча це і одне політичне утворення, воно включає в себе безліч дрібних фракцій з чималим ступенем автономії. Після смерті імператора Священної Римської імперії його місце займає одна з цих фракцій. Імператор з часом набуває Імперську владу, яку можна витратити на видання Імператорських указів і проведення Імперських реформ: перші дають тимчасовий ефект, що впливає на імперію в цілому, а другі вносять постійні зміни в Священну Римську імперію. Титул імператора також може бути оскаржений претендентами за межами імперії, висунутими Папою Римським, якщо нинішній імператор буде відлучений від церкви.	true
message_event_text_text_mk_event_mk1212_hreintro_title	Medieval Kingdoms: Total War - 1212 AD	true
message_event_text_text_mk_event_mecca_attacked_secondary	Священне місто мусульман Мекка впало в руки невірних, його святині осквернені чужинцями-загарбниками. Мусульмани всього світу обурені цією обставиною, і ситуація в багатьох державах незабаром може прийти в повний безлад.	true
message_event_text_text_mk_event_mecca_attacked_title	Падіння Мекки	true
message_event_text_text_mk_event_mecca_liberated_secondary	Мекка, священне місто мусульман, нарешті була звільнена прихильниками ісламської віри. Радість огорнула серце кожного мусульманина в усьому світі.	true
message_event_text_text_mk_event_mecca_liberated_title	Відвоювання Мекки	true
message_event_text_text_mk_event_mecca_destroyed_title	Руйнування Мекки	true
message_event_text_text_mk_event_mecca_destroyed_secondary	Для мусульман усього світу настав найгірший день в історії: священне місто Мекка було повністю зруйновано, а всі його святині розорені і знищені чужинцями-загарбниками. Іслам, можливо, і не оговтається від такого серйозного удару, але точно, що у правовірних з'явиться жага помсти.	true
message_event_text_text_mk_event_faction_rank_secondary_4	Ваша фракція досягла рангу «королівства», що вказує на її статус регіональної держави.	true
message_event_text_text_mk_event_faction_rank_secondary_5	Ваша фракція досягла рангу «імперії», що вказує на її статус великої держави.	true
message_event_text_text_mk_event_faction_rank_title_4	Заснування королівства	true
message_event_text_text_mk_event_faction_rank_title_5	Заснування імперії	true
message_event_text_text_mk_event_hre_war_declared_on_member_state_title	Оголошено війну державі-члену СРІ	true
message_event_text_text_mk_event_hre_war_declared_on_member_state_secondary	Ви оголосили війну державі-члену Священної Римської імперії і тим самим значно підірвали свій статус імператора, що призвело до значного зниження рівня Імперської влади.	true
message_event_text_text_mk_event_hre_election_title	Imperial Election	true
message_event_text_text_mk_event_hre_election_description	The imperial election has ended, bringing the reign of one emperor to a close and ushering in a new leader for the Holy Roman Empire. The newly crowned Emperor takes the helm, ready to shape the next chapter of the Empire’s legacy.	true
