key	text	tooltip
#Loc;1;text/db/random_localisation_strings.loc		
random_localisation_strings_string_finances_vassal_income_breakdown_faction	%S	true
random_localisation_strings_string_building_construction_requires_main_slot_upgrade	Спочатку треба перебудувати місто.	true
random_localisation_strings_string_sea_region_control_status_hostile	Ворожий	true
random_localisation_strings_string_siege_suffering_attrition	У гарнізону закінчилися припаси. Він несе небойові втрати.	true
random_localisation_strings_string_finances_tribute_income_breakdown_other	Від решти	true
random_localisation_strings_string_cancel_construction_confirmation	Ця будівля ще будується. Ви дійсно хочете знести її?	true
random_localisation_strings_string_unit_stat_bonus_morale_superior	Відмінний бойовий дух	true
random_localisation_strings_string_unit_stat_bonus_armour_improved	Добра броня	true
random_localisation_strings_string_famous_battle_battle_of	Битва	true
random_localisation_strings_string_round_id_august	Серпень	true
random_localisation_strings_string_round_id_late_july	Кінець липня	true
random_localisation_strings_string_difficulty_level_4	Дуже висок.	true
random_localisation_strings_string_difficulty_level_5	Легенд.	true
random_localisation_strings_string_difficulty_level_2	Середн.	true
random_localisation_strings_string_difficulty_level_3	Висок.	true
random_localisation_strings_string_difficulty_level_1	Низьк.	true
random_localisation_strings_string_siege_turns_to_attrition	Термін, на який вистачить припасів у гарнізону:	true
random_localisation_strings_string_character_role_daughter	Дочка	true
random_localisation_strings_string_cannot_build_insufficient_funds	У вас недостатньо коштів, щоб побудувати цю споруду.	true
random_localisation_strings_string_StratHud_Building_Card_Recruit_Selection	ЛКМ - побудувати споруду; ПКМ - дізнатися більше	true
random_localisation_strings_string_finance_header_liege_lord	Володіння	true
random_localisation_strings_string_character_role_retainer	Слуга	true
random_localisation_strings_string_stats_clan_naval_ranked_games_won	text_rejected	true
random_localisation_strings_string_character_situation_conversion_catholic	Навернення провінції	true
random_localisation_strings_string_click_to_mark_current_selection_for_dismantling	ЛКМ - знести вибрану споруду. Частина вартості знесених споруд повертається до скарбниці.	true
random_localisation_strings_string_opponent_accepts_surrender_title	Згодні здатися	true
random_localisation_strings_string_replenish_prerequisites_not_met	Ви повинні мати можливість набирати загони в цій місцевості. Крім того, щоб поповнити військо, потрібно достатньо коштів. Ціна:	true
random_localisation_strings_string_unknown_ship_state	У вас немає всієї інформації про цей корабель. Підійшовши ближче, ви дізнаєтеся більше.	true
random_localisation_strings_string_round_id_late_june	Кінець червня	true
random_localisation_strings_string_StratHudbutton_Construction_Site	Пустир||Тут ви можете створити новий будівельний майданчик.	true
random_localisation_strings_string_mission_text_text_mis_activity_attain_fame_level_specific	PLACEHOLDER	true
random_localisation_strings_string_unit_upgrade_insufficient_funds	У вашій скарбниці недостатньо грошей, щоб поліпшити цей загін.	true
random_localisation_strings_string_trade_node_tooltip_supply_to_other	доставлено в їх столицю	true
random_localisation_strings_string_resource_exporting_percentage_zero	Щоб вивозити цей ресурс в інші землі, потрібен торговий шлях.	true
random_localisation_strings_string_AUA_LOCKED_HEAVILY_DAMAGED	text_rejected	true
random_localisation_strings_string_stats_clan_land_ranked_games_lost	text_rejected	true
random_localisation_strings_string_mp_ready_error_invalid_army_index	Обрана армія вже зайнята. Щоб почати гру, виберіть іншу армію.	true
random_localisation_strings_string_character_panel_loyalty_honour_negative	Негативні фактори	true
random_localisation_strings_string_player_stats_decisive_victories	Вирішальних перемог	true
random_localisation_strings_string_fe_unit_card_tooltip_navy	ЛКМ - вибрати \\nПодвійне клацання ЛКМ - видалити\\nПКМ - інформація||Картки кораблів можна переміщати в межах флоту.	true
random_localisation_strings_string_attacker_direction_south	Південь	true
random_localisation_strings_string_encourage_fleet	Натхнення||Деякі флагманські кораблі можуть надихати екіпаж інших суден у своїй зоні впливу, покращуючи їх атаку в ближньому бою, швидкість перезарядки і точність.||Для повторного використання цієї здатності має пройти деякий час.	true
random_localisation_strings_string_attacker_direction_north	Північ	true
random_localisation_strings_string_unknown_unit_state	У вас немає всієї інформації про цей загін. Підійшовши ближче, ви дізнаєтеся більше. У підглядників шанси дізнатися щось про війська вищі.	true
random_localisation_strings_string_round_id_early_may	Початок травня	true
random_localisation_strings_string_invalid_army_setup_local	У вас некоректний склад війська	true
random_localisation_strings_string_unit_stat_bonus_charge_superior	Відмінний натиск	true
random_localisation_strings_string_trade_route_state_neutral	(Нейтральний)	true
random_localisation_strings_string_building_under_construction_damaged_cannot	Недобудовані будівлі не пошкоджені	true
random_localisation_strings_string_mp_ready_error_no_land_defender_for_coastal_battle	У прибережній битві у захисника повинен бути, як мінімум, один сухопутний загін.	true
random_localisation_strings_string_morale_confident	Впевнені	true
random_localisation_strings_string_repair_selection	Відремонтувати пошкоджені кораблі в обраній групі. Ціна:	true
random_localisation_strings_string_sea_region_control_status_neutral	Нейтр.	true
random_localisation_strings_string_stats_clan_most_clan_map_regions_held_simultaneous	text_rejected	true
random_localisation_strings_string_FACTION_FOOD_FACTOR_ARMIES	Ворожі армії у ваших провінціях	true
random_localisation_strings_string_siege_turns_to_surrender	Ходів до капітуляції:	true
random_localisation_strings_string_player_stats_mp_consecutive_land	Макс. серія перемог у сухопутних битвах	true
random_localisation_strings_string_diplomacy_button_cannot_hostage	text_rejected	true
random_localisation_strings_string_unit_generic_left_click	ЛКМ - вибрати	true
random_localisation_strings_string_no_path_available	Цей загін не зможе дістатися до наймача.	true
random_localisation_strings_string_gfx_filtering_ani16x	Анізотр. 16x	true
random_localisation_strings_string_unit_stat_bonus_armour_exceptional	Ідеальна броня	true
random_localisation_strings_string_round_id_early_december	Початок грудня	true
random_localisation_strings_string_expedition_cannot_trade	Експедиції не можуть торгувати	true
random_localisation_strings_string_network_error_join_failed	Не вдалося приєднатися до обраної гри	true
random_localisation_strings_string_bribe_nonhostile_cancel	Скасувати	true
random_localisation_strings_string_network_error_host_failed	Не вдалося створити гру	true
random_localisation_strings_string_must_negotiate_with_master	З цим проханням можна звернутися тільки до глави фракції:	true
random_localisation_strings_string_error_twitch_login	Не вдалося увійти в Twitch.tv. \\n\\nПереконайтеся, що ім'я користувача та пароль введені правильно.	true
random_localisation_strings_string_conversion_factor_events_christian	Останні події	true
random_localisation_strings_string_demo_save_disabled	Функція збереження тимчасово відключена.||Збереження буде виконуватися автоматично в ході кампанії.	true
random_localisation_strings_string_cannot_reinforce_at_night	Дані війська не можуть служити підкріпленням в нічній битві.	true
random_localisation_strings_string_setup_cost_high	text_rejected	true
random_localisation_strings_string_StratHudbutton_Damaged_Building	Пошкоджена споруда||Поки споруда пошкоджена, всі її ефекти ослаблені, крім того, її не можна покращувати. Сама по собі споруда відновлюється повільно, зате безкоштовно. Щоб витратити гроші і відремонтувати її за один хід, скористайтеся відповідною кнопкою вгорі.	true
random_localisation_strings_string_character_role_candidate	Кандидат	true
random_localisation_strings_string_mission_issued_infiltrate	text_rejected	true
random_localisation_strings_string_unit_stat_bonus_morale_improved	Хороший бойовий дух	true
random_localisation_strings_string_player_stats_campaign_naval_battles_won	Виграно битв на морі (в кампанії)	true
random_localisation_strings_string_unit_stat_bonus_armour_superior	Відмінна броня	true
random_localisation_strings_string_character_role_governor	Губернатор	true
random_localisation_strings_string_settlement_colon	Поселення:	true
random_localisation_strings_string_unit_concerned_recent_casualties	Нещодавно зазнали втрат	true
random_localisation_strings_string_ability_phase_mask_freeze_fatigue	Відключити втому	true
random_localisation_strings_string_no_slot_available	Доступні комірки відсутні	true
random_localisation_strings_string_stat_bonus_cavalry	Перев. пр. кінноти	true
random_localisation_strings_string_cancel_demolish_building_once_settled_expedition	Щоб завершити знесення цієї споруди, експедиція повинна зупинитися в таборі. ЛКМ - скасувати наказ про знесення.	true
random_localisation_strings_string_unit_stat_bonus_charge_improved	Добрий натиск	true
random_localisation_strings_string_the_selected_item_may_not_be_dismantled	Вибраний елемент неможливо знести.	true
random_localisation_strings_string_postbattle_public_order_reduction	Нестабільність у провінції	true
random_localisation_strings_string_prebattle_popup_defection_04	Деякі ворожі війська перейшли на ваш бік і будуть битися на вашому боці. Однак частина ваших людей покинула вас і приєдналася до ваших ворогів.	true
random_localisation_strings_string_prebattle_popup_defection_02	Деякі ваші війська перебігли до ворога, тепер вони будуть протистояти вам на полі бою!	true
random_localisation_strings_string_prebattle_popup_defection_03	Деякі ворожі війська перебігли до вас, тепер вони будуть битися на вашому боці!	true
random_localisation_strings_string_prebattle_popup_defection_01	Перебіжчики!	true
random_localisation_strings_string_finances_background_income	Основний дохід	true
random_localisation_strings_string_fatigue_very_tired	Дуже втомлені	true
random_localisation_strings_string_StratHudbutton_Cannot_Recruit_Missionary1	У вас вже максимальна кількість місіонерів	true
random_localisation_strings_string_StratHudbutton_Cannot_Recruit_Missionary2	Вам не вистачає коштів на найм цього агента. Ціна:	true
random_localisation_strings_string_StratHudbutton_Cannot_Recruit_Missionary3	Ви можете наймати не більше одного місіонера на провінцію кожен хід	true
random_localisation_strings_string_resource_long_term	Міцні зв'язки	true
random_localisation_strings_string_diplomacy_undiscovered_clan_mon	Невідкрита фракція	true
random_localisation_strings_string_victory_conditions_turns_to_hold	Утримувати протягом %n ходів.	true
random_localisation_strings_string_unit_concerned_frightened_horses	Коні налякані	true
random_localisation_strings_string_StratHudbutton_Naval_Cancel_Repair	Скасувати ремонт вибраних кораблів. До скарбниці повернеться:	true
random_localisation_strings_string_MILITARY_FORCE_FOOD_FACTOR_RAIDING	Наліт	true
random_localisation_strings_string_prebattle_legendary_cannot_save	Не можна зберігатися перед боєм, граючи на легендарному рівні складності.	true
random_localisation_strings_string_TechTree_Tech_Available_Function_Tooltip	ЛКМ - вивчити цю технологію	true
random_localisation_strings_string_character_situation_land_attack	Сухопутні битви	true
random_localisation_strings_string_mp_ready_error_no_units	Ви повинні вибрати кілька загонів перед оголошенням готовності.	true
random_localisation_strings_string_mp_coop_partner_defeated	Ваш партнер по спільній грі переможений, гра зараз буде завершена.	true
random_localisation_strings_string_character_situation_requesting_allegiance	Запит на підданство	true
random_localisation_strings_string_character_situation_sea_defence	Захист у морських битвах	true
random_localisation_strings_string_campaign_type_co_op_short	Коротка спільна гра	true
random_localisation_strings_string_network_message_vac_player_kicked	покидає гру через помилку авторизації VAC.	true
random_localisation_strings_string_dlc_purchase_title	Отримано завантажувані матеріали	true
random_localisation_strings_string_error_legendary_save_load_disabled	Швидке збереження/завантаження вимкнено на легендарному рівні складності	true
random_localisation_strings_string_power_category_1	Жахаючий	true
random_localisation_strings_string_power_category_3	Сильний	true
random_localisation_strings_string_power_category_2	Могутній	true
random_localisation_strings_string_power_category_5	Слабкий	true
random_localisation_strings_string_power_category_4	Помірний	true
random_localisation_strings_string_power_category_6	Безвісний	true
random_localisation_strings_string_FACTION_FOOD_FACTOR_HORDES	Орди у ваших провінціях	true
random_localisation_strings_string_trade_agreement_tooltip_export_route_count	Залишилося морських шляхів для зовнішньої торгівлі: у вас - %d/%d; у них - %d/%d ||Це значення визначають торгові порти в столичній провінції.	true
random_localisation_strings_string_unit_stat_bonus_melee_exceptional	Ідеальний ближній бій	true
random_localisation_strings_string_reduced_unit_limit_msg_sp	Ви зменшили максимальну кількість загонів. Деякі загони будуть виключені з вашого набору.	true
random_localisation_strings_string_unit_encouraged_settlement_plaza	Точки захоплення	true
random_localisation_strings_string_gfx_ultra	Макс.	true
random_localisation_strings_string_audio_provider_stereo_headphones	Навушники	true
random_localisation_strings_string_town_factor_events	Події	true
random_localisation_strings_string_morale_1	Бунтівні	true
random_localisation_strings_string_morale_0	Повстання	true
random_localisation_strings_string_agent_help_cannot_sabotage_damaged_castle_gates	Не можна влаштувати диверсію - ворота поселення вже були пошкоджені.	true
random_localisation_strings_string_ability_change_formation_spacing	Розімкнути стрій||Розімкнутий стрій зменшує втрати від обстрілу, але підвищує вразливість до натиску та атак у ближньому бою.	true
random_localisation_strings_string_limited_unit_type	Максимальна кількість таких предметів обмежена. Зараз у вас їх %d з %d.	true
random_localisation_strings_string_player_is_mp_co_op_ally_and_cannot_attack	Не можна атакувати союзника по спільній мережевій грі.	true
random_localisation_strings_string_technology_status_stolen	text_rejected	true
random_localisation_strings_string_fatigue_exhausted	Виснажені	true
random_localisation_strings_string_land_combatant_winning_big	Загін здобуває рішучу перемогу	true
random_localisation_strings_string_battle_title_olbia	Битва при Ольвії	true
random_localisation_strings_string_unit_concerned_outnumbered	Ворог переважає чисельністю	true
random_localisation_strings_string_network_error_join_failed_no_stats	Не вдалося приєднатися до гри: статистика гравця недоступна	true
random_localisation_strings_string_diplomacy_button_need_peace_with_other_allies_to_a	text_rejected	true
random_localisation_strings_string_character_panel_loyalty_honour_positive	Позитивні фактори	true
random_localisation_strings_string_player_stats_campaign_land_battles_lost	Програно битв на суші (в кампанії)	true
random_localisation_strings_string_pre_battle_siege_equipment_totals_tooltip	Облогові знаряддя, що будуються: %d\\nГотові облогові знаряддя: %d	true
random_localisation_strings_string_decline_breaks_alliance_defender	Відмовитися (ви розірвете союз із захисником)	true
random_localisation_strings_string_round_id_early_september	Початок вересня	true
random_localisation_strings_string_player_stats_total_mp_naval_battles_won	Виграно мережевих морських битв	true
random_localisation_strings_string_building_under_construction_damaged_repair	Клацніть тут, щоб відремонтувати недобудовану будівлю. Тоді будівництво в ній зможе продовжитися.	true
random_localisation_strings_string_battle_victory_minor_close	Важка перемога||Ворог зламаний! Загибель і ганьба - його доля, хоча зовсім недавно ви були на межі поразки.	true
random_localisation_strings_string_fe_unit_card_tooltip_minimal_naval	ЛКМ - вибрати\\nПКМ - дізнатися більше||Картки можна переміщати в межах флоту.	true
random_localisation_strings_string_stats_clan_number_of_active_seasons_since_creation	text_rejected	true
random_localisation_strings_string_error_chat_room_invalid	Помилка чату||Неправильна кімната чату.	true
random_localisation_strings_string_character_type_title_sonandheir	Син і спадкоємець	true
random_localisation_strings_string_unit_generic_right_click	ПКМ - дізнатися більше	true
random_localisation_strings_string_fe_recruitment_card_tooltip_category_clamp_reached	Не можна додати цей загін - одночасно можна використовувати тільки одну облогову машину.	true
random_localisation_strings_string_unit_encouraged_settlement	Обороняють місто	true
random_localisation_strings_string_stats_clan_naval_ranked_games_lost	text_rejected	true
random_localisation_strings_string_FACTION_FOOD_FACTOR_EDICTS	Едикти	true
random_localisation_strings_string_unit_concerned_discouraged_by_unit_ability	Ослаблені вмінням противника	true
random_localisation_strings_string_stats_clan_current_highest_ranked_4v4_clan_team	text_rejected	true
random_localisation_strings_string_stats_clan_current_highest_ranked_3v3_clan_team	text_rejected	true
random_localisation_strings_string_stats_clan_current_highest_ranked_2v2_clan_team	text_rejected	true
random_localisation_strings_string_FACTION_FOOD_FACTOR_EVENTS	Події	true
random_localisation_strings_string_network_error_incompatible_data	Несумісні дані	true
random_localisation_strings_string_cancel_demolish_building	Ця будівля буде знесена після закінчення вашого ходу. Клацніть ЛКМ, щоб скасувати знесення.	true
random_localisation_strings_string_cancel_demolish_building_once_expedition	Щоб завершити знесення цієї споруди, експедиція повинна розбити табір. ЛКМ - скасувати наказ про знесення.	true
random_localisation_strings_string_hudbutton_studying_name	Вивчення:	true
random_localisation_strings_string_multiplayer_dialog_expire	Це діалогове вікно зникне через:	true
random_localisation_strings_string_technology_status_available_no_facility	text_rejected	true
random_localisation_strings_string_character_role_deceased	Покійн.	true
random_localisation_strings_string_button_cancel_slot_instruction_inactive	Виберіть предмет перед використанням цієї кнопки.	true
random_localisation_strings_string_battle_time_limit	%d хв.	true
random_localisation_strings_string_overwrite_title	Перезаписати файл?	true
random_localisation_strings_string_unit_stat_bonus_accuracy_superior	Відмінна влучність	true
random_localisation_strings_string_opponent_refuses_surrender_title	Відмовляються здаватися	true
random_localisation_strings_string_agent_help_str_request_allegiance_faction_leader_present	text_rejected	true
random_localisation_strings_string_faction_leader_tooltip_honour_5	text_rejected	true
random_localisation_strings_string_faction_leader_tooltip_honour_4	text_rejected	true
random_localisation_strings_string_faction_leader_tooltip_honour_6	text_rejected	true
random_localisation_strings_string_faction_leader_tooltip_honour_1	text_rejected	true
random_localisation_strings_string_faction_leader_tooltip_honour_3	text_rejected	true
random_localisation_strings_string_faction_leader_tooltip_honour_2	text_rejected	true
random_localisation_strings_string_network_error_host_disconnected	Адміністратор вийшов з гри.	true
random_localisation_strings_string_mission_reward_grant_unit	Дає загін:	true
random_localisation_strings_string_gfx_filtering_tri	Трилінійна	true
random_localisation_strings_string_character_situation_entertaining_nobles	Розваги аристократії	true
random_localisation_strings_string_opponent_demands_surrender_title	Вимагають здатися	true
random_localisation_strings_string_wealth_category_4	Середні	true
random_localisation_strings_string_wealth_category_5	Бідні	true
random_localisation_strings_string_REGION_FOOD_FACTOR_RAIDING	Наліт	true
random_localisation_strings_string_wealth_category_6	Злиденні	true
random_localisation_strings_string_wealth_category_1	Найбагатші	true
random_localisation_strings_string_wealth_category_2	Багаті	true
random_localisation_strings_string_wealth_category_3	Заможні	true
random_localisation_strings_string_cannot_recruit_insufficient_funds	У вас недостатньо коштів, щоб набрати цей загін.	true
random_localisation_strings_string_player_stats_campaign_naval_battles_lost	Програно битв на морі (в кампанії)	true
random_localisation_strings_string_battle_defeat_minor_close	Випадкова поразка||Перемога вислизнула від вас. Ворог святкує перемогу, але вона далася йому нелегко.	true
random_localisation_strings_string_setup_error_title	text_rejected	true
random_localisation_strings_string_stats_clan_current_clan_members	text_rejected	true
random_localisation_strings_string_diplomacy_button_need_alliance_to_request_alliance	Немає союзів, які можна розірвати.	true
random_localisation_strings_string_unit_concerned_extended_casualties	Нещодавно зазнали втрат	true
random_localisation_strings_string_player_stats_most_men_lost	Макс. втрати в бою	true
random_localisation_strings_string_StratHudbutton_Cannot_Embark/Disembark0	Неможливо здійснити посадку чи висадку	true
random_localisation_strings_string_StratHudbutton_Cannot_Embark/Disembark1	До цієї землі неможливо дістатися.	true
random_localisation_strings_string_StratHudbutton_Cannot_Embark/Disembark2	Цей флот занадто далеко від берега або порту.	true
random_localisation_strings_string_tacmap_inactive_filter_expedition	Недоступно для експедиції.	true
random_localisation_strings_string_character_details_rank_5	Поточний ранг: 5 (макс. - 6)||Ранг персонажа показує загальний рівень його умінь і відображається зірками.||Ранг підвищується з досвідом. З кожним новим рівнем персонаж може отримувати додаткові вміння.	true
random_localisation_strings_string_character_details_rank_4	Поточний ранг: 4 (макс. - 6)||Ранг персонажа показує загальний рівень його умінь і відображається зірками.||Ранг підвищується з досвідом. З кожним новим рівнем персонаж може отримувати додаткові вміння.	true
random_localisation_strings_string_character_details_rank_6	Поточний ранг: 6 (максимальний)||Ранг персонажа показує загальний рівень його умінь і відображається зірками.||Ранг підвищується з досвідом. З кожним новим рівнем персонаж може отримувати додаткові вміння.	true
random_localisation_strings_string_character_details_rank_1	Поточний ранг: 1 (макс. - 6)||Ранг персонажа показує загальний рівень його вмінь і відображається зірками.||Ранг підвищується з досвідом. З кожним новим рівнем персонаж може отримувати додаткові вміння.	true
random_localisation_strings_string_character_details_rank_3	Поточний ранг: 3 (макс. - 6)||Ранг персонажа показує загальний рівень його умінь і відображається зірками.||Ранг підвищується з досвідом. З кожним новим рівнем персонаж може отримувати додаткові вміння.	true
random_localisation_strings_string_character_details_rank_2	Поточний ранг: 2 (макс. - 6)||Ранг персонажа показує загальний рівень його вмінь і відображається зірками.||Ранг підвищується з досвідом. З кожним новим рівнем персонаж може отримувати додаткові вміння.	true
random_localisation_strings_string_campaign_type_long	Тривала кампанія	true
random_localisation_strings_string_network_message_confirm_quit_host	Ви дійсно хочете вийти? Гра завершиться для всіх.	true
random_localisation_strings_string_StratHudbutton_Naval_Repair_Not_Required	Обраним кораблям ремонт не потрібен.	true
random_localisation_strings_string_finance_header_diplomacy	Дипломатія	true
random_localisation_strings_string_mp_ready_error_ai_no_siege_units	У ШІ повинні бути піхотні загони або далекобійні машини, здатні штурмувати укріплення.	true
random_localisation_strings_string_finances_tribute_income_breakdown_faction	%S (залишилося ходів: %d)	true
random_localisation_strings_string_time_hours	год	true
random_localisation_strings_string_player_stats_enemy_generals_killed	Вбито ворожих полководців	true
random_localisation_strings_string_unit_stat_bonus_charge_exceptional	Ідеальний натиск	true
random_localisation_strings_string_conversion_factor_state_religion_christian	text_rejected	true
random_localisation_strings_string_diplomacy_button_need_war_to_request_peace	text_rejected	true
random_localisation_strings_string_battle_victory_major_close	Важка перемога||Опинившись на межі поразки, ви зуміли вирвати перемогу з рук ворога! Ваш ворог розбитий!	true
random_localisation_strings_string_MILITARY_FORCE_FOOD_FACTOR_RIVALRY	Внутрішні чвари	true
random_localisation_strings_string_round_id_september	Вересень	true
random_localisation_strings_string_TechTree_Tech_Unavailable_Function_Tooltip	Недоступно. Ви не дотрималися умов будівництва або не маєте необхідних технологій.	true
random_localisation_strings_string_campaign_radar_sort_by_speciality	За спеціалізацією	true
random_localisation_strings_string_stats_clan_clan_total_ranked_game_losses	text_rejected	true
random_localisation_strings_string_StratHudbutton_demolish	Знесення будівлі	true
random_localisation_strings_string_audio_provider_5_1	5.1, дискретн.	true
random_localisation_strings_string_audio_provider_6_1	6.1, дискретн.	true
random_localisation_strings_string_audio_provider_7_1	7.1, дискретн.	true
random_localisation_strings_string_audio_provider_8_1	8.1, дискретн.	true
random_localisation_strings_string_audio_provider_4_0	4.0, дискретн.	true
random_localisation_strings_string_character_situation_land_amphibious_attack	Прибережні битви	true
random_localisation_strings_string_player_stats_generals_lost	Втрачено полководців	true
random_localisation_strings_string_unit_concerned_fatigue_very_tired	Дуже втомилися	true
random_localisation_strings_string_auto_save_filename	auto_save	true
random_localisation_strings_string_FACTION_FOOD_FACTOR_RECENT_BATTLES	Наслідки битв	true
random_localisation_strings_string_cannot_build_tech_required	Щоб побудувати будівлю, необхідно дослідити вказану технологію.	true
random_localisation_strings_string_effect_bundle_target_local	Провінція:	true
random_localisation_strings_string_round_id_early_november	Початок листопада	true
random_localisation_strings_string_unit_concerned_surprised	Здивовані появою ворога	true
random_localisation_strings_string_player_stat_battles_lost	Битв програно	true
random_localisation_strings_string_technology_tooltip_stealing_functionality	ЛКМ - спробувати вкрасти; ПКМ - дізнатися більше	true
random_localisation_strings_string_ability_phase_mask_poison	Отрута	true
random_localisation_strings_string_fe_unit_card_tooltip_no_dupe_naval	ЛКМ - вибрати \\nПодвійний клік ЛКМ - видалити||Картки кораблів можна переміщати в межах флоту.	true
random_localisation_strings_string_predicted_with_units_added	- якщо вибрані загони будуть відправлені в гарнізон	true
random_localisation_strings_string_captive_option_title_kill	Вбити полонених	true
random_localisation_strings_string_victory_conditions_mp_co_op_long	Разом із союзником по спільній грі захопіть і утримуйте не менше %n провінцій, серед яких повинні бути вказані провінції.	true
random_localisation_strings_string_technology_status_available_no_researcher	text_rejected	true
random_localisation_strings_string_fe_unit_card_tooltip_land	ЛКМ - вибрати \\nПодвійний клік ЛКМ - видалити\\nПКМ - інформація||Картки загонів можна переміщати в межах армії.	true
random_localisation_strings_string_character_situation_subterfuge_sabotage_building	Диверсія в будівлі	true
random_localisation_strings_string_religion_factor_in_decline	У занепаді	true
random_localisation_strings_string_religion_factor_increasing	Зростає	true
random_localisation_strings_string_unit_stat_bonus_morale_exceptional	Ідеальний бойовий дух	true
random_localisation_strings_string_agent_help_string_request_allegiance_major_faction	text_rejected	true
random_localisation_strings_string_character_situation_entertaining_generals	Розважання полководців	true
random_localisation_strings_string_gdp_poor_fertility_bonus	Особливість фракції	true
random_localisation_strings_string_battle_defeat_major_close	Випадкова поразка||Горе, горе! Ворог переміг вас, але ви доблесно билися і були близькі до перемоги.	true
random_localisation_strings_string_at_peace	Мир	true
random_localisation_strings_string_unit_stat_bonus_accuracy_improved	Добра влучність	true
random_localisation_strings_string_character_situation_land_ambush	Засідки	true
random_localisation_strings_string_morale_shattered	Розбиті	true
random_localisation_strings_string_stat_can_target_buildings	Може пошкоджувати споруди	true
random_localisation_strings_string_diplomacy_button_need_peace_to_request_war	text_rejected	true
random_localisation_strings_string_character_situation_subterfuge_field_scout	Розвідка	true
random_localisation_strings_string_dlc_purchase_body	Дякуємо вам. Щоб завантажити та використовувати нові матеріали, перезапустіть гру Total War: ATTILA.	true
random_localisation_strings_string_fe_unit_card_tooltip_minimal_land	ЛКМ - вибрати\\nПКМ - дізнатися більше||Картки можна переміщати в межах армії.	true
random_localisation_strings_string_round_id_early_february	Початок лютого	true
random_localisation_strings_string_network_error_join_failed_game_not_found	Не вдалося приєднатися до гри: гра не знайдена	true
random_localisation_strings_string_stat_base_value	Базове значення	true
random_localisation_strings_string_character_type_title_son	Син	true
random_localisation_strings_string_player_stats_best_streak	Краща серія	true
random_localisation_strings_string_skill_next_level	Наступний рівень:	true
random_localisation_strings_string_morale_impetuous	Нестримні	true
random_localisation_strings_string_region_specialty_holy_site	text_rejected	true
random_localisation_strings_string_stats_clan_land_ranked_games_won	text_rejected	true
random_localisation_strings_string_win_chance_high	Високий	true
random_localisation_strings_string_trade_route_state_player	(Ваш)	true
random_localisation_strings_string_StratHudbutton_cannot_repairShip_noport	Ремонт неможливий||Ремонтувати кораблі можна тільки в порту.	true
random_localisation_strings_string_network_message_player_left_end	покидає гру. Гра зараз завершиться.	true
random_localisation_strings_string_finance_header_military	Армія	true
random_localisation_strings_string_trade_route_tooltip_local_neutral	(спільні з іншими державами)	true
random_localisation_strings_string_gfx_med	Середн.	true
random_localisation_strings_string_Campaign_button_end_turn_spring	Весна	true
random_localisation_strings_string_nav_not_in_combat	Не в бою	true
random_localisation_strings_string_date_bc	р. до н.е.	true
random_localisation_strings_string_food_consumption	Споживання	true
random_localisation_strings_string_MILITARY_FORCE_FOOD_FACTOR_UNITS	Війська	true
random_localisation_strings_string_recruitment_tab	Найм	true
random_localisation_strings_string_mk_dif_teu	[[col:red]]Висок.[[/col]], реліг. заворушення	true
random_localisation_strings_string_mk_dif_jer	[[col:dark_r]]Дуж. висок.[[/col]], могутній ворог	true
random_localisation_strings_string_mk_dif_ser	[[col:red]]Висок.[[/col]], сильні сусідні фракції	true
random_localisation_strings_string_mk_dif_den	[[col:green]]Низьк.[[/col]], сильна дипломатія	true
random_localisation_strings_string_mk_dif_gen	[[col:green]]Низьк.[[/col]], сильна дипломатія	true
random_localisation_strings_string_mk_dif_ven	[[col:green]]Низьк.[[/col]], сильна дипломатія	true
random_localisation_strings_string_mk_dif_zen	[[col:yellow]]Середн.[[/col]]	true
random_localisation_strings_string_mk_dif_geo	[[col:green]]Низьк.[[/col]], велика територія	true
random_localisation_strings_string_network_message_player_dropped_end	покидає гру. Зараз гра буде завершена.	true
random_localisation_strings_string_land_combatant_losing_big	Загін зазнає поразки	true
random_localisation_strings_string_warning_graphics_upgrade	Деякі зміни не можуть бути застосовані до початку нової кампанії або битви. Продовжити?	true
random_localisation_strings_string_Enlightenment_Bar	text_rejected	true
random_localisation_strings_string_hudbutton_studying_turns_until_completion	Ходів до завершення:	true
random_localisation_strings_string_cancel_recruitment_confirmation	Даний загін зараз набирає бійців. Ви впевнені, що хочете скасувати найм?	true
random_localisation_strings_string_trade_route_tooltip_local_enemy	(загальні з противником)	true
random_localisation_strings_string_defender	Захисник	true
random_localisation_strings_string_multiplayer_play_battle	Участь	true
random_localisation_strings_string_ability_release_animals	Випустити звірів||Наказ випустити бойових тварин. Це буде зроблено тільки тоді, коли ви наблизитеся до противника: звірі нападуть на найближчий до них загін.	true
random_localisation_strings_string_stat_base_damage	Базова шкода	true
random_localisation_strings_string_ability_naval_fire_at_will	Почати/припинити стрільбу||Отримавши наказ припинити стрільбу, корабель припинить обстріл і не буде стріляти, поки ви не натиснете цю кнопку ще раз.	true
random_localisation_strings_string_Naval_Bar	Флот	true
random_localisation_strings_string_adjecency_points	сусідні точки	true
random_localisation_strings_string_trade_status_tooltip_can	Може торгувати	true
random_localisation_strings_string_queued_building_blocked_by_stance	Щоб завершити будівництво, орді потрібно повернутися в осілий стан. ЛКМ - скасувати будівництво, ПКМ - дізнатися більше.	true
random_localisation_strings_string_undecided	Все одно	true
random_localisation_strings_string_stats_clan_current_clan_map_rank	text_rejected	true
random_localisation_strings_string_morning	Ранок	true
random_localisation_strings_string_file_load_failed	Завантаження не вдалося	true
random_localisation_strings_string_error_chat_room_connection_failure	Помилка чату||Неможливо підключитися до кімнати чату.	true
random_localisation_strings_string_campaign_autoresolver_tooltip_stance_land_balanced	Цей режим не дає вашим військам ні переваг, ні штрафів.	true
random_localisation_strings_string_character_situation_land_defence	Захист в наземних битвах	true
random_localisation_strings_string_trade_route_state_shared	(Загальний)	true
random_localisation_strings_string_army_trapped_in_enemy_ZOC	Цей загін опинився у ворожій зоні контролю і не може рухатися. Йому залишається тільки напасти на ворога.	true
random_localisation_strings_string_FACTION_PROVINCE_FOOD_FACTOR_BUILDINGS_IN_REGIONS	Будівлі	true
random_localisation_strings_string_event_log_battle_victory_heroic_crushing	Героїчна перемога	true
random_localisation_strings_string_agent_recruitment_insufficient_dev_points	[[col:red]]У вас недостатньо надлишків населення для створення нової орди.[[/col]]	true
random_localisation_strings_string_gfx_off	Вимк.	true
random_localisation_strings_string_predicted	Прогноз	true
random_localisation_strings_string_importing	Імпорт	true
random_localisation_strings_string_capital	Столиця фракції	true
random_localisation_strings_string_exporting	Експорт	true
random_localisation_strings_string_date_ad	рік	true
random_localisation_strings_string_delayed	З затримкою	true
random_localisation_strings_string_StratHudButton_Cannot_Recruit_Unit11	Немає очок набору військ	true
random_localisation_strings_string_StratHudbutton_Cannot_Recruit_Unit10	У вас немає ресурсів, необхідних для найму цього загону.	true
random_localisation_strings_string_level_level_level_level	Рівень	true
random_localisation_strings_string_demo_battle_unavailable	У демо-версії ця можливість є тільки в ключових битвах. Виберіть автоматичний розрахунок битви.	true
random_localisation_strings_string_commerce_raiding	Нальоти на торгові шляхи:	true
random_localisation_strings_string_unit_encouraged_inspired_by_unit_ability	Натхнені вміннями	true
random_localisation_strings_string_player_stats_battles_drawn	Битв закінчилося внічию	true
random_localisation_strings_string_Cannot_reinforce_artillery	Облогові машини не можна вводити в бій в якості підкріплення	true
random_localisation_strings_string_mission_issued_research_technology	Дослідити технологію:	true
random_localisation_strings_string_increasing	Покращується	true
random_localisation_strings_string_maximum_permitted_amount_of_this_unit_type_reached	Досягнуто макс. можлива чисельність для загону цього типу	true
random_localisation_strings_string_trade_agreement_tooltip_sea_routes	Морський торговий шлях з'єднає дві ваші столиці.	true
random_localisation_strings_string_trade_lost	Не продається в інші країни. Покращіть порти, щоб отримувати більше грошей, експортуючи ці товари.	true
random_localisation_strings_string_trade_post	Торговий пост	true
random_localisation_strings_string_Unit_Card_Generic_Function	ЛКМ - вибрати; ПКМ - дізнатися більше	true
random_localisation_strings_string_postbattle_money_gained	Отримано грошей	true
random_localisation_strings_string_network_error_internal_controller_disconnection	Сталося відключення від мережевої служби	true
random_localisation_strings_string_agent_help_string_bribe_capital	text_rejected	true
random_localisation_strings_string_Cancelled	Скасування	true
random_localisation_strings_string_gunners	text_rejected	true
random_localisation_strings_string_unit_card_lost_general_disbanded	Полководець був убитий, його військо розпущено.	true
random_localisation_strings_string_error_chat_command_failed	Некоректна команда чату	true
random_localisation_strings_string_trade_agreement_tooltip_embargoed	Ембарго заважає укладенню торговельної угоди	true
random_localisation_strings_string_December	text_rejected	true
random_localisation_strings_string_siege_tab	Облога	true
random_localisation_strings_string_skills_num_points	оч. в умінні	true
random_localisation_strings_string_blockaded	У блокаді	true
random_localisation_strings_string_character_situation_cunning_bribe	Хабарництво	true
random_localisation_strings_string_mk_dif_lat	[[col:dark_r]]Дуж. висок.[[/col]], ворож. сусід. фракції	true
random_localisation_strings_string_mk_dif_mar	[[col:yellow]]Середн.[[/col]], в міграції	true
random_localisation_strings_string_mk_dif_cas	[[col:green]]Низьк.[[/col]], сильна дипломатія	true
random_localisation_strings_string_prebattle_reinforcing_army	Посилює військо	true
random_localisation_strings_string_mk_dif_haf	[[col:yellow]]Середн.[[/col]], васал. держава	true
random_localisation_strings_string_mk_dif_zag	[[col:red]]Висок.[[/col]], в ізоляції	true
random_localisation_strings_string_mk_dif_wal	[[col:dark_r]]Дуж. висок.[[/col]], васал. держава	true
random_localisation_strings_string_mk_dif_mak	[[col:red]]Висок.[[/col]], в ізоляції	true
random_localisation_strings_string_technology_status_being_researched	text_rejected	true
random_localisation_strings_string_network_error_host	Не вдалося створити гру	true
random_localisation_strings_string_agent_help_string_high_opposing_religion	text_rejected	true
random_localisation_strings_string_unit_encouraged_inspired	Натхненні сусіднім загоном	true
random_localisation_strings_string_agent_help_string_high_security_building	Ця будівля дуже добре захищена, в ній складно влаштувати диверсію.	true
random_localisation_strings_string_network_message_no_clients_left	Гравець покинув гру	true
random_localisation_strings_string_multiplayer_autoresolve	Авторозрахунок	true
random_localisation_strings_string_desolate	Закинуто	true
random_localisation_strings_string_battle_invalid_ship_docking_point	Сюди вже прямує інший корабель. Вкажіть нове місце висадки.	true
random_localisation_strings_string_October	text_rejected	true
random_localisation_strings_string_Scupper	Затопити||Затопити непотрібні кораблі, щоб заощадити на їх утриманні.	true
random_localisation_strings_string_building_construction_blocked_by_character	Розширення неможливе. Переконайтеся, що в попередній комірці є не зруйнована споруда, а поблизу немає персонажів, що перешкоджають розширенню.	true
random_localisation_strings_string_end_migration_tooltip_expedition	Якщо ви окупуєте це поселення, ваша експедиція завершиться.	true
random_localisation_strings_string_mp_ready_error_battle_type_desync	Вибраний тип битви не відповідає даній мапі.	true
random_localisation_strings_string_mission_reward_prestige	Репутація	true
random_localisation_strings_string_mission_reward_naval_experience	Досвід для всіх кораблів флоту	true
random_localisation_strings_string_attacker_direction_east	Схід	true
random_localisation_strings_string_attacker_direction_west	Захід	true
random_localisation_strings_string_character_situation_zeal_demoralise_army	Деморалізація військ	true
random_localisation_strings_string_unit_replacement_string	замінює	true
random_localisation_strings_string_food_production	Виробництво	true
random_localisation_strings_string_campaign_type_one_vs_one	Один на один	true
random_localisation_strings_string_destroy_transported_title	Розпуск загонів	true
random_localisation_strings_string_Classic	Наземна битва	true
random_localisation_strings_string_finance_header_recruitment	Найм	true
random_localisation_strings_string_player_stat_miles_covered_campaign	Миль подолано армією і флотом	true
random_localisation_strings_string_agent_recruitment_click_to_recruit	Клацніть ЛКМ, щоб найняти цього агента в даному поселенні.	true
random_localisation_strings_string_mk_dif_sco	[[col:yellow]]Середн.[[/col]], в ізоляції	true
random_localisation_strings_string_diplomacy_button_cannot_request_join_war_warring_a	text_rejected	true
random_localisation_strings_string_pre-battle_multiplayer_undecided	Все одно	true
random_localisation_strings_string_ability_board_ship	Почати абордаж	true
random_localisation_strings_string_fe_unit_card_tooltip_no_dupe_land	ЛКМ - вибрати \\nПодвійне клацання ЛКМ - видалити||Картки загонів можна переміщати в межах армії.	true
random_localisation_strings_string_resource_importing_from	Імпорт з:	true
random_localisation_strings_string_opponent_accepts_surrender_body	Загін захисників погодився здатися на вашу вимогу.	true
random_localisation_strings_string_agent_help_string_family_member	Ваша мета - член добре охоронюваної сім'ї, вбити його буде нелегко.	true
random_localisation_strings_string_neutral	Нейтр.	true
random_localisation_strings_string_Married	text_rejected	true
random_localisation_strings_string_imperium	Імперіум	true
random_localisation_strings_string_damaged	Пошкоджено	true
random_localisation_strings_string_retreat	Відступити	true
random_localisation_strings_string_marines	text_rejected	true
random_localisation_strings_string_manoeuverability_medium	Середн.	true
random_localisation_strings_string_mk_dif_abb	[[col:yellow]]Середн.[[/col]], сильна дипломатія	true
random_localisation_strings_string_stats_clan_current_highest_ranked_solo_clan_mbr_na	text_rejected	true
random_localisation_strings_string_audio_provider_srs_circle_surround	SRS Circle	true
random_localisation_strings_string_mission_reward_enable_unit	Дозволяє найм:	true
random_localisation_strings_string_ability_skirmish	Режим перестрілки||У режимі перестрілки загін буде триматися на безпечній відстані від ворога. Цю тактику можна використовувати для уповільнення наступаючого ворога або відволікання конкретних загонів. Застрельники при цьому вразливі для натиску кінноти.	true
random_localisation_strings_string_chat_prefix_team	[команді]	true
random_localisation_strings_string_Construction_site	Будівельний майданчик	true
random_localisation_strings_string_trade_route_tooltip_enemy	(ворог)	true
random_localisation_strings_string_afternoon	Друга половина дня	true
random_localisation_strings_string_abandon_tooltip	Клацніть тут, щоб покинути це поселення на наступному ході.\\n\\n[[col:green]]Ви отримаєте дохід: %d.[[/col]]\\n\\n[[col:red]]Погіршиться громадський порядок у провінціях вашої фракції.[[/col]]	true
random_localisation_strings_string_effect_bundle_from_event	Подія:	true
random_localisation_strings_string_fe_recruitment_card_tooltip_land	ЛКМ - вибрати\\nПКМ - дізнатися більше\\nДля додавання двічі клацніть ЛКМ або перетягніть картку на військо.	true
random_localisation_strings_string_mp_ready_error_overspend	Не можна почати гру - гравець витратив занадто багато на склад війська.	true
random_localisation_strings_string_producing	Виробництво	true
random_localisation_strings_string_error_leaderboard_search	text_rejected	true
random_localisation_strings_string_advisor	Радник	true
random_localisation_strings_string_confirm_delete_msg	Ця дія призведе до видалення всіх вибраних файлів. Ви впевнені?	true
random_localisation_strings_string_stance_food_stolen	Їжі викрадено: %n із спожитої	true
random_localisation_strings_string_action_result_type_success	Успіх	true
random_localisation_strings_string_trade_status_tooltip_value	Поточна ціна:	true
random_localisation_strings_string_win_chance_none	Нікчемний	true
random_localisation_strings_string_REGION_FOOD_FACTOR_RECENT_BATTLE	Наслідки битв	true
random_localisation_strings_string_StratHudbutton_cannot_enlist_full	Неможливо найняти полководця||У вас уже максимальна кількість полководців.	true
random_localisation_strings_string_sanitation	Санітарія	true
random_localisation_strings_string_mk_dif_fla	[[col:red]]Висок.[[/col]]	true
random_localisation_strings_string_famous_battle_victory_over	Перемога над:	true
random_localisation_strings_string_mk_dif_alm	[[col:red]]Висок.[[/col]], числ. вороги	true
random_localisation_strings_string_mk_dif_ilk	[[col:yellow]]Середн.[[/col]], кочівники	true
random_localisation_strings_string_campaign_ministers_effectiveness_effect	Рівень управління священнослужителів: %+n	true
random_localisation_strings_string_FACTION_PROVINCE_FOOD_FACTOR_POOR_FERTILITY_BONUS	Особливість фракції	true
random_localisation_strings_string_player_stats_campaigns_completed	Кампаній пройдено	true
random_localisation_strings_string_mission_issued_make_peace	Укласти мир:	true
random_localisation_strings_string_recruitment_unavailable	Цей загін недоступний з наступних причин:	true
random_localisation_strings_string_trade_node_tooltip_supply_to_you	доставлено до вашої столиці	true
random_localisation_strings_string_gfx_low	Низьк.	true
random_localisation_strings_string_mk_dif_tou	[[col:red]]Висок.[[/col]], Альбіг. хрест. похід	true
random_localisation_strings_string_mk_dif_lor	[[col:yellow]]Середн.[[/col]]	true
random_localisation_strings_string_mk_dif_nor	[[col:yellow]]Середн.[[/col]], в міграції	true
random_localisation_strings_string_mk_dif_por	[[col:green]]Низьк.[[/col]], сильна дипломатія	true
random_localisation_strings_string_gfx_custom	На вибір	true
random_localisation_strings_string_mk_dif_gol	[[col:yellow]]Середн.[[/col]], кочівники	true
random_localisation_strings_string_mk_dif_pol	[[col:yellow]]Середн.[[/col]]	true
random_localisation_strings_string_mk_dif_vol	[[col:red]]Висок.[[/col]], монгол. вторгнення	true
random_localisation_strings_string_mk_dif_boh	[[col:yellow]]Середн.[[/col]]	true
random_localisation_strings_string_right_click_info	ПКМ - дізнатися більше	true
random_localisation_strings_string_ping_none	Немає маркера	true
random_localisation_strings_string_finance_header_expenses	Витрати	true
random_localisation_strings_string_morale_fighting_to_death	Б'ються до смерті	true
random_localisation_strings_string_REGION_FOOD_FACTOR_HORDES	Орди в цьому регіоні	true
random_localisation_strings_string_allied_mencount	Чисельність союзників	true
random_localisation_strings_string_captive_option_description_kill	Нікого не щадити! Вбийте всіх до останнього - це вгамує спрагу крові ваших воїнів, але ворог і його союзники надовго запам'ятають те, що сталося.\\n\\nВтім, вороги ваших ворогів неодмінно оцінять такий крок.	true
random_localisation_strings_string_finances_commerce_raiding_income	Від нальотів на торгові шляхи	true
random_localisation_strings_string_region_specialty_philosophical_tradition	text_rejected	true
random_localisation_strings_string_Campaign_button_end_turn_summer	Літо	true
random_localisation_strings_string_tile_upgrade_none	Ні	true
random_localisation_strings_string_town_commercial	Поселення (торговий центр)	true
random_localisation_strings_string_mk_dif_ant	[[col:dark_r]]Дуж. висок.[[/col]], могутній ворог	true
random_localisation_strings_string_mk_dif_eng	[[col:dark_g]]Дуж. низьк.[[/col]], острів. гегемон	true
random_localisation_strings_string_campaign_type_co_op_long	Тривала спільна гра	true
random_localisation_strings_string_quick_battle_fail	Не вдалося підключитися до швидкого бою	true
random_localisation_strings_string_region_specialty_horses	text_rejected	true
random_localisation_strings_string_damaged_building	Пошкоджена споруда||Поки споруда пошкоджена, всі її ефекти ослаблені, крім того, її не можна покращувати. Сама по собі споруда відновлюється повільно, зате безкоштовно. Щоб витратити гроші і відремонтувати її за один хід, скористайтеся відповідною кнопкою вгорі.	true
random_localisation_strings_string_FACTION_PROVINCE_FOOD_FACTOR_TECHNOLOGIES	Технології	true
random_localisation_strings_string_FACTION_PROVINCE_FOOD_FACTOR_CHARACTERS	Персонажі	true
random_localisation_strings_string_finances_tribute_income	text_rejected	true
random_localisation_strings_string_formatted_minutes_plural	%d хв.	true
random_localisation_strings_string_mk_dif_lit	[[col:red]]Висок.[[/col]], язичники	true
random_localisation_strings_string_stats_clan_current_highest_ranked_solo_clan_member	text_rejected	true
random_localisation_strings_string_mk_dif_pis	[[col:green]]Низьк.[[/col]], сильна дипломатія	true
random_localisation_strings_string_mk_dif_kie	[[col:yellow]]Середн.[[/col]]	true
random_localisation_strings_string_mk_dif_nic	[[col:yellow]]Середн.[[/col]], ворож. сусід. фракції	true
random_localisation_strings_string_mk_dif_sic	[[col:yellow]]Середн.[[/col]]	true
random_localisation_strings_string_mission_objectives	Мета:	true
random_localisation_strings_string_mk_dif_mil	[[col:yellow]]Середн.[[/col]]	true
random_localisation_strings_string_mouse_over	Під курсором	true
random_localisation_strings_string_victory_conditions_mp_co_op_short	Разом із союзником по спільній грі захопіть і утримуйте не менше %n провінцій, серед яких обов'язково повинні бути зазначені.	true
random_localisation_strings_string_StratHudbutton_Naval_Repair_No_Selection	Виберіть пошкоджені кораблі, щоб їх відремонтувати.	true
random_localisation_strings_string_military_force_legacy_name_garrison_army	Армія в гарнізоні	true
random_localisation_strings_string_influence	Вплив:	true
random_localisation_strings_string_round_id_january	Січень	true
random_localisation_strings_string_StratHudbutton_cannot_navy_repair_nocash	Ремонт неможливий||У вас недостатньо коштів.||Розпустіть непотрібні війська або підвищіть податки, щоб збільшити дохід.	true
random_localisation_strings_string_mk_dif_khw	[[col:red]]Висок.[[/col]], монгол. вторгнення	true
random_localisation_strings_string_mk_dif_ghu	[[col:red]]Висок.[[/col]], в ізоляції	true
random_localisation_strings_string_military_force_legacy_name_transport_fleet	Вантажний флот	true
random_localisation_strings_string_quick_save	Швидке збереження	true
random_localisation_strings_string_round_id_december	Грудень	true
random_localisation_strings_string_function_construction_hud	ЛКМ - вибрати; ПКМ - дізнатися більше	true
random_localisation_strings_string_recruitment_from	Цей загін можна найняти в:	true
random_localisation_strings_string_network_error_join_failed_error	Не вдалося приєднатися до гри: невизначена помилка	true
random_localisation_strings_string_save_fail	Не вдалося зберегти гру	true
random_localisation_strings_string_upload_complete	Завантаження завершено	true
random_localisation_strings_string_army_tab	Армія	true
random_localisation_strings_string_whisper	Особисте повідомлення	true
random_localisation_strings_string_unlimited	Необмеж.	true
random_localisation_strings_string_cancel_recruitment_header	Скасувати найм	true
random_localisation_strings_string_will_lose_at_end	Якщо час закінчиться, ви програєте	true
random_localisation_strings_string_Children	Діти:	true
random_localisation_strings_string_fe_recruitment_card_tooltip_naval	ЛКМ - вибрати\\nПКМ - дізнатися більше\\nДля додавання двічі клацніть ЛКМ або перетягніть картку на флот.	true
random_localisation_strings_string_decreasing	Погіршується	true
random_localisation_strings_string_load_fail	Завантаження не вдалося	true
random_localisation_strings_string_character_situation_cunning_oversee_army	Спостереження за армією	true
random_localisation_strings_string_skills_requires	Необхідно	true
random_localisation_strings_string_ability_dismount	Злізти з коня/сісти верхи||Якщо ваші вершники збираються атакувати списоносців, їм краще злізти з коня.	true
random_localisation_strings_string_region_specialty_smithing	text_rejected	true
random_localisation_strings_string_Campaign_button_end_turn_winter	Зима	true
random_localisation_strings_string_technology_tooltip_stealing_numeric_info	Шанс на успіх:	true
random_localisation_strings_string_dlc_menu_button_offline	Ви повинні бути в мережі, щоб побачити набори матеріалів.	true
random_localisation_strings_string_diplomacy_button_other_clan_no_alliances_to_break	text_rejected	true
random_localisation_strings_string_limited	Обмеж.	true
random_localisation_strings_string_player_stats_ships_lost	Втрачено кораблів	true
random_localisation_strings_string_agent_help_string_request_allegiance_own_religion	text_rejected	true
random_localisation_strings_string_infrastructure_tab	Інфраструктура	true
random_localisation_strings_string_land_not_in_combat	Не в бою	true
random_localisation_strings_string_no	Немає	true
random_localisation_strings_string_stance_food_consumption	Спожито продовольства: %n із запасів регіону	true
random_localisation_strings_string_agent_cannot_act_settlement_full	Кількість агентів у цьому поселенні вже досягла максимуму.	true
random_localisation_strings_string_network_message_desynch	Сталася помилка синхронізації. Гра завершується.	true
random_localisation_strings_string_January	text_rejected	true
random_localisation_strings_string_recharge_change	Час відновлення вміння	true
random_localisation_strings_string_ability_abandon_artillery_engines	Кинути облогові машини||Наказ загону кинути облогові машини.	true
random_localisation_strings_string_famous_battle_defeated_by	Поразка від:	true
random_localisation_strings_string_mk_dif_bur	[[col:red]]Висок.[[/col]], васал. держава	true
random_localisation_strings_string_mk_dif_aus	[[col:yellow]]Середн.[[/col]], сильна дипломатія	true
random_localisation_strings_string_captive_option_description_enslave	Прийнявши цих добровольців, ви поповните ряди своїх військ.\\n\\nВрахуйте, що їх недосвідченість позначиться на вміннях вашої армії.	true
random_localisation_strings_string_technology_bonuses_tooltip	Швидкість досліджень:	true
random_localisation_strings_string_technology_status_unavailable_tech	text_rejected	true
random_localisation_strings_string_mk_dif_hun	[[col:green]]Низьк.[[/col]], сильна дипломатія	true
random_localisation_strings_string_mk_dif_bul	[[col:yellow]]Середн.[[/col]]	true
random_localisation_strings_string_mk_dif_cum	[[col:dark_r]]Дуж. висок.[[/col]], монгол. вторгнення	true
random_localisation_strings_string_mk_dif_rum	[[col:red]]Висок.[[/col]], реліг. заворушення	true
random_localisation_strings_string_agent_help_string_incite_rebels	Неможливо підбурювати до бунту в повсталій провінції.	true
random_localisation_strings_string_unit_concerned_casualties	Зазнали втрат	true
random_localisation_strings_string_morale_wavering	Коливаються	true
random_localisation_strings_string_error_clan_search	text_rejected	true
random_localisation_strings_string_round_id_late_september	Кінець вересня	true
random_localisation_strings_string_Campaign_button_end_turn_autumn	Осінь	true
random_localisation_strings_string_November	text_rejected	true
random_localisation_strings_string_expedition_occupy	Оголосити незалежність||Захоплення цього поселення означатиме проголошення незалежності від Римської імперії!	true
random_localisation_strings_string_researcher_tooltip	Клацніть ЛКМ, щоб зробити вибір. Потім клацніть ЛКМ на доступній технології, щоб почати дослідження.	true
random_localisation_strings_string_battle_defeat_minor_heroic	Розгромна поразка||Лише ганьбою і безчестям запам'ятається цей день. Ви були наголову розбиті.	true
random_localisation_strings_string_recruitment_travel_time	Набраний загін приєднається до армії за наступну кількість ходів:	true
random_localisation_strings_string_recruitment_cost	Ціна найму	true
random_localisation_strings_string_region_specialty_artisans	text_rejected	true
random_localisation_strings_string_event_log_battle_victory_major_decisive	Рішуча перемога	true
random_localisation_strings_string_sea_region_control_status_shared	Загальне	true
random_localisation_strings_string_graphics_settings_require_restart	Нові налаштування набудуть чинності після перезапуску гри.	true
random_localisation_strings_string_Fixed_Artillery_Cannot_Reinforce	Нерухомі далекобійні машини не можуть рухатися по полю бою. Як наслідок, їх не можна використовувати в якості підкріплення.	true
random_localisation_strings_string_trade_agreement_tooltip_neighbour	Наземний торговий шлях з'єднає дві ваші столиці.	true
random_localisation_strings_string_technology_entity_tooltip	text_rejected	true
random_localisation_strings_string_will_win_at_end	Якщо час закінчиться, ви переможете.	true
random_localisation_strings_string_resource	Ресурс	true
random_localisation_strings_string_February	text_rejected	true
random_localisation_strings_string_state_religion_change_inactive_not_enough_support	Зміна релігії неможлива: цю релігію сповідує занадто мала частина населення.\\n\\nНеобхідна чисельність:	true
random_localisation_strings_string_population_too_low	Занадто мала кількість населення	true
random_localisation_strings_string_mk_dif_swe	[[col:yellow]]Середн.[[/col]]	true
random_localisation_strings_string_units_upgrade_no_upgrade_available	Цей загін неможливо вдосконалити.	true
random_localisation_strings_string_mk_dif_swi	[[col:yellow]]Середн.[[/col]]	true
random_localisation_strings_string_StratHudButton_Cannot_Demolish0	Неможливо знести	true
random_localisation_strings_string_StratHudButton_Cannot_Demolish1	Не можна зносити поселення, порти і дороги, а також спеціальні будівлі базового рівня.	true
random_localisation_strings_string_unit_concerned_under_friendly_fire	Під обстрілом своїх	true
random_localisation_strings_string_character_role_son	Син	true
random_localisation_strings_string_gfx_aoit_on_intel	Прискор. Intel	true
random_localisation_strings_string_ping_move	Перемістіться сюди!	true
random_localisation_strings_string_mission_reward_treasury	Скарбниця	true
random_localisation_strings_string_September	Вересень	true
random_localisation_strings_string_cannot_recruit_queue_full	Список набору заповнений. Щоб поставити цей загін у чергу, доведеться щось видалити.	true
random_localisation_strings_string_outbreak_chance	Імовірність спалаху	true
random_localisation_strings_string_will_draw_at_end	Якщо час закінчиться, буде нічия	true
random_localisation_strings_string_attacker	Атакуючий	true
random_localisation_strings_string_player_stats_best_4v4_placement	Кращий штурм (4 на 4, наземний бій)	true
random_localisation_strings_string_player_stats_best_1v1_placement	Кращий штурм (1 на 1, наземний бій)	true
random_localisation_strings_string_player_stats_best_2v2_placement	Кращий штурм (2 на 2, наземний бій)	true
random_localisation_strings_string_player_stats_best_3v3_placement	Кращий штурм (3 на 3, наземний бій)	true
random_localisation_strings_string_player_stats_enemy_units_wiped_out	Макс. знищених загонів ворога	true
random_localisation_strings_string_gfx_downgraded_osx	УВАГА! Недостатньо відеопам'яті. Параметри графіки будуть знижені. Щоб продуктивність гри не знизилася, зменшіть якість відображення текстур.	true
random_localisation_strings_string_gfx_filtering_ani2x	Анізотр. 2x	true
random_localisation_strings_string_building_construction_requires_prereq_buildings	Для зведення цієї споруди потрібно, щоб в основній комірці поселення була одна з наступних споруд:[[col:yellow]]	true
random_localisation_strings_string_occupied_building	Зайнята будівля	true
random_localisation_strings_string_stats_clan_current_clan_map_regions_held	text_rejected	true
random_localisation_strings_string_network_message_host_left	Адміністратор вийшов з гри.	true
random_localisation_strings_string_tech_category_industrial	text_rejected	true
random_localisation_strings_string_copy_protection_message	text_rejected	true
random_localisation_strings_string_agent_recruitment_no_candidates	[[col:red]]Немає підхожих кандидатів в агенти.[[/col]]	true
random_localisation_strings_string_agent_help_cannot_sabotage_fully_damaged_building	Не можна влаштувати диверсію в зруйнованій будівлі.	true
random_localisation_strings_string_mission_penalty	Штраф:	true
random_localisation_strings_string_gatehouse	Вежа над воротами	true
random_localisation_strings_string_battlemap_regroup_position	Точка перегрупування	true
random_localisation_strings_string_network_error_join_failed_rejected	Не вдалося приєднатися до гри: сервер відхилив вашу заявку	true
random_localisation_strings_string_gfx_aa_16x16	16x	true
random_localisation_strings_string_trade_agreement_tooltip_no_borders	Порти вашої провінції повністю завантажені.||Налагодити новий морський шлях з вашої столиці неможливо.	true
random_localisation_strings_string_agent_help_string_seduce_faction_leader	text_rejected	true
random_localisation_strings_string_unit_concerned_fighting_cavalry	Боротьба з кіннотою	true
random_localisation_strings_string_character_situation_cunning_oversee_town	Спостереження за поселенням	true
random_localisation_strings_string_chat_intro_text	Наберіть /help, щоб побачити всі команди чату для вашої ігрової зони.	true
random_localisation_strings_string_friends	Друзі	true
random_localisation_strings_string_navy_tab	Флот	true
random_localisation_strings_string_legendary	Легенд.	true
random_localisation_strings_string_c_tooltip_vassal	Васальна держава	true
random_localisation_strings_string_resource_tariffs	Мита	true
random_localisation_strings_string_trade_route_tooltip_other_factions	Інше	true
random_localisation_strings_string_agents_tab	Агенти	true
random_localisation_strings_string_gfx_filtering_ani4x	Анізотр. 4x	true
random_localisation_strings_string_mk_dif_epi	[[col:red]]Висок.[[/col]], ворож. сусід. фракції	true
random_localisation_strings_string_battle_filter_clan	Кланові битви	true
random_localisation_strings_string_unit_concerned_enemy_controls_land	Ворог контролює сушу - потрібно висадитися!	true
random_localisation_strings_string_technology_not_yet_researched_for_this_unit_type	text_rejected	true
random_localisation_strings_string_military_force_legacy_name_garrison_navy	Гарнізонний флот	true
random_localisation_strings_string_pre-battle_multiplayer_spectate	Поспостерігати	true
random_localisation_strings_string_building_under_construction_damaged_cancel_repair	Скасувавши ремонт, ви залишите цю незавершену будівлю зламаною. Будівництво цієї будівлі не продовжиться, поки ви її не відремонтуєте.	true
random_localisation_strings_string_REGION_FOOD_FACTOR_EVENTS	Події	true
random_localisation_strings_string_Completed	Завершено	true
random_localisation_strings_string_gfx_shader_3_hi	Модель 3	true
random_localisation_strings_string_lclick_steal_tech	Клацніть ЛКМ, щоб спробувати вкрасти цю технологію.	true
random_localisation_strings_string_opponent_refuses_surrender_body	Захисники відмовилися здаватися вам.	true
random_localisation_strings_string_player_stat_battles_won	Перемог у боях	true
random_localisation_strings_string_construction_tab	Будівництво	true
random_localisation_strings_string_fatigue	втома	true
random_localisation_strings_string_predicted_income	Прогнозований дохід	true
random_localisation_strings_string_network_message_content_not_owned	Ви виключені з гри, оскільки адміністратор вибрав мапу, для якої у вас немає завантажених матеріалів.	true
random_localisation_strings_string_town_industrial	text_rejected	true
random_localisation_strings_string_art_active	ЛКМ - вивчити цю технологію.	true
random_localisation_strings_string_mk_dif_hre	[[col:red]]Висок.[[/col]], ворож. сусід. фракції	true
random_localisation_strings_string_mk_dif_tre	[[col:yellow]]Середн.[[/col]]	true
random_localisation_strings_string_cpu_player	ШІ %d	true
random_localisation_strings_string_mk_dif_ara	[[col:yellow]]Середн.[[/col]], сильна дипломатія	true
random_localisation_strings_string_mk_dif_bra	[[col:yellow]]Середн.[[/col]]	true
random_localisation_strings_string_mk_dif_fra	[[col:green]]Низьк.[[/col]], велика територія	true
random_localisation_strings_string_mk_dif_cro	[[col:red]]Висок.[[/col]], васал. держава	true
random_localisation_strings_string_one_minute	1 хв.	true
random_localisation_strings_string_mk_dif_arm	[[col:red]]Висок.[[/col]], реліг. заворушення	true
random_localisation_strings_string_mk_dif_tri	[[col:yellow]]Середн.[[/col]]	true
random_localisation_strings_string_character_situation_zeal_convert_character	Навернення персонажа	true
random_localisation_strings_string_gfx_v_high	Дуже висок.	true
random_localisation_strings_string_happiness_resistance_fame	text_rejected	true
random_localisation_strings_string_victory_conditions_conquest_best_before	text_rejected	true
random_localisation_strings_string_round_id_february	Лютий	true
random_localisation_strings_string_victory	Перемога	true
random_localisation_strings_string_REGION_FOOD_FACTOR_POOR_FERTILITY_BONUS	Особливість фракції	true
random_localisation_strings_string_tile_upgrade_encampment	Укріплення	true
random_localisation_strings_string_Cannot_build_fort	Неможливо побудувати форт.||Для будівництва необхідний полководець, а ви повинні знаходитися в межах своєї провінції.||Вам також буде потрібно достатньо грошей і вільного місця.||Зберіть більше коштів або підшукайте для будівництва більш підхоже місце.	true
random_localisation_strings_string_Historic	Історична битва	true
random_localisation_strings_string_agent_help_string_nemesis	Ваша жертва від природи не сприйнятлива до дій вашого агента.	true
random_localisation_strings_string_region_specialty_naval_tradition	text_rejected	true
random_localisation_strings_string_limited_edition_required	text_rejected	true
random_localisation_strings_string_round_id_october	Жовтень	true
random_localisation_strings_string_unit_encouraged_general_rallying_nearby	Полководець згуртовує найближчих бійців	true
random_localisation_strings_string_trade_agreement_tooltip_projected_value	Передбачуваний дохід:	true
random_localisation_strings_string_land_combatant_winning_slightly	Загін перемагає з невеликою перевагою	true
random_localisation_strings_string_campaign_difficulty_description_1	Для гравців, які вже знайомі зі стратегіями, але не з Total War.	true
random_localisation_strings_string_campaign_difficulty_description_0	Для тих, хто ніколи не грав у стратегії.	true
random_localisation_strings_string_campaign_difficulty_description_3	Для досвідчених гравців.	true
random_localisation_strings_string_campaign_difficulty_description_2	Для гравців, які вже знайомі з Total War.	true
random_localisation_strings_string_campaign_difficulty_description_4	Тільки для хардкорщиків! Ручне збереження в режимі кампанії неможливе. Під час паузи в бою не можна віддавати накази.	true
random_localisation_strings_string_player_is_vassal_and_cannot_attack	Будучи маріонетковою державою, ви можете оголосити війну тільки своїм володарям, якщо захочете здобути незалежність. Оголошення війни іншим фракціям неможливе.	true
random_localisation_strings_string_agent_recruitment_no_settlment_selected	Ви не вибрали поселення, де хочете найняти агента.	true
random_localisation_strings_string_event_log_battle_defeat_heroic_crushing	Розгромна поразка	true
random_localisation_strings_string_finance_header_interest	Відсоток	true
random_localisation_strings_string_unit_upgrade_unit_damaged	Сили цього загону не на максимумі, тому його неможливо поліпшити.	true
random_localisation_strings_string_player_stats_best_clan_ladder_placement	text_rejected	true
random_localisation_strings_string_ship_card_red_destroyed	Цей корабель був знищений в бою.	true
random_localisation_strings_string_FACTION_FOOD_FACTOR_TECHNOLOGIES	Технології	true
random_localisation_strings_string_gfx_filtering_ani8x	Анізотр. 8x	true
random_localisation_strings_string_CAMPAIGN_POLITICS_ACTION_TYPE_ASSASSINATE	Замовне вбивство	true
random_localisation_strings_string_unit_encouraged_rallied_by_unit_ability	Посилено вміннями	true
random_localisation_strings_string_technology_status_available_to_steal_no_gentlemen	text_rejected	true
random_localisation_strings_string_art_unavailable	Клацніть ЛКМ, щоб зробити цю технологію вашою метою.||Технології, необхідні для досягнення мети, будуть вивчатися автоматично.	true
random_localisation_strings_string_unknown	Невідомо	true
random_localisation_strings_string_diplomacy_button_cannot_request_join_war_when_at_w	text_rejected	true
random_localisation_strings_string_network_error_join_failed_password	Не вдалося приєднатися до гри: вказано неправильний пароль	true
random_localisation_strings_string_finance_header_unit_upkeep	Склад військ	true
random_localisation_strings_string_ship_card_crew_lost_ship_scuppered	text_rejected	true
random_localisation_strings_string_battle_filter_land	Сухопутні битви	true
random_localisation_strings_string_multiplayer_turn_begin2	Клацніть, щоб почати хід.	true
random_localisation_strings_string_multiplayer_turn_begin1	Хід завершено:	true
random_localisation_strings_string_character_situation_subterfuge_spy_network	Мережа підглядників	true
random_localisation_strings_string_effect_bundle_time	Залишилося сезонів	true
random_localisation_strings_string_fe_recruitment_card_tooltip_not_unlocked	Ви не можете додати цей загін: він поки що недоступний.\\nПродовжуйте перемагати, і ви відкриєте нові види загонів.	true
random_localisation_strings_string_mp_ready_error_no_faction	Фракція гравця обрана	true
random_localisation_strings_string_round_id_november	Листопад	true
random_localisation_strings_string_formatted_memory	%d МБ	true
random_localisation_strings_string_evening	Вечір	true
random_localisation_strings_string_unit_concerned_fatigue_exhausted	Виснажені	true
random_localisation_strings_string_character_experience_progress_bar	Очки досвіду на даному рівні:	true
random_localisation_strings_string_unit_encouraged_charging	Натиск	true
random_localisation_strings_string_your_ally	Ваш союзник:	true
random_localisation_strings_string_opponent_demands_surrender_body	Нападники вимагають, щоб ви здалися.	true
random_localisation_strings_string_town_intellectual	text_rejected	true
random_localisation_strings_string_StratHudbutton_limited_unit_type	Максимальна кількість таких предметів обмежена. Зараз у вас їх %d з %d.	true
random_localisation_strings_string_MILITARY_FORCE_FOOD_FACTOR_EVENTS	Події	true
random_localisation_strings_string_building_insufficent_development_points	У вас немає надлишку населення.||Зачекайте, поки населення провінції зросте до достатнього рівня. Прискорити зростання населення можна шляхом поліпшення та перебудови місцевих будівель.	true
random_localisation_strings_string_dlc_menu_button_own_all	У вас вже є всі набори матеріалів.	true
random_localisation_strings_string_trade_route_state_enemy	(Ворожий)	true
random_localisation_strings_string_StratHud_Unit_Card_Recruit_Queued	ЛКМ - видалити загін з черги; ПКМ - дізнатися більше	true
random_localisation_strings_string_mk_dif_ayy	[[col:green]]Низьк.[[/col]], величезна територія	true
random_localisation_strings_string_player_stats_mp_consecutive_naval	Макс. серія перемог у морських битвах	true
random_localisation_strings_string_MILITARY_FORCE_FOOD_FACTOR_STANCE	Режим	true
random_localisation_strings_string_round_id_late_may	Кінець травня	true
random_localisation_strings_string_gfx_high	Висок.	true
random_localisation_strings_string_ping_notification	Увага!	true
random_localisation_strings_string_gfx_filtering_bi	Білінійна	true
random_localisation_strings_string_unit_concerned_army_destruction	Армія зазнає втрат	true
random_localisation_strings_string_replenish_cancel	Скасувати поповнення обраних загонів. Повернення коштів:	true
random_localisation_strings_string_unhappy	Нещасний	true
random_localisation_strings_string_clan_season_end	Сезон закінчено.	true
random_localisation_strings_string_autosaving	Автозбереження...	true
random_localisation_strings_string_pre-battle_multiplayer_play_battle	Битися	true
random_localisation_strings_string_mp_ready_error_no_ai_units	Щоб почати гру, виберіть загони для армій ШІ.	true
random_localisation_strings_string_SkillTree_Skill_Available_Function_Tooltip	ЛКМ - додати очки; ПКМ - дізнатися більше	true
random_localisation_strings_string_action_result_type_failure	Провал	true
random_localisation_strings_string_cards_only	Тільки картки	true
random_localisation_strings_string_time_days	дн.	true
random_localisation_strings_string_player_stats_campaign_battles_fought_personally	Особисто проведено битв (у кампанії)	true
random_localisation_strings_string_multiplayer_time_up_title	Час вийшов!	true
random_localisation_strings_string_REGION_FOOD_FACTOR_TECHNOLOGIES	Технології	true
random_localisation_strings_string_campaign_filter_friends	Кампанії друзів	true
random_localisation_strings_string_CAMPAIGN_POLITICS_ACTION_TYPE_GET_INTO_POSITION	Зробити призначення	true
random_localisation_strings_string_MILITARY_FORCE_FOOD_FACTOR_TECHNOLOGIES	Технології	true
random_localisation_strings_string_morale_surrendered	Здаються	true
random_localisation_strings_string_cancel_construction_header	Скасувати будівництво	true
random_localisation_strings_string_captive_option_description_release	Продаж полонених загонів противнику приносить прибуток, але підриває згуртованість ваших військ.	true
random_localisation_strings_string_gfx_aa_8x8	8x	true
random_localisation_strings_string_gfx_aa_4x4	4x	true
random_localisation_strings_string_finance_header_commerce_raiding	Нальоти	true
random_localisation_strings_string_gfx_aa_2x2	2x	true
random_localisation_strings_string_battle_title_adrianople	Битва при Адріанополі	true
random_localisation_strings_string_will_go_bankrupt	Ви витрачаєте занадто багато грошей, а витрати на утримання військ виснажують вашу скарбницю. Якщо не підняти податки або не розпустити непотрібні загони, ваша скарбниця неминуче спорожніє. Ви впевнені, що хочете завершити хід?	true
random_localisation_strings_string_unit_encouraged_winning	Перемагають у поточному бою	true
random_localisation_strings_string_file_io_error_not_found	Файл не знайдено. Вказано неправильну назву файлу.	true
random_localisation_strings_string_character_role_politician	Держ. діяч	true
random_localisation_strings_string_FACTION_FOOD_FACTOR_POOR_FERTILITY_BONUS	Особливість фракції	true
random_localisation_strings_string_leaderboard_no_entries_returned	Записів не знайдено.	true
random_localisation_strings_string_multiplayer_waiting_load	Чекаємо завершення завантаження інших гравців...	true
random_localisation_strings_string_mk_dif_aze	[[col:red]]Висок.[[/col]], ворож. сусід. фракції	true
random_localisation_strings_string_CARD_STAT_BEST_4V4_LADDER_PLACEMENT_NAVAL	Кращий абордаж 4 на 4	true
random_localisation_strings_string_gfx_downgraded	УВАГА! Якість графіки знижена через брак відеопам'яті. Увімкніть параметр «Необмежена відеопам'ять» в меню додаткових параметрів графіки. Якщо продуктивність гри знизиться, вимкніть його і зменшіть якість текстур.	true
random_localisation_strings_string_morale	Бойовий дух	true
random_localisation_strings_string_rclick_terminate_steal_click	ПКМ - скасувати крадіжку цієї технології	true
random_localisation_strings_string_pre-battle_multiplayer_auto_resolve	Розрахувати автоматично	true
random_localisation_strings_string_building_culture_conversion	Вартість навернення за рахунок місцевої культури	true
random_localisation_strings_string_ping_defend	Тримайте тут оборону!	true
random_localisation_strings_string_description	Опис	true
random_localisation_strings_string_naval_recruitment_tab	Найм флоту	true
random_localisation_strings_string_unit_encouraged_fortification_breach	Позицію ще можна утримати	true
random_localisation_strings_string_network_error_incompatible_exe	Несумісна виконувана версія	true
random_localisation_strings_string_character_situation_cunning_counterspy	Контррозвідка	true
random_localisation_strings_string_morale_routing	Втікають	true
random_localisation_strings_string_at_war	Війна	true
random_localisation_strings_string_destroy_transported_warning	Ви дійсно хочете розпустити вибрані загони?	true
random_localisation_strings_string_melee_defence	Захист в ближ. бою	true
random_localisation_strings_string_lists_tooltip2	ЛКМ - висунути загін; ПКМ - дізнатися більше	true
random_localisation_strings_string_episodic_restriction	Тільки в пролозі	true
random_localisation_strings_string_thief_tooltip	Клацніть ЛКМ, щоб зробити вибір. Потім клацніть ЛКМ по доступній технології, щоб спробувати її вкрасти.	true
random_localisation_strings_string_finances_tribute_expenditure	Інше	true
random_localisation_strings_string_play_battle	Участь	true
random_localisation_strings_string_unit_card_lost_men_disbanded	Цей загін втратив занадто багато людей і був розпущений.	true
random_localisation_strings_string_StratHudbutton_cannot_enlist_nocash	Неможливо найняти полководця||У вас недостатньо коштів.	true
random_localisation_strings_string_weather_tooltips_fog	Туман||Сильне погіршення огляду.	true
random_localisation_strings_string_network_error_kicked	Адміністратор виключив вас з гри.	true
random_localisation_strings_string_diplomacy_header_player_clan	text_rejected	true
random_localisation_strings_string_network_message_confirm_quit	Ви дійсно хочете вийти?	true
random_localisation_strings_string_March	text_rejected	true
random_localisation_strings_string_settlement_spy_info_no_info	Немає відомостей від підглядників	true
random_localisation_strings_string_character_situation_seducing	Спокушання	true
random_localisation_strings_string_finance_header_tribute	Данина	true
random_localisation_strings_string_versus	і	true
random_localisation_strings_string_wealth	Багатство	true
random_localisation_strings_string_player_stat_disembarks	Всього висадок	true
random_localisation_strings_string_damage	Збиток	true
random_localisation_strings_string_May	text_rejected	true
random_localisation_strings_string_day	День	true
random_localisation_strings_string_unit_upgrade_incorrect_stance	Ви не можете поліпшити цей загін, поки ваша армія не перейде у відповідний режим.	true
random_localisation_strings_string_class_middle	Середній клас	true
random_localisation_strings_string_warning_players_without_dlc	Ви вибираєте мапу, що містить завантажувані матеріали, яких немає у деяких гравців у лобі. Ці гравці будуть виключені. Продовжити?	true
random_localisation_strings_string_player_stats_total_mp_naval_battles_completed	Всього мережевих морських битв	true
random_localisation_strings_string_fe_recruitment_card_tooltip_command_clash_land	Не можна набрати цей загін, поки у армії немає полководця.	true
random_localisation_strings_string_ability_defend	Режим оборони||У цьому режимі ваші війська займають оборону і утримують позицію. Навіть якщо ворог втече, ваші воїни залишаться на місці і будуть тримати стрій.	true
random_localisation_strings_string_player_stat_men_killed	Всього солдатів вбито/взято в полон	true
random_localisation_strings_string_round_id_late_march	Кінець березня	true
random_localisation_strings_string_agent_recruitment_insufficient_dev_points_expedition	[[col:red]]Надлишок населення недостатній для створення нової експедиційної армії.[[/col]]	true
random_localisation_strings_string_oppressed_by	Відчуває гніт з боку:	true
random_localisation_strings_string_ship_card_red_general_killed	Капітан цього корабля вбитий в бою.	true
random_localisation_strings_string_battle_filter_friends	Дружні битви	true
random_localisation_strings_string_manoeuverability_low	Низьк.	true
random_localisation_strings_string_unit_concerned_projectiles_overhead	Снаряди над головою	true
random_localisation_strings_string_road	Дорога	true
random_localisation_strings_string_resource_exporting_percentage	Експорт:	true
random_localisation_strings_string_unit_stat_bonus_accuracy_exceptional	Ідеальна влучність	true
random_localisation_strings_string_Naval	Морська битва	true
random_localisation_strings_string_technology_status_being_stolen	text_rejected	true
random_localisation_strings_string_agent_help_string_bribe_faction_leader	text_rejected	true
random_localisation_strings_string_defeat	Поразка	true
random_localisation_strings_string_purchase_dialog_txt	Для цієї гри потрібні додаткові завантажувані матеріали.	true
random_localisation_strings_string_morale_broken	Зламані	true
random_localisation_strings_string_trade_agreement_tooltip_no_sea_routes	Порти в їхній столиці завантажені на повну потужність.||Неможливо прокласти морський торговий шлях з їхньої столиці.	true
random_localisation_strings_string_cannot_recruit_general_already_full	Ви не можете найняти полководця зараз.||У вашій армії вже досягнуто максимальна кількість загонів.||Щоб найняти полководця, необхідно розпустити непотрібний загін.	true
random_localisation_strings_string_enemy_forces	Ворожий союз	true
random_localisation_strings_string_agent_help_string_insufficient_funds	Недостатньо грошей, щоб виконати цю дію.	true
random_localisation_strings_string_quit_warning	Якщо вийти зараз, ви втратите весь незбережений прогрес.	true
random_localisation_strings_string_round_id_july	Липень	true
random_localisation_strings_string_CARD_STAT_BEST_1V1_LADDER_PLACEMENT_NAVAL	Кращий абордаж 1 на 1	true
random_localisation_strings_string_character_situation_conversion	Навернення провінції	true
random_localisation_strings_string_stats_clan_clan_leader	text_rejected	true
random_localisation_strings_string_finance_header_looting	Видобуток	true
random_localisation_strings_string_nations_filter_tooltip	ЛКМ - увімкнути або вимкнути фільтр	true
random_localisation_strings_string_allied	Союзники	true
random_localisation_strings_string_event_log_battle_victory_close_phyrric	Піррова перемога	true
random_localisation_strings_string_mission_reward	Нагорода:	true
random_localisation_strings_string_action_result_type_opportune_failure	Втрачена можливість	true
random_localisation_strings_string_error_profile_request	text_rejected	true
random_localisation_strings_string_auto_resolve	Авторозрахунок	true
random_localisation_strings_string_bribe_nonhostile_description	Ви збираєтеся маніпулювати неворожим агентом, переманюючи його до вашої фракції. Це вважається оголошенням війни.\\nВи впевнені?	true
random_localisation_strings_string_load_success	Завантаження пройшло успішно	true
random_localisation_strings_string_range	Дальність	true
random_localisation_strings_string_repair_cancel	Скасувати ремонт вибраних кораблів. До скарбниці повернеться:	true
random_localisation_strings_string_character_details_panel_min	Мінімум	true
random_localisation_strings_string_large	Велик.	true
random_localisation_strings_string_high	Вис.	true
random_localisation_strings_string_cannot_dismantle_ruin	Щоб очистити цю комірку, вам спочатку потрібно знести руїни в попередній.	true
random_localisation_strings_string_player_disconnected	відключається.	true
random_localisation_strings_string_character_situation_cunning_hunt_down	Утримання	true
random_localisation_strings_string_Siege	Облога	true
random_localisation_strings_string_battle_victory_minor_decisive	Рішуча перемога||Ворог мертвий або втікає, рятуючи своє нікчемне життя! Ви перемогли!	true
random_localisation_strings_string_network_error_desync	Сталася розсинхронізація в грі, виконується вихід з гри...	true
random_localisation_strings_string_victory_conditions_tutorial	Для перемоги в кампанії захопіть провінції, зазначені нижче.	true
random_localisation_strings_string_gfx_aa_mlaa	MLAA	true
random_localisation_strings_string_battle_victory_major_decisive	Рішуча перемога||Немає сумнівів: це велика перемога! Всі ваші вороги мертві або втекли!	true
random_localisation_strings_string_CARD_STAT_BEST_2V2_LADDER_PLACEMENT_NAVAL	Кращий абордаж 2 на 2	true
random_localisation_strings_string_attrition_heat	Це зона ураження. Всі війська, що потрапили сюди, будуть нести небойові втрати через сильну спеку	true
random_localisation_strings_string_StratHudbutton_Cannot_Build2	Перебуваючи в облозі, ви не можете вести тут будівництво.	true
random_localisation_strings_string_StratHudbutton_Cannot_Build3	Перш ніж будувати будівлю, відремонтуйте найпершу споруду цього ланцюжка.	true
random_localisation_strings_string_StratHudbutton_Cannot_Build0	Неможливо побудувати	true
random_localisation_strings_string_StratHudbutton_Cannot_Build1	Вам не вистачає коштів на цю споруду. Ціна:	true
random_localisation_strings_string_yes	Так	true
random_localisation_strings_string_mission_description	Опис:	true
random_localisation_strings_string_player_stats_men_lost	Бійців втрачено	true
random_localisation_strings_string_food_percent	Відсоток продукції	true
random_localisation_strings_string_incompatible_version	Версія гри відрізняється від вашої, ви не зможете до неї приєднатися	true
random_localisation_strings_string_Unit_replenishment_per_turn	Поповнює людей за хід:	true
random_localisation_strings_string_battle_draw	Нічия ||Бойові дії припинені, битва закінчилася внічию. Обидві сторони розійшлися з честю.	true
random_localisation_strings_string_trade_agreement_tooltip_no_ports_them	text_rejected	true
random_localisation_strings_string_event_log_battle_draw	Нічия	true
random_localisation_strings_string_round_id_june	Червень	true
random_localisation_strings_string_mission_issued_end_rebellion	Придушити повстання:	true
random_localisation_strings_string_network_message_not_responding_host	Деякі гравці не відповідають. Виключити їх з гри або почекати ще?	true
random_localisation_strings_string_morale_amok	Шаленіють	true
random_localisation_strings_string_CARD_STAT_BEST_3V3_LADDER_PLACEMENT_NAVAL	Кращий абордж 3 на 3	true
random_localisation_strings_string_reinforcement_tooltip	З цієї позиції можна посилити союзний загін.	true
random_localisation_strings_string_never	Ніколи	true
random_localisation_strings_string_queued_building_blocked_by_stance_expedition	Щоб завершити будівництво, експедиції потрібно розбити табір. ЛКМ - скасувати будівництво, ПКМ - дізнатися більше.	true
random_localisation_strings_string_mp_ready_error_no_opposition	Не можна почати гру - у вас немає супротивників.	true
random_localisation_strings_string_repair_cost	Ціна ремонту:	true
random_localisation_strings_string_unit_encouraged_general_alive	Полководець живий	true
random_localisation_strings_string_network_message_kicked_by_host	Ви виключені з гри її адміністратором.	true
random_localisation_strings_string_stats_clan_current_clan_members_active	text_rejected	true
random_localisation_strings_string_finance_header_building_upkeep	Обслуговування споруди	true
random_localisation_strings_string_pre-battle_multiplayer_play_as_ai	Зіграти за ШІ	true
random_localisation_strings_string_unit_encouraged_army_supported	Підтримують військо	true
random_localisation_strings_string_ground	Суша	true
random_localisation_strings_string_allied_forces	Ваш союз	true
random_localisation_strings_string_ping_attack	Вдарте сюди!	true
random_localisation_strings_string_technology_status_unavailable	text_rejected	true
random_localisation_strings_string_resource_not_acquired	Цей ресурс ще не отримано.	true
random_localisation_strings_string_power_ranking	Рейтинг сили	true
random_localisation_strings_string_game_aborted	Гра перервана	true
random_localisation_strings_string_stat_shield	Рівень щита	true
random_localisation_strings_string_network_error_join_failed_game_full	Не вдалося приєднатися до гри: немає вільних місць	true
random_localisation_strings_string_unit_concerned_attacked_by_artillery	Під обстрілом далекобійних машин	true
random_localisation_strings_string_land_combatant_losing	Загін зазнає поразки	true
random_localisation_strings_string_declare_war_ally_not_requested_help	Цей союзник не просив вашої допомоги у війні.	true
random_localisation_strings_string_building_under_construction_damaged	Ця незавершена будівля була пошкоджена, всі будівельні роботи в ній зупинені. Виберіть її і натисніть кнопку «Ремонт», щоб полагодити будівлю і продовжити будівництво.	true
random_localisation_strings_string_wall_strength	Міцність стіни	true
random_localisation_strings_string_round_id_early_august	Початок серпня	true
random_localisation_strings_string_stats_clan_steam_group_creation_date	text_rejected	true
random_localisation_strings_string_battle_victory_heroic_crushing	Героїчна перемога||Це перемога! Славна, героїчна, велична перемога! Ваш ворог розбитий вщент!	true
random_localisation_strings_string_finance_header_vassals	Васальні держави	true
random_localisation_strings_string_gfx_on	Увімк.	true
random_localisation_strings_string_mission_issuer	Автори:	true
random_localisation_strings_string_audio_provider_stereo_speakers	Стереоколонки	true
random_localisation_strings_string_stat_base_reload_time	Базовий час перезарядки	true
random_localisation_strings_string_round_id_late_april	Кінець квітня	true
random_localisation_strings_string_fire_damage	Шкода від вогню	true
random_localisation_strings_string_agent_help_string_agent_cap_reached	[[col:red]]Ви використовуєте максимально можливу кількість таких персонажів.Підвищіть рівень імперіуму, і ви зможете наймати більше таких персонажів. [[/col]]	true
random_localisation_strings_string_StratHudbutton_cannot_repair_nocash	Ремонт неможливий||У вас недостатньо коштів.||Розпустіть непотрібні війська або підвищіть податки, щоб збільшити дохід.	true
random_localisation_strings_string_player_stat_battles_started	Битв розпочато	true
random_localisation_strings_string_campaign_autoresolver_tooltip_stance_siege_balanced	Цей режим не дає вашим військам ні переваг, ні штрафів.	true
random_localisation_strings_string_art_being_researched	Ви зараз вивчаєте цю технологію.	true
random_localisation_strings_string_function_building_upgrade_hud	ЛКМ - поліпшити; ПКМ - дізнатися більше	true
random_localisation_strings_string_pip_general_tooltip_loyalty_4	Вірність: висока	true
random_localisation_strings_string_pip_general_tooltip_loyalty_5	Вірність: безумовна	true
random_localisation_strings_string_pip_general_tooltip_loyalty_6	Вірність: непохитна	true
random_localisation_strings_string_pip_general_tooltip_loyalty_1	Вірність: дуже низька	true
random_localisation_strings_string_pip_general_tooltip_loyalty_2	Вірність: сумнівна	true
random_localisation_strings_string_pip_general_tooltip_loyalty_3	Вірність: середня	true
random_localisation_strings_string_will_go_bankrupt_title	Скарбниця скоро спорожніє!	true
random_localisation_strings_string_night	Ніч	true
random_localisation_strings_string_unit_concerned_flank_attacked	Атаковані з флангу	true
random_localisation_strings_string_clear_advice_warning	Ви збираєтеся очистити історію порад. Продовжити?	true
random_localisation_strings_string_reinforcement_arrows	Будь-які війська, позначені стрілками, можуть допомогти цій армії в битві.	true
random_localisation_strings_string_player_stats_total_campaign_battles	Всього битв (у кампанії)	true
random_localisation_strings_string_multiplayer_default	mp_default	true
random_localisation_strings_string_finance_header_construction	Будівництво	true
random_localisation_strings_string_unit_concerned_general_recently_died	Нещодавно помер полководець	true
random_localisation_strings_string_attrition_cold	Опинившись взимку на ворожих землях, війська несуть небойові втрати.	true
random_localisation_strings_string_overwrite_legendary_save_warning_title	Перезаписати збереження легендарного рівня складності?	true
random_localisation_strings_string_replenish_some_unable	Неможливо поповнити деякі загони в обраній групі: відповідні види військ недоступні в цих місцях.	true
random_localisation_strings_string_horde_icon_tooltip_expedition	Експедиція\\n\\nЦя фракція знаходиться у військовому поході, тому у неї немає регіонів.	true
random_localisation_strings_string_clan_points	text_rejected	true
random_localisation_strings_string_heir	Спадкоємець	true
random_localisation_strings_string_player_stats_alliances_made	Укладено союзів	true
random_localisation_strings_string_agent_recruitment_reduced_changed_bodyguard	[[col:red]]Недостатньо коштів для створення нового загону охоронців. Загін буде укомплектований не повністю.[[/col]]	true
random_localisation_strings_string_faction_not_allowed	text_rejected	true
random_localisation_strings_string_unlock_agent_action_to_embed_in_army	Для впливу на цю армію потрібен доступ до наступної дії:	true
random_localisation_strings_string_move_options_multiplayer_cannot_declare_war	Ви не можете оголосити війну вашому партнеру по спільній мережевій грі.	true
random_localisation_strings_string_locked_slot_requires_castle_upgrade	text_rejected	true
random_localisation_strings_string_chat_ping_msg	Маркер розміщений	true
random_localisation_strings_string_finance_header_fleet_upkeep	Зміст флоту	true
random_localisation_strings_string_stat_mount_hp	ОЗ транспорту	true
random_localisation_strings_string_no_building	немає будівлі	true
random_localisation_strings_string_April	text_rejected	true
random_localisation_strings_string_player_stats_total_men_dead	Бійців убито в бою (своїх і чужих)	true
random_localisation_strings_string_trade_node_tooltip_base_supply	припаси, які привезе перше торгове судно	true
random_localisation_strings_string_ability_phase_mask_unbreakable	Незламність	true
random_localisation_strings_string_move_options_vassal_cannot_declare_war	text_rejected	true
random_localisation_strings_string_melee_attack	Ближній бій	true
random_localisation_strings_string_destroy_transported_message	Знищення цих загонів призведе до втрати всіх персонажів, які на даний момент знаходяться з ними.	true
random_localisation_strings_string_low	Низьк.	true
random_localisation_strings_string_unit_concerned_general_dead	Полководець мертвий	true
random_localisation_strings_string_you	Ви	true
random_localisation_strings_string_mission_issued_recruit_unit	Набрати загін:	true
random_localisation_strings_string_wako_pirates_demand	Необхідна сума:	true
random_localisation_strings_string_June	text_rejected	true
random_localisation_strings_string_none	Немає	true
random_localisation_strings_string_stat_explosion_damage	Шкода від вибуху	true
random_localisation_strings_string_load_campaign	Завантажити гру в кампанії	true
random_localisation_strings_string_multiplayer_turn_end	Хід завершено.\\n\\nОчікування:	true
random_localisation_strings_string_midday	Полудень	true
random_localisation_strings_string_network_message_vac_you_kicked	Ви були виключені з гри через помилку авторизації VAC.	true
random_localisation_strings_string_finances_vassal_income_breakdown_other	text_rejected	true
random_localisation_strings_string_round_id_late_august	Кінець серпня	true
random_localisation_strings_string_character_details_panel_max	Максимум	true
random_localisation_strings_string_campaign_autoresolver_tooltip_stance_naval_aggressive	Ваші воїни кинуться на ворога. Цей режим більш ефективний, якщо у противника багато стрільців. Його вибір призводить до збільшення втрат.	true
random_localisation_strings_string_campaign_autoresolver_tooltip_stance_land_aggressive	Ваші воїни кинуться на ворога. Цей режим більш ефективний, якщо у противника багато стрільців. Його вибір призводить до збільшення втрат.	true
random_localisation_strings_string_growth_rate	Зростання	true
random_localisation_strings_string_leaderboard_no_response_from_server	text_rejected	true
random_localisation_strings_string_stat_bonus_elephant	Перев. пр. слонів	true
random_localisation_strings_string_victory_conditions_conquest	text_rejected	true
random_localisation_strings_string_content_locked	Матеріали заблоковані	true
random_localisation_strings_string_normal	Середн.	true
random_localisation_strings_string_network_message_player_dropped	покидає гру.	true
random_localisation_strings_string_July	text_rejected	true
random_localisation_strings_string_ally	Союзник	true
random_localisation_strings_string_early	Рано	true
random_localisation_strings_string_small	Мал.	true
random_localisation_strings_string_upload_failed	Не вдалося завантажити дані. Перевірте підключення до мережі Інтернет і спробуйте ще раз.	true
random_localisation_strings_string_player_stats_units_recruited	Набрано загонів	true
random_localisation_strings_string_network_message_you_dropped	Втрачено з'єднання з грою.	true
random_localisation_strings_string_power_ranking_tooltip	Відносна сила їх фракції в порівнянні з усіма іншими.	true
random_localisation_strings_string_predicted_income_explanation	Сума, яку ви отримаєте на наступному ході. Зверніть увагу, що це не прогноз загальної суми у вашій скарбниці.	true
random_localisation_strings_string_full	Повн.	true
random_localisation_strings_string_self	Сам загін	true
random_localisation_strings_string_clan_demotion	text_rejected	true
random_localisation_strings_string_finance_header_total_income	Всього доходів	true
random_localisation_strings_string_Economics_Bar	text_rejected	true
random_localisation_strings_string_network_message_player_left	залишає гру.	true
random_localisation_strings_string_battle_defeat_heroic_crushing	Розгромна поразка||Повний крах! Ви зазнали розгромної поразки.	true
random_localisation_strings_string_marked_for_dismantling	Позначено під знесення	true
random_localisation_strings_string_enemy	Ворог	true
random_localisation_strings_string_action_result_type_guaranteed	Гарантовано	true
random_localisation_strings_string_effect_bundle_tooltip	Поточні ефекти||Успішне виконання завдань і певні ігрові події можуть мати деякий вплив на вашу фракцію або провінції.	true
random_localisation_strings_string_multiplayer_waiting_reconnect	Чекаємо гравців...	true
random_localisation_strings_string_population_surplus_expedition	Надлишок населення||Експедиції потрібні люди. Надлишок населення можна використовувати як для посилення існуючої експедиції, так і для створення нової. Для зростання вкрай важливі табори і набіги.	true
random_localisation_strings_string_all	Всі	true
random_localisation_strings_string_round_id_late_january	Кінець січня	true
random_localisation_strings_string_num_breaches	Мінімальна кількість проломів	true
random_localisation_strings_string_factors_governing_relationship	Фактори, що визначають ставлення до сторони %S:	true
random_localisation_strings_string_mission_reward_land_experience	Досвід для всіх наземних загонів	true
random_localisation_strings_string_target	Ціль	true
random_localisation_strings_string_FACTION_PROVINCE_FOOD_FACTOR_FERTILITY	Родючість	true
random_localisation_strings_string_reliability	Надійність	true
random_localisation_strings_string_battle_victory_close_phyrric	Піррова перемога||Ви перемогли, але якою ціною? Занадто багато хто заплатив життям за цю перемогу.	true
random_localisation_strings_string_vhard	Дуже висок.	true
random_localisation_strings_string_ultra	Ультра	true
random_localisation_strings_string_port	Порт	true
random_localisation_strings_string_singleplayer_default	sp_default	true
random_localisation_strings_string_gfx_extreme	Вища якість	true
random_localisation_strings_string_player_stats_enemy_ships_sunk	Потоплено ворожих суден	true
random_localisation_strings_string_farm	Садиба	true
random_localisation_strings_string_lists_tooltip	Двічі клацніть ЛКМ, щоб висунути загін; ПКМ - дізнатися більше	true
random_localisation_strings_string_hard	Висок.	true
random_localisation_strings_string_technology_tooltip_researching_numeric_info	Очікуваний час дослідження:	true
random_localisation_strings_string_town_factor_industry	Торгівля	true
random_localisation_strings_string_cannot_begin_battle_map_downloading	Ви не зможете почати битву до закінчення завантаження мапи.	true
random_localisation_strings_string_technology_status_available_to_steal	text_rejected	true
random_localisation_strings_string_upkeep_cost	Ціна утримання	true
random_localisation_strings_string_sea_region_control_status_controlled	Під контролем	true
random_localisation_strings_string_battle_regroup_position_marker	Точка перегрупування	true
random_localisation_strings_string_CAMPAIGN_POLITICS_ACTION_TYPE_ASSASSINATE_WIFE	Вбивство дружини	true
random_localisation_strings_string_easy	Низьк.	true
random_localisation_strings_string_instruction_regroup_ability	Клацніть ПКМ по точці, щоб поставити мітку перегрупування. Клацніть по кнопці, щоб скасувати дію.	true
random_localisation_strings_string_cost	Ціна	true
random_localisation_strings_string_test	тест	true
random_localisation_strings_string_settlement_strength	Сила поселення	true
random_localisation_strings_string_land_combatant_even	Нічия	true
random_localisation_strings_string_network_error_incompatible_map_version	Невірна версія мапи	true
random_localisation_strings_string_audio_provider_windows_default	За замовчуванням	true
random_localisation_strings_string_fatigue_winded	Змучені	true
random_localisation_strings_string_audio_provider_directsound_3d_hardware	DirectSound 3D	true
random_localisation_strings_string_reveal	Відкрити	true
random_localisation_strings_string_player_stats_best_2v2_skill	Рекорд навичок (2 на 2, наземний бій)	true
random_localisation_strings_string_player_stats_best_3v3_skill	Рекорд навичок (3 на 3, наземний бій)	true
random_localisation_strings_string_player_stats_best_1v1_skill	Рекорд навичок (1 на 1, наземний бій)	true
random_localisation_strings_string_player_stats_best_4v4_skill	Рекорд навичок (4 на 4, наземний бій)	true
random_localisation_strings_string_thousand_abbreviated	тис.	true
random_localisation_strings_string_StratHud_Building_Card_Recruit_Queued	ЛКМ - видалити будівлю з черги; ПКМ - дізнатися більше	true
random_localisation_strings_string_happy	Щасливий	true
random_localisation_strings_string_button_advice_tooltip	Щоб отримати підказку, клацніть на цій панелі	true
random_localisation_strings_string_stat_men_hp	ОЗ солдатів	true
random_localisation_strings_string_save_success	Збереження пройшло успішно	true
random_localisation_strings_string_exceeds_all_budgets	Перевищення всього бюджету	true
random_localisation_strings_string_battle_victory_minor_heroic	Героїчна перемога||Бій закінчено, і рахунок убитих вже відомий. Це гідна перемога!	true
random_localisation_strings_string_trade_agreement_tooltip_no_route_them	Неможливо прокласти морський торговий шлях з їхньої столиці.	true
random_localisation_strings_string_stat_bonus_infantry	Перев. пр. піхоти	true
random_localisation_strings_string_tile_upgrade_settlement_escalation1	Рівень ескалації 1	true
random_localisation_strings_string_tile_upgrade_settlement_escalation2	Рівень ескалації 2	true
random_localisation_strings_string_postbattle_town_wealth	Очікуваний добробут міста	true
random_localisation_strings_string_FACTION_FOOD_FACTOR_CHARACTERS	Персонажі	true
random_localisation_strings_string_victory_conditions_prestige_additional	text_rejected	true
random_localisation_strings_string_cpu	Комп'ютер	true
random_localisation_strings_string_mission_issued_capture_city	Захопити місто:	true
random_localisation_strings_string_character_situation_paying_off	Виплата боргу	true
random_localisation_strings_string_indestructible	Незруйновний	true
random_localisation_strings_string_technology_status_unavailable_building	text_rejected	true
random_localisation_strings_string_clan_members	text_rejected	true
random_localisation_strings_string_other_factors	Інші фактори	true
random_localisation_strings_string_morale_steady	Тверді	true
random_localisation_strings_string_event_log_rebellion_peasant	text_rejected	true
random_localisation_strings_string_million_abbreviated	млн.	true
random_localisation_strings_string_repair_not_required	Обраним кораблям ремонт не потрібен.	true
random_localisation_strings_string_invalid_replay_file	Не вдалося завантажити повтор битви. Вказано неправильний файл.	true
random_localisation_strings_string_chat_telestration_msg	Повідомлення з картинкою надіслано	true
random_localisation_strings_string_conversion_factor_osmosis_christian	text_rejected	true
random_localisation_strings_string_cannot_show_projectile_stats	(Характеристики стрільби не відображаються при виборі декількох загонів з різною зброєю.)	true
random_localisation_strings_string_region_specialty_prime_forest	text_rejected	true
random_localisation_strings_string_unit_concerned_losing	Програють поточний бій	true
random_localisation_strings_string_network_error_join_failed_incompatible	Не вдалося приєднатися до гри: несумісні версії	true
random_localisation_strings_string_fleet_status_transit2	В дорозі до точки:	true
random_localisation_strings_string_fleet_status_transit1	В дорозі	true
random_localisation_strings_string_agent_help_string_bribe_vassal	text_rejected	true
random_localisation_strings_string_diplomacy_panel_hostage_held	Ваш заручник взятий:	true
random_localisation_strings_string_fe_recruitment_card_tooltip_cap_reached_sea	Не можна додавати інші загони цього типу - досягнуто межу: %d на флот.	true
random_localisation_strings_string_agent_help_string_coop_action	Щодо іншого гравця в спільній кампанії цю дію виконати неможливо.	true
random_localisation_strings_string_town	Місто	true
random_localisation_strings_string_morale_shaken	Приголомшені	true
random_localisation_strings_string_player_stats_total_mp_land_battles_completed	Всього мережевих сухопутних битв	true
random_localisation_strings_string_network_error_incompatible_mod	Несумісна версія модифікації	true
random_localisation_strings_string_ruined	Зруйновано	true
random_localisation_strings_string_art_already_researched	Ви вже вивчили цю технологію.	true
random_localisation_strings_string_army_recruitment_limit_reached	Ви найняли макс. кількість загонів, можливу для цієї армії.	true
random_localisation_strings_string_expert	Дуже висок.	true
random_localisation_strings_string_raided	Наліт	true
random_localisation_strings_string_you_cannot_afford_to_repair_this_item	Вам не вистачає коштів на ремонт. Ціна:	true
random_localisation_strings_string_guerrilla_cant_deploy	text_rejected	true
random_localisation_strings_string_late	Пізно	true
random_localisation_strings_string_tile_upgrade_settlement_level2	Велик.	true
random_localisation_strings_string_tile_upgrade_settlement_level3	Велике	true
random_localisation_strings_string_tile_upgrade_settlement_level1	Маленьке	true
random_localisation_strings_string_tile_upgrade_settlement_level4	Величезне	true
random_localisation_strings_string_rebel_faction_name_override	Бунтівники	true
random_localisation_strings_string_network_message_steam_connection_lost	Зв'язок із Steam втрачено.	true
random_localisation_strings_string_ping_standard	Тут!	true
random_localisation_strings_string_cancel_repair_building	Ця будівля буде відремонтована після закінчення вашого ходу. Клацніть ЛКМ, щоб скасувати ремонт.	true
random_localisation_strings_string_fatigue_active	Активні	true
random_localisation_strings_string_seamen	text_rejected	true
random_localisation_strings_string_agent_help_string_high_loyalty	Ваша жертва надзвичайно лояльна - цю людину буде складно підкупити.	true
random_localisation_strings_string_overwrite_msg	Ви дійсно хочете зберегти гру поверх існуючого збереження?	true
random_localisation_strings_string_bonus	Бонус:	true
random_localisation_strings_string_trade_status_tooltip_already_trading	Торгівля вже йде	true
random_localisation_strings_string_exit_theatre_tooltip	Закінчити перегляд	true
random_localisation_strings_string_attrition_cold_immune	Загони вашої армії захищені від небойових втрат через холод.	true
random_localisation_strings_string_network_message_waiting_for_response	Очікування відповіді від гравця в мережі.	true
random_localisation_strings_string_win_chance_moderate	Середній	true
random_localisation_strings_string_character_role_admiral	Флотоводець	true
random_localisation_strings_string_player_stats_nations_destroyed	Фракцій знищено	true
random_localisation_strings_string_rally_ability	Згуртувати війська	true
random_localisation_strings_string_quit_battle	Ви вийдете з битви. Ви впевнені?	true
random_localisation_strings_string_ability_fire_at_will	Стрільба без наказу||У режимі стрільби без наказу загони відкривають вогонь по всіх супротивниках, що наблизилися на достатню відстань.	true
random_localisation_strings_string_unit_concerned_general_fled_recently	Полководець нещодавно втік	true
random_localisation_strings_string_unit_concerned_settlement_destruction	Руйнування поселення	true
random_localisation_strings_string_region_factor_industry	Торгівля	true
random_localisation_strings_string_character_role_general	Полководець	true
random_localisation_strings_string_expedition_occupy_confirmation	Окупація поселення призведе до того, що експедиція оголосить про свою незалежність і втратить підтримку імперії. Її завдання і нагороди стануть недоступними, проте в разі успіху ваша фракція отримає шанс відродити Західну Римську імперію.	true
random_localisation_strings_string_always	Завжди	true
random_localisation_strings_string_win_chance_low	Низький	true
random_localisation_strings_string_Unit_replenishment_complete_in	Ходів до повного відновлення загону:	true
random_localisation_strings_string_medium	Середн.	true
random_localisation_strings_string_button_cancel_slot_instruction_active	Клацніть на цю кнопку, щоб скасувати будь-які дії з вибраним предметом.	true
random_localisation_strings_string_click_to_show_on_map	Клацніть, щоб показати на мапі	true
random_localisation_strings_string_player_stats_num_sword_duels	Поєдинків на мечах виграно	true
random_localisation_strings_string_CARD_STAT_BEST_1V1_SKILL_NAVAL	Найкращий результат у морському бою 1 на 1	true
random_localisation_strings_string_CARD_STAT_BEST_3V3_SKILL_NAVAL	Найкращий результат у морському бою 3 на 3	true
random_localisation_strings_string_CARD_STAT_BEST_2V2_SKILL_NAVAL	Найкращий результат у морському бою 2 на 2	true
random_localisation_strings_string_CARD_STAT_BEST_4V4_SKILL_NAVAL	Найкращий результат у морському бою 4 на 4	true
random_localisation_strings_string_agent_recruitment_insufficient_money_for_different_bodyguard	[[col:red]]Недостатньо коштів для створення нового загону охоронців.[[/col]]	true
random_localisation_strings_string_CapturePoint	Бій за захоплення точки	true
random_localisation_strings_string_diplomacy_button_must_be_at_peace_to_protect	text_rejected	true
random_localisation_strings_string_benchmark_dialog_body	Вийти з тестового режиму?	true
random_localisation_strings_string_network_error_steam_disconnect	Сталося відключення від Steam. Для продовження перезапустіть Steam.	true
random_localisation_strings_string_unit_concerned_night_battle_unprepared	Не готові до нічної битви	true
random_localisation_strings_string_FACTION_PROVINCE_FOOD_FACTOR_BASE_FOOD	Базова їжа	true
random_localisation_strings_string_state_religion_change_inactive_faction_leader_already_changed	Зміна релігії неможлива - лідер вашої фракції вже змінював релігію.	true
random_localisation_strings_string_agent_help_string_enemy_counter_agent	Агент противника буде заважати вам, знижуючи ваші шанси на успіх.	true
random_localisation_strings_string_fortification	Укріплення	true
random_localisation_strings_string_attrition_sea	У цих водах кораблі будуть нести небойові втрати	true
random_localisation_strings_string_unit_concerned_fatigue_tired	Втомлені	true
random_localisation_strings_string_gfx_drop_low	Макс. продук.	true
random_localisation_strings_string_player_stats_miles_covered_campaign	Пройдено миль по суші і по морю (в кампанії)	true
random_localisation_strings_string_gate_with_oil	(з олією)	true
random_localisation_strings_string_finance_header_total_upkeep	Всього утрим.	true
random_localisation_strings_string_invalid_army_setup_alliance	У гравця некоректний склад війська	true
random_localisation_strings_string_round_id_late_october	Кінець жовтня	true
random_localisation_strings_string_error_chat_room_failed	Помилка чату||Неможливо створити кімнату чату.	true
random_localisation_strings_string_technology_disabled_by	Застаріло. Нова технологія	true
random_localisation_strings_string_pre-battle_multiplayer_retreat	Відступити	true
random_localisation_strings_string_power_ranking_tooltip_player	Відносна сила вашої фракції в порівнянні з усіма іншими.	true
random_localisation_strings_string_mp_ready_error_no_ai_faction	Фракція ШІ не обрана	true
random_localisation_strings_string_no_repairs_required	Ремонт не потрібен	true
random_localisation_strings_string_campaign_autoresolver_tooltip_stance_defensive	Цей режим більш ефективний, якщо у вас багато стрільців. Його вибір призводить до зменшення втрат.	true
random_localisation_strings_string_slaves_percent	Відсоток іммігрантів	true
random_localisation_strings_string_region_capital	Поселення	true
random_localisation_strings_string_FACTION_PROVINCE_FOOD_FACTOR_EVENTS_IN_REGIONS	Події в регіоні	true
random_localisation_strings_string_reason	Причина:	true
random_localisation_strings_string_random	Випадково	true
random_localisation_strings_string_finances_other_income	Дохід з інших джерел.	true
random_localisation_strings_string_weather_tooltips_dry	Суха погода||Негативні ефекти відсутні.	true
random_localisation_strings_string_audio_provider_dolby_surround	Dolby Surround	true
random_localisation_strings_string_character_situation_sea_attack	Морські битви	true
random_localisation_strings_string_enemy_mencount	Чисельність ворога	true
random_localisation_strings_string_player_stats_regions_conquered	Захоплено провінцій	true
random_localisation_strings_string_CAMPAIGN_POLITICS_ACTION_TYPE_MARRIAGE	Весілля	true
random_localisation_strings_string_instruction_inspire_ability	Клацніть ЛКМ на загоні, щоб надихнути його. ПКМ - скасувати дію.	true
random_localisation_strings_string_diplomacy_panel_hostage_given	Їхній заручник виданий:	true
random_localisation_strings_string_under_repair	У ремонті	true
random_localisation_strings_string_military_force_legacy_name_rebel_army	Бунтівна армія	true
random_localisation_strings_string_fe_recruitment_card_tooltip_cap_reached_land	Не можна додавати інші загони цього типу - досягнуто межу: %d на армію.	true
random_localisation_strings_string_attrition_heat_immune	Загони вашої армії захищені від небойових втрат в пустелі.	true
random_localisation_strings_string_Military_Bar	Армія	true
random_localisation_strings_string_unaffordable	Недостатньо коштів	true
random_localisation_strings_string_player_stats_enemy_men_killed	Вбито ворожих бійців	true
random_localisation_strings_string_diplomacy_button_need_peace_to_ally	text_rejected	true
random_localisation_strings_string_right_click_building_browser	ПКМ - перегляд будівель	true
random_localisation_strings_string_wako_pirates_current_treasury	Скарбниця на даний момент:	true
random_localisation_strings_string_campaign_autoresolver_tooltip_stance_naval_balanced	Цей режим не дає вашим військам ні переваг, ні штрафів.	true
random_localisation_strings_string_enter_contested_region_warning	У вашій рідній провінції відбувається революція. Якщо ввести туди війська, деякі солдати можуть приєднатися до бунтівників.\\n\\nВи впевнені?	true
random_localisation_strings_string_replenish_not_required	Обраним загонам поповнення не потрібно.	true
random_localisation_strings_string_campaign_autoresolver_tooltip_stance_siege_aggressive	Ваші воїни кинуться на ворога. Цей режим більш ефективний, якщо у противника багато стрільців. Його вибір призводить до збільшення втрат.	true
random_localisation_strings_string_unit_concerned_general_incapacitated	Полководець поранений	true
random_localisation_strings_string_campaing_public_order_tooltip_header	Громадський порядок	true
random_localisation_strings_string_conversion_factor_general_christian	text_rejected	true
random_localisation_strings_string_player_stats_ranked_battles_started	Рейтингових битв розпочато	true
random_localisation_strings_string_diplomacy_button_no_trade_agreement_to_cancel	Немає торгових угод, які можна розірвати.	true
random_localisation_strings_string_network_error_incompatible_missing_map	Мапа не знайдена	true
random_localisation_strings_string_unit_encouraged_on_the_hill	На височині	true
random_localisation_strings_string_round_id_may	Травень	true
random_localisation_strings_string_total_numeric	Всього	true
random_localisation_strings_string_multiplayer_time_up	Ваш час закінчився, ваш хід завершено.	true
random_localisation_strings_string_skill_current_level	Поточний рівень:	true
random_localisation_strings_string_Feature_unavailable	Недоступно в цій кампанії	true
random_localisation_strings_string_manoeuverability_high	Вис.	true
random_localisation_strings_string_victory_conditions_deadline	Завершити до кінця вашого ходу через:	true
random_localisation_strings_string_StratHudbutton_cannot_demolish	Не можна зносити поселення, порти і дороги, а також спеціальні будівлі базового рівня.	true
random_localisation_strings_string_reduced_unit_limit_msg	Адміністратор зменшив максимальну кількість загонів. Вам доведеться прибрати частину військ.	true
random_localisation_strings_string_Middle	text_rejected	true
random_localisation_strings_string_controls_save_key_list	Зберегти список гарячих клавіш	true
random_localisation_strings_string_character_situation_zeal_inspire_army	Натхнення військ	true
random_localisation_strings_string_ally_attacked_ally_attacking	Ваш союзник напав на іншу фракцію і просить вас про підтримку!	true
random_localisation_strings_string_unit_concerned_melee_contact	Борються в ближньому бою	true
random_localisation_strings_string_sea_region_control_status_contested	Завойовано	true
random_localisation_strings_string_player_stats_ranked_naval_battles_won	Рейтингових морських битв виграно	true
random_localisation_strings_string_ability_phase_mask_minor_casualties	Завдання незначних втрат	true
random_localisation_strings_string_morale_turn_until_rebellion	При поточному стані справ заколот почнеться через %n х.	true
random_localisation_strings_string_round_id_april	Квітень	true
random_localisation_strings_string_controls_load_key_list	Завантажити список гарячих клавіш	true
random_localisation_strings_string_finances_vassal_income	Всього від васальних держав	true
random_localisation_strings_string_event_log_battle_defeat_minor_close	Випадкова поразка	true
random_localisation_strings_string_Unit_is_suffering_attrition	Війська, що опинилися на території противника взимку, несуть небойові втрати. Щоб уникнути цього, виведіть загін з ворожої землі.	true
random_localisation_strings_string_ability_phase_mask_kill_self	Вбити себе	true
random_localisation_strings_string_region_specialty_gold_mining	text_rejected	true
random_localisation_strings_string_repair_no_selection	Виберіть пошкоджені кораблі, щоб їх відремонтувати.	true
random_localisation_strings_string_effect_bundle_target_global	text_rejected	true
random_localisation_strings_string_network_message_if_not_wait_game_ends	Якщо ви вирішите не чекати, гра завершиться для всіх	true
random_localisation_strings_string_round_id_early_june	Початок червня	true
random_localisation_strings_string_esc_menu_legendary_cannot_save	При грі на легендарному рівні складності зберегти гру вручну неможливо. Гра буде автоматично зберігатися в кінці ходу.	true
random_localisation_strings_string_round_id_early_october	Початок жовтня	true
random_localisation_strings_string_player_stats_ranked_naval_battles_lost	Рейтингових морських битв програно	true
random_localisation_strings_string_Failed	Невдача	true
random_localisation_strings_string_ability_loose	Розімкнути стрій||Розімкнутий стрій зменшує втрати від обстрілу, але підвищує вразливість до натиску та атак у ближньому бою.	true
random_localisation_strings_string_unit_concerned_damaged_by_artillery	Зазнали втрат від далекобійних машин	true
random_localisation_strings_string_REGION_FOOD_FACTOR_FERTILITY	Родючість	true
random_localisation_strings_string_CAMPAIGN_POLITICS_ACTION_TYPE_ADOPT	Усиновлення	true
random_localisation_strings_string_prestige_category_6	Безвісний	true
random_localisation_strings_string_prestige_category_4	Середній	true
random_localisation_strings_string_prestige_category_5	Маловідомий	true
random_localisation_strings_string_prestige_category_2	Величний	true
random_localisation_strings_string_prestige_category_3	Шанований	true
random_localisation_strings_string_prestige_category_1	Піднесений	true
random_localisation_strings_string_quit_game_main	Ви дійсно хочете вийти з гри?	true
random_localisation_strings_string_building_insufficent_development_points_number	Необхідний надлишок населення: %n.||Зачекайте, поки населення провінції зросте до достатнього рівня. Прискорити зростання населення можна шляхом поліпшення і перебудови місцевих будівель.	true
random_localisation_strings_string_town_factor_technology	text_rejected	true
random_localisation_strings_string_ability_phase_mask_cant_move	Не може рухатися	true
random_localisation_strings_string_round_id_early_march	Початок березня	true
random_localisation_strings_string_agent_help_string_low_success_chance	Шанси, що ваш агент успішно виконає завдання, мізерні.	true
random_localisation_strings_string_unit_concerned_enemy_numbers	Скупчення сил противника поблизу	true
random_localisation_strings_string_uniform_editor_custom	На вибір	true
random_localisation_strings_string_round_id_early_july	Початок липня	true
random_localisation_strings_string_audio_provider_mono	Моно	true
random_localisation_strings_string_player_stats_campaign_land_battles_won	Виграно битв на суші (в кампанії)	true
random_localisation_strings_string_gfx_shader_3	Модель 3 (низьк.)	true
random_localisation_strings_string_gfx_shader_2	Модель 2	true
random_localisation_strings_string_gfx_shader_5	Модель 5	true
random_localisation_strings_string_gfx_shader_4	Модель 4	true
random_localisation_strings_string_CAMPAIGN_POLITICS_ACTION_TYPE_DIVORCE	Розлучення	true
random_localisation_strings_string_player_stat_battles_finished	Битв завершено	true
random_localisation_strings_string_ally_attacked_ally_defending	Ваш союзник атакований і просить про допомогу!	true
random_localisation_strings_string_player_stats_most_men_killed	Макс. ворогів вбито в бою	true
random_localisation_strings_string_owner_colon	Власник:	true
random_localisation_strings_string_FACTION_FOOD_FACTOR_RAIDING	Наліт	true
random_localisation_strings_string_ability_phase_mask_major_casualties	Завдання істотних втрат	true
random_localisation_strings_string_no_host_name	Введіть коректну назву гри, щоб влаштувати мережеву гру	true
random_localisation_strings_string_FACTION_PROVINCE_FOOD_FACTOR_RECENT_BATTLES	Наслідки битв	true
random_localisation_strings_string_unit_encouraged_flanks_secure	Фланги захищені	true
random_localisation_strings_string_ally_attacked_ally_attack_ally	Між вашими союзниками почалася війна!	true
random_localisation_strings_string_StratHudbutton_Cannot_Recruit_Naval2	Ваш флот вже повний. Щоб побудувати цей корабель, доведеться затопити інший.	true
random_localisation_strings_string_StratHudbutton_Cannot_Recruit_Naval3	Поки порт в блокаді, тут не можна побудувати корабель.	true
random_localisation_strings_string_StratHudbutton_Cannot_Recruit_Naval0	Неможливо побудувати корабель	true
random_localisation_strings_string_StratHudbutton_Cannot_Recruit_Naval1	Вам не вистачає коштів на будівництво цього корабля. Ціна:	true
random_localisation_strings_string_StratHudbutton_Cannot_Recruit_Naval6	Щоб набрати цей загін, спочатку відремонтуйте будівлю для його найму.	true
random_localisation_strings_string_StratHudbutton_Cannot_Recruit_Naval4	Поки порт пошкоджений, тут не можна побудувати корабель.	true
random_localisation_strings_string_no_valid_units	Підхожих загонів у складі війська не виявлено	true
random_localisation_strings_string_StratHudbutton_Cannot_Recruit_Naval5	Поки порт зайнятий ворогом, тут не можна побудувати корабель.	true
random_localisation_strings_string_Recruit_Travel_Turns	Ходи на найм||Число зліва вказує, скільки ходів потрібно для найму цього загону.||Число праворуч показує, скільки ходів загін добиратиметься до полководця, що його призвав.||Уже в поході полководці теж можуть наймати загони. У цьому випадку готові війська будуть відразу відправлятися до свого полководця.	true
random_localisation_strings_string_diplomacy_button_cannot_wed	text_rejected	true
random_localisation_strings_string_tile_upgrade_settlement_no_escalation	Ескалації немає	true
random_localisation_strings_string_left_click_view_tree	Клацніть ЛКМ, щоб переглянути це дерево будівництва.	true
random_localisation_strings_string_ability_disembark_from_ship	Висадитися||Наказ загону покинути корабель.	true
random_localisation_strings_string_ancillary_unlocking_next_turn	[[col:yellow]]Домочадець або предмет переходить до персонажа. Він почне впливати на наступному ході.[[/col]]	true
random_localisation_strings_string_character_situation_zeal_incite_unrest	Підбурювання	true
random_localisation_strings_string_unit_stat_bonus_melee_superior	Відмінний ближній бій	true
random_localisation_strings_string_unit_concerned_flanks_exposed_multiple	Фланги відкриті	true
random_localisation_strings_string_settlement_under_siege	text_rejected	true
random_localisation_strings_string_hosting_error	Помилка сервера	true
random_localisation_strings_string_total_value	Загальна вартість	true
random_localisation_strings_string_captive_option_title_release	Взяти викуп за полонених	true
random_localisation_strings_string_network_error_join_failed_no_response	Не вдалося приєднатися до гри: немає відповіді від сервера	true
random_localisation_strings_string_battle_defeat_minor_decisive	Важка поразка||Немає сумнівів: ця поразка була написана у вас на роду. Ваші люди втекли або мертві.	true
random_localisation_strings_string_diplomacy_button_must_be_at_peace_to_marriage	text_rejected	true
random_localisation_strings_string_battle_defeat_major_decisive	Важка поразка||Істину кажу: ганьба і безчестя заплямували пам'ять про цей день. Це був розгром.	true
random_localisation_strings_string_StratHudbutton_Cannot_Enlist_General0	Неможливо найняти полководця	true
random_localisation_strings_string_StratHudbutton_Cannot_Enlist_General1	У вас вже максимальна кількість полководців.	true
random_localisation_strings_string_StratHudbutton_Cannot_Enlist_General2	У вас немає кандидатів, з яких можна вибрати полководця.	true
random_localisation_strings_string_StratHudbutton_Cannot_Enlist_General3	Ваш флот вже повний. Щоб найняти флотоводця, доведеться затопити корабель.	true
random_localisation_strings_string_StratHudbutton_Cannot_Enlist_General4	Ваша армія вже повна, для найму полководця доведеться розпустити загін.	true
random_localisation_strings_string_StratHudbutton_Cannot_Enlist_General5	Вам не вистачає коштів на найм цього полководця. Ціна:	true
random_localisation_strings_string_player_stats_successful_assassinations	Успішних замовних вбивств	true
random_localisation_strings_string_mission_issued_blockade_port	Заблокувати порт:	true
random_localisation_strings_string_Ship_is_suffering_attrition	Цей корабель зазнав небойових втрат, оскільки знаходиться у відкритому морі. Щоб уникнути подальших втрат, виведіть його із зони ураження.	true
random_localisation_strings_string_fatigue_fresh	Свіжі	true
random_localisation_strings_string_character_type_title_brother	Брат	true
random_localisation_strings_string_agent_help_str_request_allegiance_no_support	Вплив у цій провінції занадто низький. Підніміть вплив вище 50%.	true
random_localisation_strings_string_unit_encouraged_kills	Ворог зазнає втрат	true
random_localisation_strings_string_unit_encouraged_in_column_formation	У колонах	true
random_localisation_strings_string_unit_encouraged_enemy_routing	Ворог тікає	true
random_localisation_strings_string_tech_category_military	text_rejected	true
random_localisation_strings_string_province_colon	Провінція:	true
random_localisation_strings_string_error_twitch_stream	Помилка трансляції в Twitch.tv. Трансляція буде припинена.	true
random_localisation_strings_string_megabytes_formatted	%d МБ	true
random_localisation_strings_string_invalid_units	У складі війська виявлено некоректний тип загону	true
random_localisation_strings_string_trade_agreement_tooltip_no_route_you	Порти вашої провінції повністю завантажені.||Встановити новий морський шлях з вашої столиці неможливо.	true
random_localisation_strings_string_finance_header_upkeep	Утримання	true
random_localisation_strings_string_REGION_FOOD_FACTOR_BASE_FOOD	Базова їжа	true
random_localisation_strings_string_captive_option_title_enslave	Перетворити на рабів	true
random_localisation_strings_string_player_stats_ranked_land_battles_won	Рейтингових сухопутних битв виграно	true
random_localisation_strings_string_left_click_return_list	Клацніть ЛКМ, щоб повернутися до списку будівель.	true
random_localisation_strings_string_network_error_no_steam	text_rejected	true
random_localisation_strings_string_military_force_legacy_name_prefix_navy	Клас	true
random_localisation_strings_string_action_result_type_critical_success	Критичний успіх	true
random_localisation_strings_string_round_id_early_april	Початок квітня	true
random_localisation_strings_string_REGION_FOOD_FACTOR_BUILDINGS	Будівлі	true
random_localisation_strings_string_agent_help_string_cannot_incite_kyoto	text_rejected	true
random_localisation_strings_string_diplomacy_button_cannot_trade_embargo	У вас немає торгових зв'язків, які можна перервати.	true
random_localisation_strings_string_pip_daimyo_tooltip_honour_1	Честь: сумнівна	true
random_localisation_strings_string_pip_daimyo_tooltip_honour_2	Честь: відсутня	true
random_localisation_strings_string_pip_daimyo_tooltip_honour_3	Честь: неперевірена	true
random_localisation_strings_string_pip_daimyo_tooltip_honour_4	Честь: загальновизнана	true
random_localisation_strings_string_pip_daimyo_tooltip_honour_5	Честь: видатна	true
random_localisation_strings_string_pip_daimyo_tooltip_honour_6	Честь: виняткова	true
random_localisation_strings_string_battle_warning_returning_to_postbattle	Вихід з бою:	true
random_localisation_strings_string_mp_ready_error_ai_invalid_army_index	Для ШІ обрано армію, яка вже зайнята. Щоб почати гру, виберіть для нього іншу армію.	true
random_localisation_strings_string_morale_eager	Жадають бою	true
random_localisation_strings_string_technology_tooltip_researching_functionality	ЛКМ - дослідити; ПКМ - дізнатися більше	true
random_localisation_strings_string_Tutorial_Custom_Battle_Warning_Header	Своя битва	true
random_localisation_strings_string_unit_concerned_rear_attacked	Атаковані з тилу	true
random_localisation_strings_string_FACTION_PROVINCE_FOOD_FACTOR_RAIDING	Наліт	true
random_localisation_strings_string_mission_issued_public_order	Відновити громадський порядок:	true
random_localisation_strings_string_agent_help_string_region_in_rebellion	У цій провінції вже активно діють бунтівники.	true
random_localisation_strings_string_player_stats_total_mp_land_battles_won	Мережевих сухопутних битв виграно	true
random_localisation_strings_string_round_id_march	Березень	true
random_localisation_strings_string_replenish_no_selection	Виберіть неповні загони для їх поповнення.	true
random_localisation_strings_string_round_id_late_december	Кінець грудня	true
random_localisation_strings_string_character_situation_subterfuge_spying	Шпигунство	true
random_localisation_strings_string_fe_recruitment_card_tooltip_command_clash_sea	Не можна набрати цей загін, поки в армії немає полководця.	true
random_localisation_strings_string_town_factor_ministers	text_rejected	true
random_localisation_strings_string_technology_status_available	text_rejected	true
random_localisation_strings_string_Tutorial_Custom_Battle_Warning_Content	text_rejected	true
random_localisation_strings_string_unit_stat_bonus_melee_improved	Хороший ближній бій	true
random_localisation_strings_string_StratHudbutton_Cannot_Recruit_Unit8	Щоб набрати тут цей загін, вивчіть і опануйте необхідні технології.	true
random_localisation_strings_string_StratHudbutton_Cannot_Recruit_Unit9	Щоб набрати цей загін, спочатку побудуйте специфічну будівлю.	true
random_localisation_strings_string_StratHudbutton_Cannot_Recruit_Unit2	Вам не вистачає коштів на цей загін. Ціна:	true
random_localisation_strings_string_StratHudbutton_Cannot_Recruit_Unit3	 	true
random_localisation_strings_string_StratHudbutton_Cannot_Recruit_Unit0	Неможливо найняти загін	true
random_localisation_strings_string_StratHudbutton_Cannot_Recruit_Unit1	Цей загін не зможе дістатися до наймача.	true
random_localisation_strings_string_StratHudbutton_Cannot_Recruit_Unit6	Занадто мало жителів, щоб наймати тут війська. Зачекайте, поки населення збільшиться.	true
random_localisation_strings_string_StratHudbutton_Cannot_Recruit_Unit7	Ви вже найняли максимально можливу кількість таких загонів.	true
random_localisation_strings_string_StratHudbutton_Cannot_Recruit_Unit4	Не можна набрати цей загін тут - ви перебуваєте в облозі	true
random_localisation_strings_string_StratHudbutton_Cannot_Recruit_Unit5	Щоб набрати цей загін, спочатку відремонтуйте будівлю для його найму.	true
random_localisation_strings_string_resource_value	Цінність ресурсу	true
random_localisation_strings_string_win_chance_very_high	Дуже високий	true
random_localisation_strings_string_unit_encouraged_overwhelming_friendly_units	Переважаючі місцеві сили	true
random_localisation_strings_string_battle_defeat_close_phyrric	Героїчна поразка||Вороги перемогли, але ця перемога дорого їм коштувала. Їхні трупи вкрили поле битви.	true
random_localisation_strings_string_network_error_join_failed_closed_game	Не вдалося приєднатися до гри: гра вже почалася	true
random_localisation_strings_string_CAMPAIGN_POLITICS_ACTION_TYPE_SPREAD_RUMOURS	Поширення чуток	true
random_localisation_strings_string_ability_drop_siege_equipment	Кинути облогові машини||Наказ загону кинути облогові машини.	true
random_localisation_strings_string_event_log_battle_defeat_close_phyrric	Героїчна поразка	true
random_localisation_strings_string_Unit_not_replenishing_09_expedition	Експедиційні загони можуть отримувати поповнення тільки в таборі або на території союзника.	true
random_localisation_strings_string_Tutorial_Custom_Battle_Warning	text_rejected	true
random_localisation_strings_string_technology_status_unavailable_to_steal	Ця технологія вже відома, або вам не вистачає знань для її використання.	true
random_localisation_strings_string_town_factor_bankruptcy	Скарбниця порожня	true
random_localisation_strings_string_diplomacy_button_need_access_to_cancel_access	Немає договорів про право проходу, які можна розірвати.	true
random_localisation_strings_string_finances_tribute_expenditure_breakdown_other	text_rejected	true
random_localisation_strings_string_network_message_not_responding_client	Один або більше гравців не відповідають. Продовжити очікування або вийти з гри?	true
random_localisation_strings_string_religion_factor_percentage_next_turn	Відсотків на наступний хід: %d%	true
random_localisation_strings_string_fe_unit_card_tooltip_cap_land	Макс. кількість таких загонів - %d на армію.	true
random_localisation_strings_string_FACTION_PROVINCE_FOOD_FACTOR_EDICTS	Едикти	true
random_localisation_strings_string_FACTION_PROVINCE_FOOD_FACTOR_EVENTS	Події	true
random_localisation_strings_string_stats_clan_clan_total_ranked_game_wins	text_rejected	true
random_localisation_strings_string_campaign_type_world_domination	Кампанія «Світове панування»	true
random_localisation_strings_string_stat_ap_damage	Урон крізь обладунки	true
random_localisation_strings_string_food_breakdown	Відомості про їжу	true
random_localisation_strings_string_resource_exporting_percentage_not_full	Розширення торгових шляхів дозволить вивозити більше.	true
random_localisation_strings_string_unit_concerned_flanks_exposed_single	Неприкритий фланг	true
random_localisation_strings_string_military_force_legacy_name_pirate_navy	Піратський флот	true
random_localisation_strings_string_gfx_drop_ultra	Макс.	true
random_localisation_strings_string_mission_issued_trade_agreement	Встановити торговий шлях:	true
random_localisation_strings_string_mp_ready_error_no_map_selected	Мапа не обрана	true
random_localisation_strings_string_finance_header_raided	Наліт	true
random_localisation_strings_string_campaign_type_co_op	Спільна	true
random_localisation_strings_string_predicted_with_units_removed	- прогноз на випадок, якщо обрані загони будуть видалені з гарнізону	true
random_localisation_strings_string_gfx_shader_4_1	Модель 4.1	true
random_localisation_strings_string_trade_agreement_tooltip_existing_route_shifted	Один з діючих морських торгових шляхів можна перенаправити суходолом. ||Так ви зможете прокласти інший морський шлях зі столиці.	true
random_localisation_strings_string_state_religion_change_active	Зміна релігії	true
random_localisation_strings_string_technology_status_researched	text_rejected	true
random_localisation_strings_string_StratHud_Unit_Card_Recruit_Selection	ЛКМ - найняти цей загін; ПКМ - дізнатися більше	true
random_localisation_strings_string_victory_conditions_conquest_tutorial	Захопіть і утримуйте не менше %n провінцій, включаючи наступні:	true
random_localisation_strings_string_FACTION_FOOD_FACTOR_RIVALRY	Внутрішні чвари	true
random_localisation_strings_string_pre_battle_siege_equipment_totals_tooltip_cap	Максимум: %d	true
random_localisation_strings_string_CAMPAIGN_POLITICS_ACTION_TYPE_BRIBE	Підкуп	true
random_localisation_strings_string_character_situation_subterfuge_assassination	Замовні вбивства	true
random_localisation_strings_string_StratHudbutton_cannot_disembark_here	Висадка неможлива||Висадитися неможливо, оскільки ця місцевість непрохідна.	true
random_localisation_strings_string_home_region_expedition	Ні (експедиція)	true
random_localisation_strings_string_fatigue_tired	Втомлені	true
random_localisation_strings_string_network_error_stats_no_steam	text_rejected	true
random_localisation_strings_string_FACTION_FOOD_FACTOR_FERTILITY	Родючість	true
random_localisation_strings_string_mission_issued_form_alliance	Укласти союз:	true
random_localisation_strings_string_FACTION_PROVINCE_FOOD_FACTOR_HORDES	Орди в цій провінції	true
random_localisation_strings_string_morale_20	Вагаються	true
random_localisation_strings_string_benchmark_dialog_title	Вийти з тестового режиму	true
random_localisation_strings_string_military_force_legacy_name_prefix_army	Легіон	true
random_localisation_strings_string_Tutorial_First_Battle_Warning	text_rejected	true
random_localisation_strings_string_battle_time_remaining	Залишилося часу:	true
random_localisation_strings_string_network_error_dropped	Втрачено з'єднання з грою.	true
random_localisation_strings_string_overwrite_legendary_save_warning_text	Почавши нову гру на легендарному рівні складності, ви зітрете поточне збереження на цьому рівні складності. Продовжити?	true
random_localisation_strings_string_campaign_type_short	Швидка кампанія	true
random_localisation_strings_string_network_error_authentication_failed	Щоб почати гру, необхідна авторизація	true
random_localisation_strings_string_mp_ready_error_no_commander	Перед початком бою необхідно додати головнокомандувача.	true
random_localisation_strings_string_finance_header_taxes	Податки	true
random_localisation_strings_string_unit_concerned_attacked_by_projectile	Під обстрілом	true
random_localisation_strings_string_finance_header_other	Інше	true
random_localisation_strings_string_finance_header_mines	Рудники	true
random_localisation_strings_string_event_log_battle_defeat_major_decisive	Важка поразка	true
random_localisation_strings_string_land_combatant_losing_slightly	Загін незначно поступається	true
random_localisation_strings_string_weather_tooltips_storm	Піщана буря||Підпал кораблів, будівель і укріплень займає більше часу.	true
random_localisation_strings_string_August	text_rejected	true
random_localisation_strings_string_mp_ready_error_too_many_armies	Не можна почати гру - на обраній мапі занадто багато гравців. \\nЗмініть мапу або видаліть зайвих гравців.	true
random_localisation_strings_string_campaign_autoresolver_tooltip_stance_naval_defensive	Цей режим більш ефективний, якщо у вас багато стрільців. Його вибір призводить до зменшення втрат.	true
random_localisation_strings_string_agent_help_string_cannot_incite_own_religion	text_rejected	true
random_localisation_strings_string_finance_header_trade	Торгівля	true
random_localisation_strings_string_unit_encouraged_fortification	Всередині укріплення	true
random_localisation_strings_string_character_type_title_general	Полководець	true
random_localisation_strings_string_bribe_nonhostile_panel_title	Спроба маніпуляції	true
random_localisation_strings_string_MILITARY_FORCE_FOOD_FACTOR_FERTILITY	Родючість	true
random_localisation_strings_string_character_role_wife	Дружина	true
random_localisation_strings_string_finance_header_agent_actions	Дії агентів	true
random_localisation_strings_string_finance_header_ransom_battle_captives	Викуп за полонених	true
random_localisation_strings_string_character_situation_land_siege_attack	Облога	true
random_localisation_strings_string_chat_help_text	ПІДКАЗКА\\nФормат команди: /команда аргумент1 аргумент2 \\nПочавши друкувати слово, за допомогою клавіші TAB ви можете вибрати потрібний варіант його закінчення (наприклад, команди чату або імена гравців).\\n\\n Доступні команди:	true
random_localisation_strings_string_Empty_building_warning	Якщо ви не будете розвивати це місце, рано чи пізно на ньому з'являться нетрі.	true
random_localisation_strings_string_Change_Reinforcement_Position	Перетягніть картку загону, щоб змінити його місце в черзі підкріплень.	true
random_localisation_strings_string_class_lower	Нижчий клас	true
random_localisation_strings_string_network_error_title	Помилка	true
random_localisation_strings_string_class_upper	Знать	true
random_localisation_strings_string_victory_conditions_one_vs_one	text_rejected	true
random_localisation_strings_string_region_colon	Регіон:	true
random_localisation_strings_string_diplomacy_button_need_peace_to_trade	text_rejected	true
random_localisation_strings_string_battle_filter_naval	Морські битви	true
random_localisation_strings_string_morale_60	Надійні	true
random_localisation_strings_string_finance_header_total_expenses	Всього витрат	true
random_localisation_strings_string_StratHudbutton_Cannot_Repair_Naval2	Ремонтувати кораблі можна тільки в порту	true
random_localisation_strings_string_StratHudbutton_Cannot_Repair_Naval0	Ремонт неможливий	true
random_localisation_strings_string_StratHudbutton_Cannot_Repair_Naval1	Вам не вистачає коштів на ремонт. Ціна:	true
random_localisation_strings_string_trade_status_tooltip_cannot	Не може торгувати	true
random_localisation_strings_string_player_stats_num_pistol_duels	text_rejected	true
random_localisation_strings_string_Unit_not_replenishing_09	Орди можуть поповнювати війська тільки в таборі або на території союзника.	true
random_localisation_strings_string_Unit_not_replenishing_08	- Цей флот не в дружніх водах.	true
random_localisation_strings_string_Unit_not_replenishing_05	- Ваша скарбниця порожня.	true
random_localisation_strings_string_Unit_not_replenishing_04	- В облозі.	true
random_localisation_strings_string_Unit_not_replenishing_07	- Ця армія не на дружній території.	true
random_localisation_strings_string_Unit_not_replenishing_06	- Нестача продовольства.	true
random_localisation_strings_string_Unit_not_replenishing_01	Неможливо поповнити цей загін, оскільки:	true
random_localisation_strings_string_Unit_not_replenishing_03	- У цьому війську немає полководця.	true
random_localisation_strings_string_Unit_not_replenishing_02	- Недавні події	true
random_localisation_strings_string_round_id_early_january	Початок січня	true
random_localisation_strings_string_StratHudbutton_Cannot_Recruit_Geisha2	Вам не вистачає коштів на найм цього агента. Ціна:	true
random_localisation_strings_string_character_situation_subterfuge_sabotage_army	Диверсія у військах	true
random_localisation_strings_string_auto_save_filename_legendary	auto_save_legendary	true
random_localisation_strings_string_stats_clan_best_clan_map_rank	text_rejected	true
random_localisation_strings_string_gempei_religion_colon	Підданство:	true
random_localisation_strings_string_StratHudbutton_cannot_enlist_no_cand	text_rejected	true
random_localisation_strings_string_morale_40	Покірні	true
random_localisation_strings_string_mp_ready_error_no_siege_units	Вам необхідно набрати піхотні загони або далекобійні машини, здатні штурмувати укріплення.	true
random_localisation_strings_string_Unit_not_replenishing_10	Ворожа армія в регіоні перешкоджає поповненню	true
random_localisation_strings_string_tax_level_4	Здирницька	true
random_localisation_strings_string_tax_level_0	Мінімальна	true
random_localisation_strings_string_tax_level_1	Низька	true
random_localisation_strings_string_tax_level_2	Нормальна	true
random_localisation_strings_string_tax_level_3	Висока	true
random_localisation_strings_string_ship_card_red_captured	Цей корабель був захоплений ворогом!	true
random_localisation_strings_string_fe_unit_card_tooltip_cap_naval	Макс. число таких кораблів - %d на флот.	true
random_localisation_strings_string_StratHudbutton_Cannot_Recruit_Metuske2	Вам не вистачає коштів на найм цього агента. Ціна:	true
random_localisation_strings_string_trade_route_tooltip_neutral	(інше)	true
random_localisation_strings_string_cannot_merge_agent_not_enough_action_points	Цьому агенту не вистачає очок дій, щоб дістатися до іншого війська.	true
random_localisation_strings_string_player_stats_successful_duels	Успішних поєдинків	true
random_localisation_strings_string_FACTION_PROVINCE_FOOD_FACTOR_ARMIES	Ворожі армії в цій провінції	true
random_localisation_strings_string_conversion_factor_characters_christian	text_rejected	true
random_localisation_strings_string_land_combatant_winning	Загін перемагає	true
random_localisation_strings_string_repair_prerequisites_not_met	Щоб полагодити вибрані кораблі, необхідно перебувати в порту і мати достатньо коштів. Ціна:	true
random_localisation_strings_string_agent_recruitment_insufficient_money	[[col:red]]У вашій скарбниці недостатньо грошей, щоб найняти цього агента.[[/col]]	true
random_localisation_strings_string_trade_status_tooltip_value_potential	Ймовірна ціна:	true
random_localisation_strings_string_weather_tooltips_snow	Сніг||У снігу загони повільніше переміщаються і довше відновлюють сили.	true
random_localisation_strings_string_Empty_building	Будівельний майданчик ||Тут можна зводити нові споруди.	true
random_localisation_strings_string_unit_encouraged_general_nearby	Полководець поблизу	true
random_localisation_strings_string_unit_concerned_friends_routing	Союзники тікають	true
random_localisation_strings_string_public_order	Поточний громад. порядок	true
random_localisation_strings_string_trade_route	Торговий шлях	true
random_localisation_strings_string_agent_recruitment_reduced_bodyguard	[[col:red]]Недостатньо коштів - наявний загін охоронців буде укомплектований не повністю.[[/col]]	true
random_localisation_strings_string_FACTION_FOOD_FACTOR_BUILDINGS	Будівлі	true
random_localisation_strings_string_SkillTree_Skill_Unavailable_Function_Tooltip_0	Недоступно	true
random_localisation_strings_string_character_situation_zeal_inspire_town	text_rejected	true
random_localisation_strings_string_SkillTree_Skill_Unavailable_Function_Tooltip_1	Для придбання недостатньо очок умінь.	true
random_localisation_strings_string_SkillTree_Skill_Unavailable_Function_Tooltip_2	У вас немає необхідних умінь.	true
random_localisation_strings_string_SkillTree_Skill_Unavailable_Function_Tooltip_3	Це вміння відноситься до іншої гілки.	true
random_localisation_strings_string_trade_node_tooltip_predicted_supply	очікуване надходження припасів	true
random_localisation_strings_string_player_stats_ranked_land_battles_lost	Рейтингових сухопутних битв програно	true
random_localisation_strings_string_stats_clan_current_highest_ranked_4v4_clan_team_na	text_rejected	true
random_localisation_strings_string_mission_issued_build_building	Побудувати будівлю:	true
random_localisation_strings_string_campaign_difficulty_slider_legendary	Ручне збереження в режимі кампанії неможливе. Під час паузи в бою не можна віддавати накази.	true
random_localisation_strings_string_campaign_type_prestige	Важлива перемога	true
random_localisation_strings_string_controls_empty	<Порожньо>	true
random_localisation_strings_string_fe_recruitment_card_tooltip_required_ancillary	Щоб використовувати цей предмет, потрібен наступний домочадець вашого персонажа:	true
random_localisation_strings_string_town_factor_discontent	Невдоволення	true
random_localisation_strings_string_FACTION_FOOD_FACTOR_BASE_FOOD	Базова їжа	true
random_localisation_strings_string_event_log_battle_victory_minor_close	Важ. перемога	true
random_localisation_strings_string_diplomacy_button_cannot_military_access_war	text_rejected	true
random_localisation_strings_string_weather_storm	Буря	true
random_localisation_strings_string_diplomacy_header_other_clans	text_rejected	true
random_localisation_strings_string_campaign_autoresolver_tooltip_stance_siege_defensive	Цей режим більш ефективний, якщо у вас багато стрільців. Його вибір призводить до зменшення втрат.	true
random_localisation_strings_string_unit_card_lost_hero_disbanded	text_rejected	true
random_localisation_strings_string_morale_80	Віддані	true
random_localisation_strings_string_player_stats_friendly_units_rallied	Макс. союзних загонів зібрано	true
random_localisation_strings_string_agent_cannot_act_force_full	Кількість агентів у цьому війську вже досягла максимуму.	true
random_localisation_strings_string_front_end_unit_size_with_fleet_tooltip	Змінює максимально допустиму чисельність загонів і флотів. Знизьте значення, щоб істотно підвищити продуктивність гри під час битв.	true
random_localisation_strings_string_region_specialty_stone	text_rejected	true
random_localisation_strings_string_region_specialty_iron_mining	text_rejected	true
random_localisation_strings_string_finance_header_income	Дохід	true
random_localisation_strings_string_action_result_type_critical_failure	Критична невдача	true
random_localisation_strings_string_stat_xp_value	Додатковий досвід	true
random_localisation_strings_string_stats_clan_current_highest_ranked_2v2_clan_team_na	text_rejected	true
random_localisation_strings_string_town_factor_education	Освіта	true
random_localisation_strings_string_stats_clan_current_clan_ladder_rank	text_rejected	true
random_localisation_strings_string_unit_concerned_fear_enemy_unit	Налякані ворожим загоном	true
random_localisation_strings_string_trade_route_tooltip_raid_value	Ціна нальоту на торгові шляхи:	true
random_localisation_strings_string_StratHudbutton_Ruined_Building	Зруйнована будівля||До завершення ремонту ця будівля не функціонує.	true
random_localisation_strings_string_finances_tribute_expenditure_breakdown_faction	%S (залишилося ходів: %d)	true
random_localisation_strings_string_round_id_late_february	Кінець лютого	true
random_localisation_strings_string_tech_required_for_construction	text_rejected	true
random_localisation_strings_string_diplomacy_button_no_trade_to_demand_they_break	text_rejected	true
random_localisation_strings_string_MILITARY_FORCE_FOOD_FACTOR_CHARACTERS	Персонажі	true
random_localisation_strings_string_building_under_construction_damaged_demolish	Клацніть тут, щоб скасувати ремонт недобудованих будівель.	true
random_localisation_strings_string_event_log_rebellion_christian	text_rejected	true
random_localisation_strings_string_replenish_selection	Відновити втрати загонів у вибраній групі. Ціна:	true
random_localisation_strings_string_stats_clan_current_highest_ranked_3v3_clan_team_na	text_rejected	true
random_localisation_strings_string_character_situation_land_siege_defence	Захист в облозі	true
random_localisation_strings_string_cannot_enter_enemy_zoc	Неможливо входити в зону контролю ворожої групи, крім як для атаки.	true
random_localisation_strings_string_round_id_late_november	Кінець листопада	true
random_localisation_strings_string_Single	Одиночна	true
random_localisation_strings_string_ability_formed_attack	Атака в строю||Ця група намагається зберігати бойовий порядок в ближньому бою.	true
random_localisation_strings_string_unit_card_lost_men_captured	Ця група захоплена ворогом.	true
random_localisation_strings_string_tech_building_tooltip2	text_rejected	true
random_localisation_strings_string_tech_building_tooltip1	text_rejected	true
random_localisation_strings_string_finance_header_civic	Цивільні справи	true
random_localisation_strings_string_MILITARY_FORCE_FOOD_FACTOR_BASE_FOOD	Базова їжа	true
random_localisation_strings_string_confirm_delete_title	Підтвердити видалення	true
random_localisation_strings_string_cancel_demolish_building_once_settled	Щоб завершити знесення цієї споруди, орда повинна осісти. ЛКМ - скасувати наказ про знесення.	true
random_localisation_strings_string_clan_promotion	text_rejected	true
random_localisation_strings_string_tech_category_enlightenment	text_rejected	true
random_localisation_strings_string_conversion_factor_buildings_christian	text_rejected	true
random_localisation_strings_string_MILITARY_FORCE_FOOD_FACTOR_BUILDINGS	Споруди	true
random_localisation_strings_string_weather_tooltips_rain	Дощ||Підпал кораблів, споруд і укріплень займає більше часу.	true
