key	text	tooltip
#Loc;1;text/db/vo_unit_texts.loc		
vo_unit_texts_text_Naval_UO_BA_Double_Click_Move_To_05att_cult_eastern	Get moving!	true
vo_unit_texts_text_Land_US_RO_Selection_Perioikoi_Hoplitesatt_cult_eastern	Perioikoi Hoplites!	true
vo_unit_texts_text_Naval_UO_BA_Double_Click_Move_To_04att_cult_eastern	Get to the oars!	true
vo_unit_texts_text_Naval_UO_BA_Double_Click_Move_To_03att_cult_eastern	Move out, double time!	true
vo_unit_texts_text_Naval_UO_BA_Double_Click_Move_To_02att_cult_eastern	Set a course!	true
vo_unit_texts_text_Naval_UO_BA_Double_Click_Move_To_01att_cult_eastern	Row, curse you!	true
vo_unit_texts_text_Land_US_RO_Selection_Hellenic_Royal_Guardatt_cult_eastern	Hellenic Royal Guard!	true
vo_unit_texts_text_Land_US_RO_Selection_Socii_Extraordinariiatt_cult_eastern	Socii Extraordinarii!	true
vo_unit_texts_text_Naval_UO_EA_Single_Click_Move_To_04att_cult_eastern	Move to position!	true
vo_unit_texts_text_Naval_UO_EA_Single_Click_Move_To_05att_cult_eastern	Get moving!	true
vo_unit_texts_text_Naval_UO_EA_Single_Click_Move_To_01att_cult_eastern	Move out!	true
vo_unit_texts_text_Naval_UO_EA_Single_Click_Move_To_02att_cult_eastern	To the oars!	true
vo_unit_texts_text_Naval_UO_EA_Single_Click_Move_To_03att_cult_eastern	Set the oars!	true
vo_unit_texts_text_Land_UO_EA_Double_Click_Move_To_Heightened_04att_cult_eastern	Double time!	true
vo_unit_texts_text_Land_UO_EA_Double_Click_Move_To_Heightened_05att_cult_eastern	Advance at speed!	true
vo_unit_texts_text_Land_UO_EA_Double_Click_Move_To_Heightened_02att_cult_eastern	Quick march!	true
vo_unit_texts_text_Land_UO_EA_Double_Click_Move_To_Heightened_03att_cult_eastern	At speed!	true
vo_unit_texts_text_Land_UO_BA_Single_Click_Move_To_Heightened_01att_cult_barbarian	Move out!	true
vo_unit_texts_text_Land_UO_BA_Single_Click_Move_To_Heightened_02att_cult_barbarian	Get moving!	true
vo_unit_texts_text_Land_UO_BA_Single_Click_Move_To_Heightened_03att_cult_barbarian	Warriors on me!	true
vo_unit_texts_text_Land_UO_BA_Single_Click_Move_To_Heightened_04att_cult_barbarian	Lets go!	true
vo_unit_texts_text_Land_UO_BA_Single_Click_Move_To_Heightened_05att_cult_barbarian	Follow me!	true
vo_unit_texts_text_Land_UO_EA_Double_Click_Move_To_Heightened_01att_cult_eastern	At the double!	true
vo_unit_texts_text_Land_SA_EA_Into_the_Breach_01att_cult_eastern	Fight, push through!	true
vo_unit_texts_text_Land_SA_EA_Into_the_Breach_03att_cult_eastern	Into the breach!	true
vo_unit_texts_text_Land_SA_EA_Into_the_Breach_02att_cult_eastern	The Gods carry us!	true
vo_unit_texts_text_Land_SA_RO_Brace!_Group_01att_cult_roman	Brace!	true
vo_unit_texts_text_Land_SA_RO_Brace!_Group_02att_cult_roman	Prepare  for impact!	true
vo_unit_texts_text_Land_SA_RO_Brace!_Group_03att_cult_roman	Brace yourselves!	true
vo_unit_texts_text_Land_SA_BA_Screech_01att_cult_barbarian	I'll killl yeeee!	true
vo_unit_texts_text_Land_SA_BA_Screech_02att_cult_barbarian	Ahhhh!	true
vo_unit_texts_text_Land_SA_BA_Screech_03att_cult_barbarian	*high pitched scream*	true
vo_unit_texts_text_Naval_UO_RO_Stop_Turning_01att_cult_roman	Halt the turn!	true
vo_unit_texts_text_Naval_UO_RO_Stop_Turning_02att_cult_roman	Cease turning!	true
vo_unit_texts_text_Naval_UO_RO_Stop_Turning_03att_cult_roman	Stop the turn!	true
vo_unit_texts_text_Naval_UO_RO_Stop_Turning_04att_cult_roman	Halt turning!	true
vo_unit_texts_text_Naval_UO_RO_Stop_Turning_05att_cult_roman	Stop turning, now!	true
vo_unit_texts_text_Land_UO_RO_Skirmish_Rightatt_cult_roman	Skirmish right! 	true
vo_unit_texts_text_Land_Mounted_UO_RO_Double_Click_Move_To_01att_cult_roman	Riders, at the double!	true
vo_unit_texts_text_Land_Mounted_UO_RO_Double_Click_Move_To_02att_cult_roman	Forward!	true
vo_unit_texts_text_Land_Mounted_UO_RO_Double_Click_Move_To_03att_cult_roman	Quickly now!	true
vo_unit_texts_text_Land_Mounted_UO_RO_Double_Click_Move_To_04att_cult_roman	Riders, advance!	true
vo_unit_texts_text_Land_Mounted_UO_RO_Double_Click_Move_To_05att_cult_roman	Advance at speed!	true
vo_unit_texts_text_Naval_US_RO_Selection_Assault_Ship_01att_cult_eastern	Assault ships reporting!	true
vo_unit_texts_text_Naval_US_RO_Selection_Assault_Ship_03att_cult_eastern	Assault ships ready for orders!	true
vo_unit_texts_text_Naval_US_RO_Selection_Assault_Ship_02att_cult_eastern	Crewed and ready!	true
vo_unit_texts_text_Naval_US_RO_Selection_Assault_Ship_05att_cult_eastern	Ready, willing and able!	true
vo_unit_texts_text_Naval_US_RO_Selection_Assault_Ship_04att_cult_eastern	Assault ships ready to attack!	true
vo_unit_texts_text_Land_UO_EA_Generic_Order_Carthage_01att_cult_eastern	For Ba'al Hammon!	true
vo_unit_texts_text_Land_UO_EA_Generic_Order_Carthage_03att_cult_eastern	Proud sons of Carthage!	true
vo_unit_texts_text_Land_UO_EA_Generic_Order_Carthage_02att_cult_eastern	For Carthage!	true
vo_unit_texts_text_Land_UO_EA_Generic_Order_Carthage_05att_cult_eastern	For the people of Carthage!	true
vo_unit_texts_text_Land_UO_EA_Generic_Order_Carthage_04att_cult_eastern	Servants of Ba'al Hammon!	true
vo_unit_texts_text_Land_Mounted_US_RO_Selection_Italian_Noble_Cavalryatt_cult_roman	Italian Noble Cavalry!	true
vo_unit_texts_text_Naval_US_BA_Selection_Scorpiosatt_cult_barbarian	Scorpios ready!	true
vo_unit_texts_text_Naval_UO_RO_Go_Straight_01att_cult_roman	Hold the course!	true
vo_unit_texts_text_Naval_UO_RO_Go_Straight_02att_cult_roman	Straight ahead!	true
vo_unit_texts_text_Naval_UO_RO_Go_Straight_03att_cult_roman	Keep a steady course!	true
vo_unit_texts_text_Naval_UO_RO_Go_Straight_04att_cult_roman	Hold straight!	true
vo_unit_texts_text_Naval_UO_RO_Go_Straight_05att_cult_roman	Straight course!	true
vo_unit_texts_text_Land_SA_BA_Break_Off_01att_cult_barbarian	Break off!	true
vo_unit_texts_text_Land_SA_BA_Break_Off_02att_cult_barbarian	Back! Live to fight another day!	true
vo_unit_texts_text_Land_SA_BA_Break_Off_03att_cult_barbarian	Get out!	true
vo_unit_texts_text_Naval_GO_RO_Group_Created_04att_cult_eastern	Grouped and awaiting orders!	true
vo_unit_texts_text_Naval_GO_RO_Group_Created_05att_cult_eastern	Battle group ready!	true
vo_unit_texts_text_Naval_GO_RO_Group_Created_01att_cult_eastern	Battle group ready and awaiting orders!	true
vo_unit_texts_text_Naval_GO_RO_Group_Created_02att_cult_eastern	Grouped and ready!	true
vo_unit_texts_text_Naval_GO_RO_Group_Created_03att_cult_eastern	Battle group awaiting orders!	true
vo_unit_texts_text_Land_UR_BA_Move_To_01att_cult_barbarian	Moving!	true
vo_unit_texts_text_Land_UR_BA_Move_To_02att_cult_barbarian	Huh!	true
vo_unit_texts_text_Land_UR_BA_Move_To_03att_cult_barbarian	On the move!	true
vo_unit_texts_text_Land_UR_BA_Move_To_04att_cult_barbarian	Heading out!	true
vo_unit_texts_text_Land_UR_BA_Move_To_05att_cult_barbarian	Hah!	true
vo_unit_texts_text_Naval_UO_RO_Single_Click_Attack_01att_cult_roman	Attack!	true
vo_unit_texts_text_Naval_UO_RO_Single_Click_Attack_02att_cult_roman	Engage the enemy!	true
vo_unit_texts_text_Naval_UO_RO_Single_Click_Attack_03att_cult_roman	For honour and glory!	true
vo_unit_texts_text_Naval_UO_RO_Single_Click_Attack_04att_cult_roman	Forward!	true
vo_unit_texts_text_Naval_UO_RO_Single_Click_Attack_05att_cult_roman	Kill them!	true
vo_unit_texts_text_Land_SA_EA_Steady_Retreat_03att_cult_eastern	Withdraw!	true
vo_unit_texts_text_Land_SA_EA_Steady_Retreat_02att_cult_eastern	Fall back!	true
vo_unit_texts_text_Land_SA_EA_Steady_Retreat_01att_cult_eastern	Retreat!	true
vo_unit_texts_text_Land_US_EA_Selection_Infantry_spearmen_generic_4att_cult_eastern	Our spears are yours!	true
vo_unit_texts_text_Land_US_RO_Selection_Infantry_spearmen_generic_4att_cult_eastern	Spearmen, ready for orders!	true
vo_unit_texts_text_Land_US_EA_Selection_Infantry_spearmen_generic_5att_cult_eastern	Spearmen ready for orders!	true
vo_unit_texts_text_Land_US_RO_Selection_Infantry_spearmen_generic_5att_cult_eastern	Spearmen at the ready!	true
vo_unit_texts_text_Land_US_EA_Selection_Infantry_spearmen_generic_2att_cult_eastern	Spears at your command!	true
vo_unit_texts_text_Land_US_RO_Selection_Infantry_spearmen_generic_2att_cult_eastern	Spear infantry at your command!	true
vo_unit_texts_text_Land_US_EA_Selection_Infantry_spearmen_generic_3att_cult_eastern	Spearmen!	true
vo_unit_texts_text_Land_US_RO_Selection_Infantry_spearmen_generic_3att_cult_eastern	Spears ready!	true
vo_unit_texts_text_Land_US_EA_Selection_Infantry_spearmen_generic_1att_cult_eastern	Spears ready!	true
vo_unit_texts_text_Land_US_RO_Selection_Infantry_spearmen_generic_1att_cult_eastern	Spear infantry ready!	true
vo_unit_texts_text_Naval_UO_BA_Double_Click_Move_To_Heightened_01att_cult_eastern	Row, curse you!	true
vo_unit_texts_text_Naval_UO_BA_Double_Click_Move_To_Heightened_02att_cult_eastern	Set a course!	true
vo_unit_texts_text_Naval_UO_EA_Double_Click_Move_To_Heightened_05att_cult_eastern	Set a course!	true
vo_unit_texts_text_Naval_UO_BA_Double_Click_Move_To_Heightened_03att_cult_eastern	Move out, double time!	true
vo_unit_texts_text_Naval_UO_EA_Double_Click_Move_To_Heightened_04att_cult_eastern	Full speed ahead!	true
vo_unit_texts_text_Naval_UO_BA_Double_Click_Move_To_Heightened_04att_cult_eastern	Get to the oars!	true
vo_unit_texts_text_Naval_UO_EA_Double_Click_Move_To_Heightened_03att_cult_eastern	To oars, double time!	true
vo_unit_texts_text_Naval_UO_BA_Double_Click_Move_To_Heightened_05att_cult_eastern	Get moving!	true
vo_unit_texts_text_Naval_UO_EA_Double_Click_Move_To_Heightened_02att_cult_eastern	Hard on the oars!	true
vo_unit_texts_text_Naval_UO_EA_Double_Click_Move_To_Heightened_01att_cult_eastern	Row!	true
vo_unit_texts_text_Land_UO_EA_Skirmish_Centreatt_cult_eastern	Centre skirmish! 	true
vo_unit_texts_text_Naval_SA_EA_Use_the_Whip_02att_cult_eastern	Row you dogs!	true
vo_unit_texts_text_Naval_SA_EA_Use_the_Whip_03att_cult_eastern	Harder! Put your backs in to it!	true
vo_unit_texts_text_Naval_SA_EA_Use_the_Whip_01att_cult_eastern	Pull! Or you'll be sorry!	true
vo_unit_texts_text_Land_SA_RO_Rally_01att_cult_roman	Rally to me!	true
vo_unit_texts_text_Land_SA_RO_Rally_02att_cult_roman	Strength and honour!	true
vo_unit_texts_text_Land_SA_RO_Rally_03att_cult_roman	Never surrender!	true
vo_unit_texts_text_Land_UO_EA_Attack_Parthia_04att_cult_eastern	Unleash the Daevas!	true
vo_unit_texts_text_Land_UO_EA_Attack_Parthia_05att_cult_eastern	We will have their skins!	true
vo_unit_texts_text_Land_UO_EA_Attack_Parthia_02att_cult_eastern	The King demands blood!	true
vo_unit_texts_text_Land_UO_EA_Attack_Parthia_03att_cult_eastern	Attack! For the King!	true
vo_unit_texts_text_Land_UO_EA_Attack_Parthia_01att_cult_eastern	They will bow!	true
vo_unit_texts_text_Land_UO_RO_Skirmish_On_01att_cult_roman	Skirmish!	true
vo_unit_texts_text_Land_UO_RO_Skirmish_On_02att_cult_roman	Open the ranks!	true
vo_unit_texts_text_Land_UO_RO_Skirmish_On_03att_cult_roman	Skirmish lines!	true
vo_unit_texts_text_Land_UO_RO_Skirmish_On_04att_cult_roman	Double the ranks!	true
vo_unit_texts_text_Land_UO_RO_Skirmish_On_05att_cult_roman	Open the lines!	true
vo_unit_texts_text_Land_US_BA_Selection_Artillery_siege_generic_1att_cult_barbarian	Siege engines!	true
vo_unit_texts_text_Land_US_BA_Selection_Artillery_siege_generic_2att_cult_barbarian	Siege artillery!	true
vo_unit_texts_text_Land_US_BA_Selection_Artillery_siege_generic_3att_cult_barbarian	Death from above!	true
vo_unit_texts_text_Naval_US_BA_Selection_Support_Ship_01att_cult_barbarian	Support ships ready!	true
vo_unit_texts_text_Naval_US_BA_Selection_Support_Ship_02att_cult_barbarian	Our missiles await your word!	true
vo_unit_texts_text_Naval_US_BA_Selection_Support_Ship_03att_cult_barbarian	Support ships ready and waiting!	true
vo_unit_texts_text_Naval_US_BA_Selection_Support_Ship_04att_cult_barbarian	Support ships at your command!	true
vo_unit_texts_text_Naval_US_BA_Selection_Support_Ship_05att_cult_barbarian	At your command, support ships!	true
vo_unit_texts_text_Land_UO_RO_Attack_Macedon_01att_cult_roman	Attack you sons of Aries!	true
vo_unit_texts_text_Land_UO_RO_Attack_Macedon_02att_cult_roman	Glory to Macedon!	true
vo_unit_texts_text_Land_UO_RO_Attack_Macedon_03att_cult_roman	Hades take our enemies!	true
vo_unit_texts_text_Land_UO_RO_Attack_Macedon_04att_cult_roman	For Zeus!	true
vo_unit_texts_text_Land_UO_RO_Attack_Macedon_05att_cult_roman	Attack, brave sons of Macedon!	true
vo_unit_texts_text_Land_UR_RO_Attack_Macedon_01att_cult_roman	Ares! Hear us!	true
vo_unit_texts_text_Land_UR_RO_Attack_Macedon_02att_cult_roman	Glory to Macedon!	true
vo_unit_texts_text_Land_UR_RO_Attack_Macedon_03att_cult_roman	Send them to Hades!	true
vo_unit_texts_text_Land_UR_RO_Attack_Macedon_04att_cult_roman	Zeus!	true
vo_unit_texts_text_Land_UR_RO_Attack_Macedon_05att_cult_roman	Victory to Macedon!	true
vo_unit_texts_text_Naval_UO_BA_Single_Click_Move_To_04att_cult_eastern	Move out!	true
vo_unit_texts_text_Naval_UO_BA_Single_Click_Move_To_05att_cult_eastern	Row!	true
vo_unit_texts_text_Naval_UO_BA_Single_Click_Move_To_01att_cult_eastern	Moving out!	true
vo_unit_texts_text_Naval_UO_BA_Single_Click_Move_To_02att_cult_eastern	To the oars!	true
vo_unit_texts_text_Naval_UO_BA_Single_Click_Move_To_03att_cult_eastern	Set oars!	true
vo_unit_texts_text_Land_Mounted_UO_RO_Mount_01att_cult_roman	Mount up!	true
vo_unit_texts_text_Land_Mounted_UO_RO_Mount_02att_cult_roman	To the saddle!	true
vo_unit_texts_text_Land_Mounted_UO_RO_Mount_03att_cult_roman	Mount!	true
vo_unit_texts_text_Land_Mounted_UO_RO_Mount_04att_cult_roman	Mount up, men!	true
vo_unit_texts_text_Land_Mounted_UO_RO_Mount_05att_cult_roman	Riders, mount up!	true
vo_unit_texts_text_Naval_UO_RO_Increase_Rowing_Speed_01att_cult_roman	Increase speed!	true
vo_unit_texts_text_Naval_UO_RO_Increase_Rowing_Speed_02att_cult_roman	Full speed ahead!	true
vo_unit_texts_text_Naval_UO_RO_Increase_Rowing_Speed_03att_cult_roman	Row! Curse you, row!	true
vo_unit_texts_text_Naval_UO_RO_Increase_Rowing_Speed_04att_cult_roman	Hard on the oars!	true
vo_unit_texts_text_Naval_UO_RO_Increase_Rowing_Speed_05att_cult_roman	Faster!	true
vo_unit_texts_text_Land_US_RO_Selection_Bactrian_Royal_Guardatt_cult_eastern	Bactrian Royal Guard!	true
vo_unit_texts_text_Land_Mounted_US_EA_Selection_Cappadocian_Cavalryatt_cult_eastern	Cappadocian Cavalry!	true
vo_unit_texts_text_Naval_US_BA_Selection_Short_01att_cult_barbarian	Ships ready!	true
vo_unit_texts_text_Naval_US_BA_Selection_Short_02att_cult_barbarian	Aye!	true
vo_unit_texts_text_Naval_US_BA_Selection_Short_03att_cult_barbarian	Ships, aye!	true
vo_unit_texts_text_Naval_US_BA_Selection_Short_04att_cult_barbarian	Oars, aye!	true
vo_unit_texts_text_Naval_US_BA_Selection_Short_05att_cult_barbarian	Ready! 	true
vo_unit_texts_text_Naval_UO_EA_Double_Click_Move_To_05att_cult_eastern	Set a course!	true
vo_unit_texts_text_Naval_UO_EA_Double_Click_Move_To_04att_cult_eastern	Full speed ahead!	true
vo_unit_texts_text_Naval_UO_EA_Double_Click_Move_To_03att_cult_eastern	To oars, double time!	true
vo_unit_texts_text_Naval_UO_EA_Double_Click_Move_To_02att_cult_eastern	Hard on the oars!	true
vo_unit_texts_text_Naval_UO_EA_Double_Click_Move_To_01att_cult_eastern	Row!	true
vo_unit_texts_text_Land_Mounted_UO_EA_Single_Click_Move_To_Heightened_01att_cult_eastern	Riders, forward!	true
vo_unit_texts_text_Land_Mounted_UO_EA_Single_Click_Move_To_Heightened_03att_cult_eastern	Ride out!	true
vo_unit_texts_text_Land_Mounted_UO_EA_Single_Click_Move_To_Heightened_02att_cult_eastern	Riders, on me!	true
vo_unit_texts_text_Land_Mounted_UO_EA_Single_Click_Move_To_Heightened_05att_cult_eastern	Follow me!	true
vo_unit_texts_text_Land_Mounted_UO_EA_Single_Click_Move_To_Heightened_04att_cult_eastern	Riders, move out!	true
vo_unit_texts_text_Land_SA_EA_Inspire_Group_01att_cult_eastern	For our lord and master!	true
vo_unit_texts_text_Land_SA_EA_Inspire_Group_03att_cult_eastern	The Gods protect us!	true
vo_unit_texts_text_Land_SA_EA_Inspire_Group_02att_cult_eastern	For honour and glory!	true
vo_unit_texts_text_Land_Mounted_UO_RO_Single_Click_Move_To_01att_cult_roman	Riders, forward!	true
vo_unit_texts_text_Land_Mounted_UO_RO_Single_Click_Move_To_02att_cult_roman	Riders, on me!	true
vo_unit_texts_text_Land_Mounted_UO_RO_Single_Click_Move_To_03att_cult_roman	Ride out!	true
vo_unit_texts_text_Land_Mounted_UO_RO_Single_Click_Move_To_04att_cult_roman	Riders, move out!	true
vo_unit_texts_text_Land_Mounted_UO_RO_Single_Click_Move_To_05att_cult_roman	Follow me!	true
vo_unit_texts_text_Naval_US_RO_Selection_Harpaxatt_cult_roman	Harpax armed and ready!	true
vo_unit_texts_text_Naval_US_RO_Selection_Corvusatt_cult_roman	Corvus ready!	true
vo_unit_texts_text_Naval_UO_BA_Attack_Close_Quarters_02att_cult_eastern	Warriors ready!	true
vo_unit_texts_text_Naval_UO_EA_Attack_Close_Quarters_02att_cult_eastern	Show them steel!	true
vo_unit_texts_text_Naval_UO_BA_Attack_Close_Quarters_03att_cult_eastern	Hack 'em down!	true
vo_unit_texts_text_Naval_UO_EA_Attack_Close_Quarters_03att_cult_eastern	Hack them down!	true
vo_unit_texts_text_Naval_UO_BA_Attack_Close_Quarters_01att_cult_eastern	Get at 'em!	true
vo_unit_texts_text_Naval_UO_EA_Attack_Close_Quarters_01att_cult_eastern	Close to attack!	true
vo_unit_texts_text_Naval_UO_BA_Attack_Close_Quarters_04att_cult_eastern	Weapons ready!	true
vo_unit_texts_text_Naval_UO_EA_Attack_Close_Quarters_04att_cult_eastern	Weapons ready!	true
vo_unit_texts_text_Naval_UO_BA_Attack_Close_Quarters_05att_cult_eastern	Attack!	true
vo_unit_texts_text_Naval_UO_EA_Attack_Close_Quarters_05att_cult_eastern	Attack!	true
vo_unit_texts_text_Land_US_BA_Selection_Britons_01att_cult_barbarian	Warriors of Briton!	true
vo_unit_texts_text_Land_US_BA_Selection_Britons_02att_cult_barbarian	Proud sons of Briton!	true
vo_unit_texts_text_Land_US_BA_Selection_Britons_03att_cult_barbarian	The oaks are our strength!	true
vo_unit_texts_text_Land_US_BA_Selection_Britons_04att_cult_barbarian	Ancestors honour us!	true
vo_unit_texts_text_Land_US_BA_Selection_Britons_05att_cult_barbarian	Sons of the Oak!	true
vo_unit_texts_text_Land_US_BA_Selection_Balearic_Slingersatt_cult_barbarian	Balearic Slingers!	true
vo_unit_texts_text_Land_UO_RO_Double_Click_Move_To_01att_cult_roman	At the double!	true
vo_unit_texts_text_Land_UO_RO_Double_Click_Move_To_02att_cult_roman	Quick march!	true
vo_unit_texts_text_Land_UO_RO_Double_Click_Move_To_03att_cult_roman	At speed!	true
vo_unit_texts_text_Land_UO_RO_Double_Click_Move_To_04att_cult_roman	Double time!	true
vo_unit_texts_text_Land_UO_RO_Double_Click_Move_To_05att_cult_roman	Advance at speed!	true
vo_unit_texts_text_Land_UR_RO_Attack_01att_cult_roman	Ahhhh!	true
vo_unit_texts_text_Land_UR_RO_Attack_02att_cult_roman	Kill!	true
vo_unit_texts_text_Land_UR_RO_Attack_03att_cult_roman	Attack!	true
vo_unit_texts_text_Land_UR_RO_Attack_04att_cult_roman	Death take them!	true
vo_unit_texts_text_Land_UR_RO_Attack_05att_cult_roman	Honour and glory!	true
vo_unit_texts_text_Land_US_RO_Selection_Praetoriansatt_cult_eastern	Praetorians!	true
vo_unit_texts_text_Land_GO_EA_Group_Disbanded_01att_cult_eastern	Disband!	true
vo_unit_texts_text_Land_GO_EA_Group_Disbanded_02att_cult_eastern	Break up!	true
vo_unit_texts_text_Land_GO_EA_Group_Disbanded_03att_cult_eastern	Break group!	true
vo_unit_texts_text_Land_GO_EA_Group_Disbanded_04att_cult_eastern	Battle group, disband!	true
vo_unit_texts_text_Land_GO_EA_Group_Disbanded_05att_cult_eastern	Disband the group!	true
vo_unit_texts_text_Land_US_BA_Selection_Infantry_melee_generic_1att_cult_barbarian	Scrappers ready!	true
vo_unit_texts_text_Land_US_BA_Selection_Infantry_melee_generic_2att_cult_barbarian	They will bleed for us!	true
vo_unit_texts_text_Land_US_BA_Selection_Infantry_melee_generic_3att_cult_barbarian	Melee fighters ready!	true
vo_unit_texts_text_Land_US_BA_Selection_Infantry_melee_generic_4att_cult_barbarian	Fearless warriors!	true
vo_unit_texts_text_Land_US_BA_Selection_Infantry_melee_generic_5att_cult_barbarian	Melee warriors!	true
vo_unit_texts_text_Land_UO_BA_Guard_Off_01att_cult_barbarian	Stand down!	true
vo_unit_texts_text_Land_UO_BA_Guard_Off_02att_cult_barbarian	At ease!	true
vo_unit_texts_text_Land_UO_BA_Guard_Off_03att_cult_barbarian	Rest easy!	true
vo_unit_texts_text_Land_UO_BA_Guard_Off_04att_cult_barbarian	Stand easy!	true
vo_unit_texts_text_Land_UO_BA_Guard_Off_05att_cult_barbarian	Warriors, at ease!	true
vo_unit_texts_text_Land_SA_EA_Inspire_02att_cult_eastern	For honour and glory!	true
vo_unit_texts_text_Land_SA_EA_Inspire_03att_cult_eastern	The Gods protect us!	true
vo_unit_texts_text_Land_SA_EA_Inspire_01att_cult_eastern	For our lord and master!	true
vo_unit_texts_text_Land_SA_RO_Steady_Advance_01att_cult_roman	Advance at a steady pace!	true
vo_unit_texts_text_Land_SA_RO_Steady_Advance_02att_cult_roman	Keep a steady pace!	true
vo_unit_texts_text_Land_SA_RO_Steady_Advance_03att_cult_roman	Steady, I want a neat advance!	true
vo_unit_texts_text_Naval_UO_RO_Change_Facing_01att_cult_roman	Changing aim!	true
vo_unit_texts_text_Naval_UO_RO_Change_Facing_02att_cult_roman	Selecting new targets!	true
vo_unit_texts_text_Naval_UO_RO_Change_Facing_03att_cult_roman	Coming about to new targets!	true
vo_unit_texts_text_Naval_UO_RO_Change_Facing_04att_cult_roman	Turning to fire!	true
vo_unit_texts_text_Naval_UO_RO_Change_Facing_05att_cult_roman	Preparing new fire angles!	true
vo_unit_texts_text_Naval_GO_BA_Group_Created_04att_cult_eastern	Grouped and waiting!	true
vo_unit_texts_text_Naval_GO_EA_Group_Created_04att_cult_eastern	Grouped and awaiting orders!	true
vo_unit_texts_text_Naval_GO_BA_Group_Created_05att_cult_eastern	Warriors grouped!	true
vo_unit_texts_text_Naval_GO_EA_Group_Created_05att_cult_eastern	Battle group ready!	true
vo_unit_texts_text_Naval_GO_BA_Group_Created_01att_cult_eastern	Battle group ready!	true
vo_unit_texts_text_Naval_GO_EA_Group_Created_01att_cult_eastern	Battle group ready and awaiting orders!	true
vo_unit_texts_text_Naval_GO_BA_Group_Created_02att_cult_eastern	Grouped and ready!	true
vo_unit_texts_text_Naval_GO_EA_Group_Created_02att_cult_eastern	Grouped and ready!	true
vo_unit_texts_text_Naval_GO_BA_Group_Created_03att_cult_eastern	Battle group awaiting your word!	true
vo_unit_texts_text_Naval_GO_EA_Group_Created_03att_cult_eastern	Battle group awaiting orders!	true
vo_unit_texts_text_Land_US_BA_Selection_Berserkersatt_cult_barbarian	Berserkers!	true
vo_unit_texts_text_Land_SA_EA_Taunt_01att_cult_eastern	We will walk on your corpses!	true
vo_unit_texts_text_Land_SA_EA_Taunt_03att_cult_eastern	Your gods have deserted you!	true
vo_unit_texts_text_Land_SA_EA_Taunt_02att_cult_eastern	Men should know when they're conquered!	true
vo_unit_texts_text_Naval_UR_BA_Attack_01att_cult_barbarian	Destroy them!	true
vo_unit_texts_text_Naval_UR_BA_Attack_02att_cult_barbarian	Smash them!	true
vo_unit_texts_text_Naval_UR_BA_Attack_03att_cult_barbarian	Death!	true
vo_unit_texts_text_Naval_UR_BA_Attack_04att_cult_barbarian	Kill them!	true
vo_unit_texts_text_Naval_UR_BA_Attack_05att_cult_barbarian	Wipe them out!	true
vo_unit_texts_text_Land_UO_EA_Attack_Carthage_01att_cult_eastern	Ba'al Hammon's fury!	true
vo_unit_texts_text_Land_UR_EA_Attack_Carthage_01att_cult_eastern	With the fury of Ba'al Hammon!	true
vo_unit_texts_text_Land_UO_EA_Attack_Carthage_02att_cult_eastern	For mighty Carthage!	true
vo_unit_texts_text_Land_UR_EA_Attack_Carthage_02att_cult_eastern	For the glory of Carthage!	true
vo_unit_texts_text_Land_UO_EA_Attack_Carthage_03att_cult_eastern	Attack! For Carthage!	true
vo_unit_texts_text_Land_UR_EA_Attack_Carthage_03att_cult_eastern	Carthage!	true
vo_unit_texts_text_Land_UO_EA_Attack_Carthage_04att_cult_eastern	Forward! Warriors of Carthage!	true
vo_unit_texts_text_Land_UR_EA_Attack_Carthage_04att_cult_eastern	Death to the enemies of Carthage!	true
vo_unit_texts_text_Land_UO_EA_Attack_Carthage_05att_cult_eastern	Blood for Carthage!	true
vo_unit_texts_text_Land_UR_EA_Attack_Carthage_05att_cult_eastern	Blood, blood!	true
vo_unit_texts_text_Land_SA_RO_Rapid_Advance_01att_cult_roman	Rapid advance!	true
vo_unit_texts_text_Land_SA_RO_Rapid_Advance_02att_cult_roman	Advance, now!	true
vo_unit_texts_text_Land_SA_RO_Rapid_Advance_03att_cult_roman	Forward! Fast pace!	true
vo_unit_texts_text_Naval_UO_RO_Decrease_Rowing_Speed_01att_cult_roman	Easy on the oars!	true
vo_unit_texts_text_Naval_UO_RO_Decrease_Rowing_Speed_02att_cult_roman	Decrease speed!	true
vo_unit_texts_text_Naval_UO_RO_Decrease_Rowing_Speed_03att_cult_roman	Lift oars!	true
vo_unit_texts_text_Naval_UO_RO_Decrease_Rowing_Speed_04att_cult_roman	Ease off the oars!	true
vo_unit_texts_text_Naval_UO_RO_Decrease_Rowing_Speed_05att_cult_roman	Slow speed!	true
vo_unit_texts_text_Land_UO_RO_Change_Facing_01att_cult_roman	Change facing!	true
vo_unit_texts_text_Land_UO_RO_Change_Facing_02att_cult_roman	Move the artillery!	true
vo_unit_texts_text_Land_UO_RO_Change_Facing_03att_cult_roman	Realign the artillery!	true
vo_unit_texts_text_Land_UO_RO_Change_Facing_04att_cult_roman	Switch targets!	true
vo_unit_texts_text_Land_UO_RO_Change_Facing_05att_cult_roman	About face!	true
vo_unit_texts_text_Land_US_BA_Selection_Galatian_Noblemenatt_cult_barbarian	Galatian Noblemen!	true
vo_unit_texts_text_Naval_GO_RO_Group_Disbanded_04att_cult_eastern	Group disbanded!	true
vo_unit_texts_text_Naval_GO_RO_Group_Disbanded_05att_cult_eastern	Disbanding battle group!	true
vo_unit_texts_text_Naval_GO_RO_Group_Disbanded_02att_cult_eastern	Breaking battle group!	true
vo_unit_texts_text_Naval_GO_RO_Group_Disbanded_03att_cult_eastern	Battle group disbanding!	true
vo_unit_texts_text_Naval_GO_RO_Group_Disbanded_01att_cult_eastern	Battle group disbanded!	true
vo_unit_texts_text_Naval_GO_EA_Group_Disbanded_01att_cult_eastern	Disband!	true
vo_unit_texts_text_Naval_GO_BA_Group_Disbanded_04att_cult_eastern	Group disbanded!	true
vo_unit_texts_text_Naval_GO_EA_Group_Disbanded_03att_cult_eastern	Breaking battle group!	true
vo_unit_texts_text_Naval_GO_BA_Group_Disbanded_05att_cult_eastern	Disbanding battle group!	true
vo_unit_texts_text_Naval_GO_EA_Group_Disbanded_02att_cult_eastern	Break up!	true
vo_unit_texts_text_Naval_GO_BA_Group_Disbanded_02att_cult_eastern	Break battle group!	true
vo_unit_texts_text_Naval_GO_EA_Group_Disbanded_05att_cult_eastern	Disband the group!	true
vo_unit_texts_text_Naval_GO_BA_Group_Disbanded_03att_cult_eastern	Battle group disbanding!	true
vo_unit_texts_text_Naval_GO_EA_Group_Disbanded_04att_cult_eastern	Group disbanded!	true
vo_unit_texts_text_Naval_GO_BA_Group_Disbanded_01att_cult_eastern	Battle group disbanded!	true
vo_unit_texts_text_Land_UO_RO_Fire_at_Will_01att_cult_roman	Fire at will!	true
vo_unit_texts_text_Land_UO_RO_Fire_at_Will_02att_cult_roman	Pick your targets, men!	true
vo_unit_texts_text_Land_UO_RO_Fire_at_Will_03att_cult_roman	Get them! Any of them!	true
vo_unit_texts_text_Land_UO_RO_Fire_at_Will_04att_cult_roman	Fire at anyone!	true
vo_unit_texts_text_Land_UO_RO_Fire_at_Will_05att_cult_roman	Fire! Enjoy yourselves!	true
vo_unit_texts_text_Land_US_RO_Selection_Perioikoi_Peltastsatt_cult_eastern	Perioikoi Peltasts!	true
vo_unit_texts_text_Land_UO_EA_Mount_05att_cult_eastern	To your mounts!	true
vo_unit_texts_text_Land_UO_EA_Mount_04att_cult_eastern	To the mounts!	true
vo_unit_texts_text_Land_UO_EA_Mount_03att_cult_eastern	Mount!	true
vo_unit_texts_text_Land_UO_EA_Mount_02att_cult_eastern	To the saddle!	true
vo_unit_texts_text_Land_UO_EA_Mount_01att_cult_eastern	Mount up!	true
vo_unit_texts_text_Land_UO_EA_Single_Click_Ranged_Attack_Heightened_03att_cult_eastern	Loose!	true
vo_unit_texts_text_Land_UO_EA_Single_Click_Ranged_Attack_Heightened_02att_cult_eastern	Fire!	true
vo_unit_texts_text_Land_UO_RO_Single_Click_Move_To_01att_cult_roman	Move out!	true
vo_unit_texts_text_Land_UO_RO_Single_Click_Move_To_02att_cult_roman	On me!	true
vo_unit_texts_text_Land_UO_RO_Single_Click_Move_To_03att_cult_roman	March!	true
vo_unit_texts_text_Land_UO_RO_Single_Click_Move_To_04att_cult_roman	Marching order!	true
vo_unit_texts_text_Land_UO_RO_Single_Click_Move_To_05att_cult_roman	Follow me!	true
vo_unit_texts_text_Land_UO_EA_Single_Click_Ranged_Attack_Heightened_01att_cult_eastern	Fill the skies!	true
vo_unit_texts_text_Land_Mounted_US_EA_Selection_Scythian_Royal_Horseatt_cult_eastern	Scythian Royal Horse!	true
vo_unit_texts_text_Land_UO_EA_Single_Click_Ranged_Attack_Heightened_05att_cult_eastern	Find your targets!	true
vo_unit_texts_text_Land_UO_EA_Single_Click_Ranged_Attack_Heightened_04att_cult_eastern	Fire on the enemy!	true
vo_unit_texts_text_Land_SA_BA_Inspire_01att_cult_barbarian	Fight, or I'll kill yah!	true
vo_unit_texts_text_Land_SA_BA_Inspire_02att_cult_barbarian	Are you men or Romans?!	true
vo_unit_texts_text_Land_SA_BA_Inspire_03att_cult_barbarian	We will bath in their blood!	true
vo_unit_texts_text_Land_SA_RO_Taunt_01att_cult_roman	You fight like women!	true
vo_unit_texts_text_Land_SA_RO_Taunt_02att_cult_roman	Have your gods forsaken you?!	true
vo_unit_texts_text_Land_SA_RO_Taunt_03att_cult_roman	Your battle is lost!	true
vo_unit_texts_text_Land_US_EA_Selection_Egypt_04att_cult_eastern	For Egypt!	true
vo_unit_texts_text_Land_US_EA_Selection_Egypt_05att_cult_eastern	Egyptian warriors!	true
vo_unit_texts_text_Land_UO_BA_Disembark_01att_cult_barbarian	Disembark!	true
vo_unit_texts_text_Land_UO_BA_Disembark_02att_cult_barbarian	Go ashore!	true
vo_unit_texts_text_Land_UO_BA_Disembark_03att_cult_barbarian	Off the boats!	true
vo_unit_texts_text_Land_UO_BA_Disembark_04att_cult_barbarian	To the shore!	true
vo_unit_texts_text_Land_UO_BA_Disembark_05att_cult_barbarian	All ashore!	true
vo_unit_texts_text_Land_US_EA_Selection_Egypt_01att_cult_eastern	For the Pharaoh, strength onto him!	true
vo_unit_texts_text_Land_US_EA_Selection_Egypt_02att_cult_eastern	We serve the mighty Pharaoh!	true
vo_unit_texts_text_Land_US_EA_Selection_Egypt_03att_cult_eastern	Proud sons of Egypt!	true
vo_unit_texts_text_Land_US_BA_Selection_Artillery_field_generic_1att_cult_barbarian	Ready to rain down death!	true
vo_unit_texts_text_Land_US_BA_Selection_Artillery_field_generic_2att_cult_barbarian	Field artillery!	true
vo_unit_texts_text_Land_US_BA_Selection_Artillery_field_generic_3att_cult_barbarian	The artillery stands ready!	true
vo_unit_texts_text_Naval_US_RO_Selection_Fire_Potsatt_cult_eastern	Fire pots ready!	true
vo_unit_texts_text_Land_US_BA_Selection_Infantry_missile_generic_1att_cult_barbarian	Missiles ready!	true
vo_unit_texts_text_Land_US_BA_Selection_Infantry_missile_generic_2att_cult_barbarian	Missile armed warriors!	true
vo_unit_texts_text_Land_US_BA_Selection_Infantry_missile_generic_3att_cult_barbarian	Deadly missiles ready!	true
vo_unit_texts_text_Land_US_BA_Selection_Infantry_missile_generic_4att_cult_barbarian	Missile warriors!	true
vo_unit_texts_text_Land_US_BA_Selection_Infantry_missile_generic_5att_cult_barbarian	We will pierce their hearts!	true
vo_unit_texts_text_Land_US_RO_Selection_Levy_Thureos_Spearsatt_cult_eastern	Levy Thureos Spears!	true
vo_unit_texts_text_Land_UO_RO_Climb_01att_cult_roman	To the walls!	true
vo_unit_texts_text_Land_UO_RO_Climb_02att_cult_roman	Scale the walls!	true
vo_unit_texts_text_Land_UO_RO_Climb_03att_cult_roman	Get over the walls!	true
vo_unit_texts_text_Land_UO_RO_Climb_04att_cult_roman	Get climbing!	true
vo_unit_texts_text_Land_UO_RO_Climb_05att_cult_roman	Over the walls!	true
vo_unit_texts_text_Land_SA_BA_War_Cry_01att_cult_barbarian	BLOOOD!	true
vo_unit_texts_text_Land_SA_BA_War_Cry_02att_cult_barbarian	Ahhhhhhh!	true
vo_unit_texts_text_Land_SA_BA_War_Cry_03att_cult_barbarian	Dehh hett dahhh haa dahh whoo daaah!	true
vo_unit_texts_text_Land_Mounted_UO_EA_Double_Click_Move_To_Heightened_05att_cult_eastern	Advance at speed!	true
vo_unit_texts_text_Land_Mounted_UO_EA_Double_Click_Move_To_Heightened_04att_cult_eastern	Riders, advance!	true
vo_unit_texts_text_Land_Mounted_UO_EA_Double_Click_Move_To_Heightened_03att_cult_eastern	Quickly now!	true
vo_unit_texts_text_Land_Mounted_UO_EA_Double_Click_Move_To_Heightened_02att_cult_eastern	Forward!	true
vo_unit_texts_text_Land_Mounted_UO_EA_Double_Click_Move_To_Heightened_01att_cult_eastern	Riders, at the double!	true
vo_unit_texts_text_Land_UO_EA_Skirmish_Leftatt_cult_eastern	Skirmish left! 	true
vo_unit_texts_text_Naval_SA_RO_Flaming_Projectile_01att_cult_roman	Give them fire!	true
vo_unit_texts_text_Naval_SA_RO_Flaming_Projectile_02att_cult_roman	Fire! Burn them!	true
vo_unit_texts_text_Naval_SA_RO_Flaming_Projectile_03att_cult_roman	Set them ablaze!	true
vo_unit_texts_text_Land_UO_EA_Skirmish_Rightatt_cult_eastern	Skirmish right! 	true
vo_unit_texts_text_Land_UO_EA_Climb_04att_cult_eastern	Get climbing!	true
vo_unit_texts_text_Land_UO_EA_Climb_05att_cult_eastern	Over the walls!	true
vo_unit_texts_text_Land_UO_EA_Climb_01att_cult_eastern	To the walls!	true
vo_unit_texts_text_Land_UO_EA_Climb_02att_cult_eastern	Get over the walls!	true
vo_unit_texts_text_Land_UO_EA_Climb_03att_cult_eastern	Scale those walls!	true
vo_unit_texts_text_Land_UR_EA_Generic_Order_03att_cult_eastern	As you wish!	true
vo_unit_texts_text_Land_UR_EA_Generic_Order_02att_cult_eastern	As you command!	true
vo_unit_texts_text_Land_UR_EA_Generic_Order_01att_cult_eastern	As you say!	true
vo_unit_texts_text_Land_US_RO_Selection_Sacred_Bandatt_cult_eastern	Sacred Band!	true
vo_unit_texts_text_Land_UR_EA_Generic_Order_05att_cult_eastern	We understand.	true
vo_unit_texts_text_Land_UR_EA_Generic_Order_04att_cult_eastern	Forever loyal!	true
vo_unit_texts_text_Land_Mounted_US_BA_Selection_Saka_Noble_Armoured_Lancersatt_cult_barbarian	Saka Noble Armoured Lancers!	true
vo_unit_texts_text_Land_UO_RO_Embark_01att_cult_roman	To the ships!	true
vo_unit_texts_text_Land_UO_RO_Embark_02att_cult_roman	Embark!	true
vo_unit_texts_text_Land_UO_RO_Embark_03att_cult_roman	Get aboard!	true
vo_unit_texts_text_Land_UO_RO_Embark_04att_cult_roman	Board the ships!	true
vo_unit_texts_text_Land_UO_RO_Embark_05att_cult_roman	Embark, now!	true
vo_unit_texts_text_Land_UO_EA_Tight_Formation_04att_cult_eastern	Form tight formation!	true
vo_unit_texts_text_Land_UO_EA_Tight_Formation_05att_cult_eastern	Close formation!	true
vo_unit_texts_text_Land_UO_EA_Tight_Formation_02att_cult_eastern	Close the ranks!	true
vo_unit_texts_text_Land_UO_EA_Tight_Formation_03att_cult_eastern	Come together!	true
vo_unit_texts_text_Land_UO_EA_Tight_Formation_01att_cult_eastern	Tight formation!	true
vo_unit_texts_text_Land_SA_EA_Rally_03att_cult_eastern	We fight or we die!	true
vo_unit_texts_text_Land_SA_EA_Rally_02att_cult_eastern	Surrender is not an option!	true
vo_unit_texts_text_Land_SA_EA_Rally_01att_cult_eastern	Rally to me!	true
vo_unit_texts_text_Land_UO_RO_Single_Click_Ranged_Attack_Heightened_01att_cult_roman	Loose!	true
vo_unit_texts_text_Land_UO_RO_Single_Click_Ranged_Attack_Heightened_02att_cult_roman	Fire!	true
vo_unit_texts_text_Land_UO_RO_Single_Click_Ranged_Attack_Heightened_03att_cult_roman	Now!	true
vo_unit_texts_text_Land_UO_RO_Single_Click_Ranged_Attack_Heightened_04att_cult_roman	Fire on the enemy!	true
vo_unit_texts_text_Land_UO_RO_Single_Click_Ranged_Attack_Heightened_05att_cult_roman	Take aim!	true
vo_unit_texts_text_Naval_UO_BA_Fire_Artillery_Shore_Targets_01att_cult_eastern	Fire on the shore!	true
vo_unit_texts_text_Naval_UO_BA_Fire_Artillery_Shore_Targets_03att_cult_eastern	Give 'em something to cry about!	true
vo_unit_texts_text_Naval_UO_BA_Fire_Artillery_Shore_Targets_02att_cult_eastern	Take aim, fire on the shore!	true
vo_unit_texts_text_Naval_UO_BA_Fire_Artillery_Shore_Targets_05att_cult_eastern	Artillery, fire on the enemy!	true
vo_unit_texts_text_Naval_UO_BA_Fire_Artillery_Shore_Targets_04att_cult_eastern	Destroy shore targets!	true
vo_unit_texts_text_Land_US_RO_Selection_Socii_Hastatiatt_cult_eastern	Socii Hastati!	true
vo_unit_texts_text_Land_US_EA_Selection_Elephants_generic_4att_cult_eastern	Battle elephants!	true
vo_unit_texts_text_Land_US_EA_Selection_Elephants_generic_5att_cult_eastern	Elephants ready for battle!	true
vo_unit_texts_text_Land_US_EA_Selection_Elephants_generic_1att_cult_eastern	Elephants!	true
vo_unit_texts_text_Land_US_EA_Selection_Elephants_generic_2att_cult_eastern	Elephants at the ready!	true
vo_unit_texts_text_Land_US_EA_Selection_Elephants_generic_3att_cult_eastern	We will trample them!	true
vo_unit_texts_text_Naval_GO_BA_Lock_Formation_01att_cult_eastern	Stay as you are!	true
vo_unit_texts_text_Naval_GO_EA_Lock_Formation_01att_cult_eastern	Lock formation!	true
vo_unit_texts_text_Naval_GO_RO_Lock_Formation_01att_cult_eastern	Stay as you are!	true
vo_unit_texts_text_Naval_GO_BA_Lock_Formation_02att_cult_eastern	Stay where I put yah!	true
vo_unit_texts_text_Naval_GO_EA_Lock_Formation_02att_cult_eastern	Keep this formation!	true
vo_unit_texts_text_Naval_GO_RO_Lock_Formation_02att_cult_eastern	Anyone who breaks formation will be punished!	true
vo_unit_texts_text_Naval_GO_BA_Lock_Formation_03att_cult_eastern	Hold formation!	true
vo_unit_texts_text_Naval_GO_EA_Lock_Formation_03att_cult_eastern	Hold this formation!	true
vo_unit_texts_text_Naval_GO_RO_Lock_Formation_03att_cult_eastern	Hold formation!	true
vo_unit_texts_text_Naval_GO_BA_Lock_Formation_04att_cult_eastern	Stay together!	true
vo_unit_texts_text_Naval_GO_EA_Lock_Formation_04att_cult_eastern	Stay in formation!	true
vo_unit_texts_text_Naval_GO_RO_Lock_Formation_04att_cult_eastern	Stay in formation!	true
vo_unit_texts_text_Naval_GO_BA_Lock_Formation_05att_cult_eastern	Don't break formation!	true
vo_unit_texts_text_Naval_GO_EA_Lock_Formation_05att_cult_eastern	Maintain this formation!	true
vo_unit_texts_text_Naval_GO_RO_Lock_Formation_05att_cult_eastern	Don't break formation!	true
vo_unit_texts_text_Land_US_BA_Selection_Germans_01att_cult_barbarian	Germanic warriors!	true
vo_unit_texts_text_Land_US_BA_Selection_Germans_02att_cult_barbarian	Sons of Woden!	true
vo_unit_texts_text_Land_US_BA_Selection_Germans_03att_cult_barbarian	We are the dark forest!	true
vo_unit_texts_text_Land_US_BA_Selection_Germans_04att_cult_barbarian	Warriors of Germania!	true
vo_unit_texts_text_Land_US_BA_Selection_Germans_05att_cult_barbarian	Tremble before us!	true
vo_unit_texts_text_Land_UO_EA_Hold_Position_on_01att_cult_eastern	Hold position!	true
vo_unit_texts_text_Land_UO_EA_Hold_Position_on_02att_cult_eastern	Hold steady!	true
vo_unit_texts_text_Land_UO_EA_Hold_Position_on_03att_cult_eastern	Hold men, hold!	true
vo_unit_texts_text_Land_UO_EA_Hold_Position_on_04att_cult_eastern	Keep this position!	true
vo_unit_texts_text_Land_UO_EA_Hold_Position_on_05att_cult_eastern	Hold here!	true
vo_unit_texts_text_Naval_UO_EA_Single_Click_Move_To_Heightened_01att_cult_eastern	Move out!	true
vo_unit_texts_text_Naval_UO_BA_Single_Click_Move_To_Heightened_04att_cult_eastern	Move out!	true
vo_unit_texts_text_Naval_UO_EA_Single_Click_Move_To_Heightened_03att_cult_eastern	Set the oars!	true
vo_unit_texts_text_Naval_UO_BA_Single_Click_Move_To_Heightened_05att_cult_eastern	Row!	true
vo_unit_texts_text_Naval_UO_EA_Single_Click_Move_To_Heightened_02att_cult_eastern	To the oars!	true
vo_unit_texts_text_Naval_UO_BA_Single_Click_Move_To_Heightened_02att_cult_eastern	To the oars!	true
vo_unit_texts_text_Naval_UO_EA_Single_Click_Move_To_Heightened_05att_cult_eastern	Get moving!	true
vo_unit_texts_text_Naval_UO_BA_Single_Click_Move_To_Heightened_03att_cult_eastern	Set oars!	true
vo_unit_texts_text_Naval_UO_EA_Single_Click_Move_To_Heightened_04att_cult_eastern	Move to position!	true
vo_unit_texts_text_Naval_UO_BA_Single_Click_Move_To_Heightened_01att_cult_eastern	Moving out!	true
vo_unit_texts_text_Land_SA_BA_Flaming_Projectile_01att_cult_barbarian	Give them fire!	true
vo_unit_texts_text_Land_SA_BA_Flaming_Projectile_02att_cult_barbarian	Burn them!	true
vo_unit_texts_text_Land_SA_BA_Flaming_Projectile_03att_cult_barbarian	Set them alight!	true
vo_unit_texts_text_Naval_US_BA_Selection_Assault_Ship_01att_cult_barbarian	Assault ships reporting!	true
vo_unit_texts_text_Naval_US_BA_Selection_Assault_Ship_02att_cult_barbarian	Crewed by warriors and ready!	true
vo_unit_texts_text_Naval_US_BA_Selection_Assault_Ship_03att_cult_barbarian	Assault ships awaiting your word!	true
vo_unit_texts_text_Naval_US_BA_Selection_Assault_Ship_04att_cult_barbarian	Assault ships ready to attack!	true
vo_unit_texts_text_Naval_US_BA_Selection_Assault_Ship_05att_cult_barbarian	Ready, willing and able!	true
vo_unit_texts_text_Land_SA_BA_Rally_and_Inspire_01att_cult_barbarian	For the tribe!	true
vo_unit_texts_text_Land_SA_BA_Rally_and_Inspire_02att_cult_barbarian	For the gods!	true
vo_unit_texts_text_Land_SA_BA_Rally_and_Inspire_03att_cult_barbarian	Remember! The ancestors watch!	true
vo_unit_texts_text_Land_US_EA_Selection_Auxiliary_Sabaean_Spearmenatt_cult_eastern	Sabaean Spearmen!	true
vo_unit_texts_text_Naval_UO_EA_Fire_Artillery_Shore_Targets_01att_cult_eastern	Fire ashore!	true
vo_unit_texts_text_Naval_UO_EA_Fire_Artillery_Shore_Targets_03att_cult_eastern	Targets marked, fire!	true
vo_unit_texts_text_Naval_UO_EA_Fire_Artillery_Shore_Targets_02att_cult_eastern	Take aim, fire on the shore!	true
vo_unit_texts_text_Naval_UO_EA_Fire_Artillery_Shore_Targets_05att_cult_eastern	Artillery, fire on the enemy!	true
vo_unit_texts_text_Naval_UO_EA_Fire_Artillery_Shore_Targets_04att_cult_eastern	Destroy shore targets!	true
vo_unit_texts_text_Land_UO_BA_Dog_Attack_01att_cult_barbarian	At 'em, brutes!	true
vo_unit_texts_text_Land_UO_BA_Dog_Attack_02att_cult_barbarian	Bite hard, lads!	true
vo_unit_texts_text_Land_UO_BA_Dog_Attack_03att_cult_barbarian	Savage them!	true
vo_unit_texts_text_Land_UO_BA_Dog_Attack_04att_cult_barbarian	Go on! Get 'em!	true
vo_unit_texts_text_Land_UO_BA_Dog_Attack_05att_cult_barbarian	Rip 'em to shreds!	true
vo_unit_texts_text_Land_UO_EA_Single_Click_Move_To_Heightened_01att_cult_eastern	Move out!	true
vo_unit_texts_text_Land_UO_EA_Single_Click_Move_To_Heightened_02att_cult_eastern	On me!	true
vo_unit_texts_text_Land_UO_EA_Single_Click_Move_To_Heightened_03att_cult_eastern	March!	true
vo_unit_texts_text_Land_UO_EA_Single_Click_Move_To_Heightened_04att_cult_eastern	Marching order!	true
vo_unit_texts_text_Land_UO_EA_Single_Click_Move_To_Heightened_05att_cult_eastern	Follow me!	true
vo_unit_texts_text_Land_Mounted_US_RO_Selection_Socii_Equites_Extraordinariiatt_cult_roman	Socii Equites Extraordinarii!	true
vo_unit_texts_text_Naval_UO_RO_Repair_Ship_01att_cult_roman	Look to repairs!	true
vo_unit_texts_text_Naval_UO_RO_Repair_Ship_02att_cult_roman	Get to the repairs!	true
vo_unit_texts_text_Naval_UO_RO_Repair_Ship_03att_cult_roman	Repair the ships!	true
vo_unit_texts_text_Naval_UO_RO_Repair_Ship_04att_cult_roman	See to the repairs!	true
vo_unit_texts_text_Naval_UO_RO_Repair_Ship_05att_cult_roman	Repairs, now!	true
vo_unit_texts_text_Naval_UO_BA_Change_Facing_01att_cult_eastern	Changing aim!	true
vo_unit_texts_text_Naval_UO_EA_Change_Facing_01att_cult_eastern	Changing aim!	true
vo_unit_texts_text_Naval_UO_BA_Change_Facing_02att_cult_eastern	Selecting new targets!	true
vo_unit_texts_text_Naval_UO_EA_Change_Facing_02att_cult_eastern	Selecting new targets!	true
vo_unit_texts_text_Naval_UO_BA_Change_Facing_03att_cult_eastern	Coming about to new targets!	true
vo_unit_texts_text_Naval_UO_EA_Change_Facing_03att_cult_eastern	Coming about to new targets!	true
vo_unit_texts_text_Naval_UO_BA_Change_Facing_04att_cult_eastern	Turning to fire!	true
vo_unit_texts_text_Naval_UO_EA_Change_Facing_04att_cult_eastern	Turning to fire!	true
vo_unit_texts_text_Naval_UO_BA_Change_Facing_05att_cult_eastern	Preparing new fire angles!	true
vo_unit_texts_text_Naval_UO_EA_Change_Facing_05att_cult_eastern	Preparing new fire angles!	true
vo_unit_texts_text_Land_UO_RO_Mount_01att_cult_roman	Mount up!	true
vo_unit_texts_text_Land_UO_RO_Mount_02att_cult_roman	To the saddle!	true
vo_unit_texts_text_Land_UO_RO_Mount_03att_cult_roman	Mount!	true
vo_unit_texts_text_Land_UO_RO_Mount_04att_cult_roman	Mount up, men!	true
vo_unit_texts_text_Land_UO_RO_Mount_05att_cult_roman	Riders, mount up!	true
vo_unit_texts_text_Land_SA_EA_Into_the_Breach_Group_02att_cult_eastern	The Gods carry us!	true
vo_unit_texts_text_Land_SA_EA_Into_the_Breach_Group_03att_cult_eastern	Into the breach!	true
vo_unit_texts_text_Land_SA_EA_Into_the_Breach_Group_01att_cult_eastern	Fight, push through!	true
vo_unit_texts_text_Land_US_RO_Selection_Short_01att_cult_eastern	Orders?	true
vo_unit_texts_text_Land_US_RO_Selection_Short_03att_cult_eastern	Your orders?	true
vo_unit_texts_text_Land_US_RO_Selection_Short_02att_cult_eastern	Ready and waiting!	true
vo_unit_texts_text_Land_US_RO_Selection_Short_05att_cult_eastern	Ready!	true
vo_unit_texts_text_Land_US_RO_Selection_Short_04att_cult_eastern	Commander!	true
vo_unit_texts_text_Land_US_EA_Selection_Short_04att_cult_eastern	Awaiting orders!	true
vo_unit_texts_text_Land_US_EA_Selection_Short_05att_cult_eastern	Our orders?	true
vo_unit_texts_text_Land_US_EA_Selection_Short_02att_cult_eastern	Orders?	true
vo_unit_texts_text_Land_US_EA_Selection_Short_03att_cult_eastern	My lord?	true
vo_unit_texts_text_Land_US_EA_Selection_Short_01att_cult_eastern	Ready!	true
vo_unit_texts_text_Land_UR_EA_Attack_Parthia_04att_cult_eastern	The Daevas!	true
vo_unit_texts_text_Land_UR_EA_Attack_Parthia_05att_cult_eastern	Skins for the King!	true
vo_unit_texts_text_Land_UR_EA_Attack_Parthia_02att_cult_eastern	Blood for the King!	true
vo_unit_texts_text_Land_UR_EA_Attack_Parthia_03att_cult_eastern	Daevas fury!	true
vo_unit_texts_text_Land_UR_EA_Attack_Parthia_01att_cult_eastern	Blood and fury!	true
vo_unit_texts_text_Land_UO_BA_Melee_Button_on__01att_cult_barbarian	Weapons ready!	true
vo_unit_texts_text_Land_UO_BA_Melee_Button_on__02att_cult_barbarian	Warriors! Draw weapons!	true
vo_unit_texts_text_Land_UO_BA_Melee_Button_on__03att_cult_barbarian	Prepare to attack!	true
vo_unit_texts_text_Land_UO_BA_Melee_Button_on__04att_cult_barbarian	Ready yourselves!	true
vo_unit_texts_text_Land_UO_BA_Melee_Button_on__05att_cult_barbarian	Draw your weapons!	true
vo_unit_texts_text_Land_GO_RO_Group_Created_01att_cult_roman	Battle group ready and awaiting orders!	true
vo_unit_texts_text_Land_GO_RO_Group_Created_02att_cult_roman	Grouped and ready!	true
vo_unit_texts_text_Land_GO_RO_Group_Created_03att_cult_roman	Battle group awaiting orders!	true
vo_unit_texts_text_Land_GO_RO_Group_Created_04att_cult_roman	Grouped and awaiting orders!	true
vo_unit_texts_text_Land_GO_RO_Group_Created_05att_cult_roman	Battle group ready!	true
vo_unit_texts_text_Land_Mounted_US_BA_Selection_Noble_Horseatt_cult_barbarian	Noble Horse!	true
vo_unit_texts_text_Land_GO_EA_Unlock_Formation_04att_cult_eastern	Change formation!	true
vo_unit_texts_text_Land_GO_EA_Unlock_Formation_05att_cult_eastern	As you were!	true
vo_unit_texts_text_Land_GO_EA_Unlock_Formation_02att_cult_eastern	Break the formation!	true
vo_unit_texts_text_Land_GO_EA_Unlock_Formation_03att_cult_eastern	Release formation!	true
vo_unit_texts_text_Land_GO_EA_Unlock_Formation_01att_cult_eastern	Formation unlocked!	true
vo_unit_texts_text_Land_UO_BA_Double_Click_Move_To_Heightened_01att_cult_barbarian	Get running!	true
vo_unit_texts_text_Land_UO_BA_Double_Click_Move_To_Heightened_02att_cult_barbarian	Run, curse you!	true
vo_unit_texts_text_Land_UO_BA_Double_Click_Move_To_Heightened_03att_cult_barbarian	Warriors, move out!	true
vo_unit_texts_text_Land_UO_BA_Double_Click_Move_To_Heightened_04att_cult_barbarian	Forward!	true
vo_unit_texts_text_Land_UO_BA_Double_Click_Move_To_Heightened_05att_cult_barbarian	Move it!	true
vo_unit_texts_text_Naval_US_RO_Selection_Support_Ship_02att_cult_eastern	Our missiles await your orders!	true
vo_unit_texts_text_Naval_US_RO_Selection_Support_Ship_03att_cult_eastern	Support ships ready and waiting!	true
vo_unit_texts_text_Naval_SA_RO_Use_the_Whip_01att_cult_roman	Pull! Or you'll be sorry!	true
vo_unit_texts_text_Naval_SA_RO_Use_the_Whip_02att_cult_roman	Row you dogs!	true
vo_unit_texts_text_Naval_SA_RO_Use_the_Whip_03att_cult_roman	Harder! Put your backs in to it!	true
vo_unit_texts_text_Naval_US_RO_Selection_Support_Ship_01att_cult_eastern	Support ships ready!	true
vo_unit_texts_text_Naval_US_RO_Selection_Support_Ship_04att_cult_eastern	Support ships at your command!	true
vo_unit_texts_text_Naval_US_RO_Selection_Support_Ship_05att_cult_eastern	At your command, support ships!	true
vo_unit_texts_text_Naval_US_BA_Selection_generic_01att_cult_barbarian	Oars ready!	true
vo_unit_texts_text_Naval_US_BA_Selection_generic_02att_cult_barbarian	Ready and able!	true
vo_unit_texts_text_Naval_US_BA_Selection_generic_03att_cult_barbarian	Ships and oars ready!	true
vo_unit_texts_text_Naval_US_BA_Selection_generic_04att_cult_barbarian	Ships awaiting your word!	true
vo_unit_texts_text_Naval_US_BA_Selection_generic_05att_cult_barbarian	Ready and waiting!	true
vo_unit_texts_text_Land_SA_RO_Steady_Retreat_01att_cult_roman	Steady men, steady!	true
vo_unit_texts_text_Land_SA_RO_Steady_Retreat_02att_cult_roman	Stay with me!	true
vo_unit_texts_text_Land_SA_RO_Steady_Retreat_03att_cult_roman	Form an ordered retreat!	true
vo_unit_texts_text_Land_UO_EA_Loose_Formation_01att_cult_eastern	Loose formation!	true
vo_unit_texts_text_Land_UO_EA_Loose_Formation_02att_cult_eastern	Open the ranks!	true
vo_unit_texts_text_Land_UO_EA_Loose_Formation_03att_cult_eastern	Spread out!	true
vo_unit_texts_text_Land_UO_EA_Loose_Formation_04att_cult_eastern	Break up!	true
vo_unit_texts_text_Land_UO_EA_Loose_Formation_05att_cult_eastern	Into loose formation, now!	true
vo_unit_texts_text_Land_UO_EA_Dismount_01att_cult_eastern	Dismount!	true
vo_unit_texts_text_Land_UO_EA_Dismount_02att_cult_eastern	Riders, dismount!	true
vo_unit_texts_text_Land_UO_EA_Dismount_03att_cult_eastern	Dismount, now!	true
vo_unit_texts_text_Land_UO_EA_Dismount_04att_cult_eastern	On your feet!	true
vo_unit_texts_text_Land_UO_EA_Dismount_05att_cult_eastern	Men, dismount!	true
vo_unit_texts_text_Land_Mounted_US_BA_Selection_Mercenary_Scutarii_Cavalryatt_cult_barbarian	Mercenary Scutarii Cavalry!	true
vo_unit_texts_text_Land_SA_EA_Steady_Advance_01att_cult_eastern	Steady advance!	true
vo_unit_texts_text_Land_SA_EA_Steady_Advance_02att_cult_eastern	Forward, steady now!	true
vo_unit_texts_text_Land_SA_EA_Steady_Advance_03att_cult_eastern	Keep a steady pace!	true
vo_unit_texts_text_Land_UO_EA_Withdraw_01att_cult_eastern	Withdraw!	true
vo_unit_texts_text_Land_UO_EA_Withdraw_02att_cult_eastern	Pull back!	true
vo_unit_texts_text_Land_UO_EA_Withdraw_03att_cult_eastern	Back! Back! Withdraw!	true
vo_unit_texts_text_Land_UO_EA_Withdraw_04att_cult_eastern	On my order, Withdraw!	true
vo_unit_texts_text_Land_UO_EA_Withdraw_05att_cult_eastern	Back men, back!	true
vo_unit_texts_text_Land_SA_BA_Into_the_Breach_01att_cult_barbarian	Last one in's a Roman bastard!	true
vo_unit_texts_text_Land_SA_BA_Into_the_Breach_02att_cult_barbarian	Get in there!	true
vo_unit_texts_text_Land_SA_BA_Into_the_Breach_03att_cult_barbarian	Get 'em!	true
vo_unit_texts_text_Naval_US_RO_Selection_Toweratt_cult_roman	Towers ready!	true
vo_unit_texts_text_Land_SA_EA_Stand_and_Fight_02att_cult_eastern	Fight to the last!	true
vo_unit_texts_text_Land_SA_EA_Stand_and_Fight_03att_cult_eastern	Fight! Your master demands it!	true
vo_unit_texts_text_Land_SA_EA_Stand_and_Fight_01att_cult_eastern	Stand and fight!	true
vo_unit_texts_text_Naval_US_EA_Selection_Short_05att_cult_eastern	Our orders?	true
vo_unit_texts_text_Naval_US_EA_Selection_Short_04att_cult_eastern	Battle ready!	true
vo_unit_texts_text_Naval_US_EA_Selection_Short_03att_cult_eastern	My lord?	true
vo_unit_texts_text_Naval_US_EA_Selection_Short_02att_cult_eastern	Orders?	true
vo_unit_texts_text_Naval_US_EA_Selection_Short_01att_cult_eastern	Ready!	true
vo_unit_texts_text_Land_Mounted_US_RO_Selection_Socii_Equitesatt_cult_roman	Socii Equites!	true
vo_unit_texts_text_Land_UR_EA_Generic_Order_Carthage_01att_cult_eastern	For Ba'al Hammon!	true
vo_unit_texts_text_Land_Mounted_US_RO_Selection_Agema_Cavalryatt_cult_roman	Agema Cavalry!	true
vo_unit_texts_text_Land_UR_EA_Generic_Order_Carthage_03att_cult_eastern	For Carthage!	true
vo_unit_texts_text_Land_UR_EA_Generic_Order_Carthage_02att_cult_eastern	Carthage, mother to us all!	true
vo_unit_texts_text_Land_UR_EA_Generic_Order_Carthage_05att_cult_eastern	For mighty Carthage!	true
vo_unit_texts_text_Land_UR_EA_Generic_Order_Carthage_04att_cult_eastern	Hail Ba'al Hammon!	true
vo_unit_texts_text_Land_GO_BA_Unlock_Formation_01att_cult_barbarian	As you were!	true
vo_unit_texts_text_Land_GO_BA_Unlock_Formation_02att_cult_barbarian	Do as you please!	true
vo_unit_texts_text_Land_GO_BA_Unlock_Formation_03att_cult_barbarian	Break formation!	true
vo_unit_texts_text_Land_GO_BA_Unlock_Formation_04att_cult_barbarian	Return to your positions!	true
vo_unit_texts_text_Land_GO_BA_Unlock_Formation_05att_cult_barbarian	Leave formation!	true
vo_unit_texts_text_Land_SA_EA_Brace_01att_cult_eastern	Brace, men!	true
vo_unit_texts_text_Land_SA_EA_Brace_02att_cult_eastern	Get ready, get ready!	true
vo_unit_texts_text_Land_SA_EA_Brace_03att_cult_eastern	Stay strong!	true
vo_unit_texts_text_Land_UO_BA_Move_Siege_Tower_01att_cult_barbarian	Shift that siege tower! 	true
vo_unit_texts_text_Land_UO_BA_Move_Siege_Tower_02att_cult_barbarian	Get that tower moving!	true
vo_unit_texts_text_Land_UO_BA_Move_Siege_Tower_03att_cult_barbarian	Move the tower!	true
vo_unit_texts_text_Land_UO_BA_Move_Siege_Tower_04att_cult_barbarian	To the tower!	true
vo_unit_texts_text_Land_UO_BA_Move_Siege_Tower_05att_cult_barbarian	Put your backs in to it!	true
vo_unit_texts_text_Naval_UR_EA_Attack_03att_cult_eastern	Attack!	true
vo_unit_texts_text_Naval_UR_EA_Attack_02att_cult_eastern	Death!	true
vo_unit_texts_text_Naval_UR_EA_Attack_01att_cult_eastern	Engage!	true
vo_unit_texts_text_Naval_UR_EA_Attack_05att_cult_eastern	Wipe them out!	true
vo_unit_texts_text_Naval_UR_EA_Attack_04att_cult_eastern	Destroy them!	true
vo_unit_texts_text_Land_US_BA_Selection_Scutarii_Spearmenatt_cult_barbarian	Scutarii Spearmen!	true
vo_unit_texts_text_Land_US_BA_Selection_generic_01att_cult_barbarian	Warriors eager for blood!	true
vo_unit_texts_text_Land_US_BA_Selection_generic_02att_cult_barbarian	Ready for battle! 	true
vo_unit_texts_text_Land_US_BA_Selection_generic_03att_cult_barbarian	We'll kill 'em all!	true
vo_unit_texts_text_Land_US_BA_Selection_generic_04att_cult_barbarian	Battle ready and eager!	true
vo_unit_texts_text_Land_US_BA_Selection_generic_05att_cult_barbarian	We hunger for blood and battle!	true
vo_unit_texts_text_Naval_UO_RO_Double_Click_Attack_01att_cult_roman	Destroy them!	true
vo_unit_texts_text_Naval_UO_RO_Double_Click_Attack_02att_cult_roman	To victory!	true
vo_unit_texts_text_Naval_UO_RO_Double_Click_Attack_03att_cult_roman	Engage!	true
vo_unit_texts_text_Naval_UO_RO_Double_Click_Attack_04att_cult_roman	For glory!	true
vo_unit_texts_text_Naval_UO_RO_Double_Click_Attack_05att_cult_roman	Death to the enemy!	true
vo_unit_texts_text_Land_UO_BA_Dismount_01att_cult_barbarian	Dismount!	true
vo_unit_texts_text_Land_UO_BA_Dismount_02att_cult_barbarian	Riders, dismount!	true
vo_unit_texts_text_Land_UO_BA_Dismount_03att_cult_barbarian	Dismount, now!	true
vo_unit_texts_text_Land_UO_BA_Dismount_04att_cult_barbarian	On your feet!	true
vo_unit_texts_text_Land_UO_BA_Dismount_05att_cult_barbarian	Warriors, dismount!	true
vo_unit_texts_text_Land_UR_EA_Attack_04att_cult_eastern	Break them!	true
vo_unit_texts_text_Land_UR_EA_Attack_05att_cult_eastern	Die!	true
vo_unit_texts_text_Land_UR_EA_Attack_02att_cult_eastern	Kill!	true
vo_unit_texts_text_Land_UR_EA_Attack_03att_cult_eastern	Attack!	true
vo_unit_texts_text_Land_UR_EA_Attack_01att_cult_eastern	Ahhhh!	true
vo_unit_texts_text_Land_SA_EA_Rapid_Advance_01att_cult_eastern	Rapid Advance!	true
vo_unit_texts_text_Land_SA_EA_Rapid_Advance_03att_cult_eastern	Forward! 	true
vo_unit_texts_text_Land_SA_EA_Rapid_Advance_02att_cult_eastern	Advance at speed!	true
vo_unit_texts_text_Naval_US_BA_Selection_Artillery_Ship_01att_cult_barbarian	Artillery ships ready!	true
vo_unit_texts_text_Naval_US_BA_Selection_Artillery_Ship_02att_cult_barbarian	Artillery awaiting your word!	true
vo_unit_texts_text_Naval_US_BA_Selection_Artillery_Ship_03att_cult_barbarian	Artillery ships reporting!	true
vo_unit_texts_text_Naval_US_BA_Selection_Artillery_Ship_04att_cult_barbarian	Firepower ready!	true
vo_unit_texts_text_Naval_US_BA_Selection_Artillery_Ship_05att_cult_barbarian	Artillery at your command!	true
vo_unit_texts_text_Land_UO_BA_Melee_Button_off_01att_cult_barbarian	Sheath your weapons!	true
vo_unit_texts_text_Land_UO_BA_Melee_Button_off_02att_cult_barbarian	Wait on my word!	true
vo_unit_texts_text_Land_UO_BA_Melee_Button_off_03att_cult_barbarian	Reform!	true
vo_unit_texts_text_Land_UO_BA_Melee_Button_off_04att_cult_barbarian	Stay alert!	true
vo_unit_texts_text_Land_UO_BA_Melee_Button_off_05att_cult_barbarian	Await my word!	true
vo_unit_texts_text_Land_GO_BA_Group_Disbanded_01att_cult_barbarian	Battle group disbanded!	true
vo_unit_texts_text_Land_GO_BA_Group_Disbanded_02att_cult_barbarian	Break battle group!	true
vo_unit_texts_text_Land_GO_BA_Group_Disbanded_03att_cult_barbarian	Battle group disbanding!	true
vo_unit_texts_text_Land_GO_BA_Group_Disbanded_04att_cult_barbarian	Group disbanded!	true
vo_unit_texts_text_Land_GO_BA_Group_Disbanded_05att_cult_barbarian	Disbanding battle group!	true
vo_unit_texts_text_Naval_UO_BA_Attack_Attack_Ranged_01att_cult_eastern	Loose!	true
vo_unit_texts_text_Naval_UO_BA_Attack_Attack_Ranged_02att_cult_eastern	Fire!	true
vo_unit_texts_text_Naval_UO_BA_Attack_Attack_Ranged_03att_cult_eastern	Now!	true
vo_unit_texts_text_Naval_UO_BA_Attack_Attack_Ranged_04att_cult_eastern	Fire on them!	true
vo_unit_texts_text_Naval_UO_BA_Attack_Attack_Ranged_05att_cult_eastern	Take aim, fire!	true
vo_unit_texts_text_Naval_UO_RO_Attack_Attack_Ranged_01att_cult_roman	Loose!	true
vo_unit_texts_text_Naval_UO_RO_Attack_Attack_Ranged_02att_cult_roman	Fire!	true
vo_unit_texts_text_Naval_UO_RO_Attack_Attack_Ranged_03att_cult_roman	Now!	true
vo_unit_texts_text_Naval_UO_RO_Attack_Attack_Ranged_04att_cult_roman	Fire on the enemy!	true
vo_unit_texts_text_Naval_UO_RO_Attack_Attack_Ranged_05att_cult_roman	Take aim, fire!	true
vo_unit_texts_text_Naval_UO_EA_Fire_Artillery_Ships_04att_cult_eastern	Set them ablaze!	true
vo_unit_texts_text_Naval_UO_EA_Fire_Artillery_Ships_05att_cult_eastern	Aim, fire!	true
vo_unit_texts_text_Naval_UO_EA_Fire_Artillery_Ships_02att_cult_eastern	Sink them!	true
vo_unit_texts_text_Naval_UO_EA_Fire_Artillery_Ships_03att_cult_eastern	Smash their hull!	true
vo_unit_texts_text_Naval_UO_EA_Fire_Artillery_Ships_01att_cult_eastern	Fire on them!	true
vo_unit_texts_text_Land_US_RO_Selection_Mercenary_Cimmerian_Archersatt_cult_eastern	Mercenary Cimmerian Archers!	true
vo_unit_texts_text_Land_Mounted_UO_BA_Double_Click_Move_To_Heightened_01att_cult_barbarian	Horsemen, forward!	true
vo_unit_texts_text_Land_Mounted_UO_BA_Double_Click_Move_To_Heightened_02att_cult_barbarian	Forward!	true
vo_unit_texts_text_Land_Mounted_UO_BA_Double_Click_Move_To_Heightened_03att_cult_barbarian	Quickly now!	true
vo_unit_texts_text_Land_Mounted_UO_BA_Double_Click_Move_To_Heightened_04att_cult_barbarian	Riders, advance!	true
vo_unit_texts_text_Land_Mounted_UO_BA_Double_Click_Move_To_Heightened_05att_cult_barbarian	Advance at speed!	true
vo_unit_texts_text_Land_UO_RO_Double_Click_Attack_Heightened_01att_cult_roman	Charge!	true
vo_unit_texts_text_Land_UO_RO_Double_Click_Attack_Heightened_02att_cult_roman	Advance!	true
vo_unit_texts_text_Land_UO_RO_Double_Click_Attack_Heightened_03att_cult_roman	For glory!	true
vo_unit_texts_text_Land_UO_RO_Double_Click_Attack_Heightened_04att_cult_roman	Forward!	true
vo_unit_texts_text_Land_UO_RO_Double_Click_Attack_Heightened_05att_cult_roman	Engage!	true
vo_unit_texts_text_Land_US_EA_Selection_Infantry_missile_generic_4att_cult_eastern	Our aim is true!	true
vo_unit_texts_text_Land_US_EA_Selection_Infantry_missile_generic_5att_cult_eastern	Missile infantry ready!	true
vo_unit_texts_text_Land_Mounted_US_BA_Selection_Royal_Horse_Archersatt_cult_barbarian	Royal Horse Archers!	true
vo_unit_texts_text_Land_US_EA_Selection_Infantry_missile_generic_1att_cult_eastern	Missiles!	true
vo_unit_texts_text_Land_US_EA_Selection_Infantry_missile_generic_2att_cult_eastern	Missiles at your command!	true
vo_unit_texts_text_Land_US_EA_Selection_Infantry_missile_generic_3att_cult_eastern	We will darken the skies!	true
vo_unit_texts_text_Naval_UR_RO_Generic_Order_01att_cult_roman	Orders understood!	true
vo_unit_texts_text_Naval_UR_RO_Generic_Order_02att_cult_roman	As you command!	true
vo_unit_texts_text_Naval_UR_RO_Generic_Order_03att_cult_roman	By your command!	true
vo_unit_texts_text_Naval_UR_RO_Generic_Order_04att_cult_roman	Yes commander!	true
vo_unit_texts_text_Naval_UR_RO_Generic_Order_05att_cult_roman	Understood!	true
vo_unit_texts_text_Land_US_BA_Selection_Chariot_generic_1att_cult_barbarian	Chariots ready!	true
vo_unit_texts_text_Land_US_BA_Selection_Chariot_generic_2att_cult_barbarian	Charioteers!	true
vo_unit_texts_text_Land_US_BA_Selection_Chariot_generic_3att_cult_barbarian	Mighty chariots!	true
vo_unit_texts_text_Land_Mounted_US_RO_Selection_Hippeus_Lancersatt_cult_roman	Hippeus Lancers!	true
vo_unit_texts_text_Land_Mounted_US_EA_Selection_Auxiliary_Cappadocian_Cavalryatt_cult_eastern	Auxiliary Cappadocian Cavalry!	true
vo_unit_texts_text_Land_UO_EA_Man_Siege_Tower_01att_cult_eastern	To the tower!	true
vo_unit_texts_text_Land_UO_EA_Man_Siege_Tower_02att_cult_eastern	Into the tower!	true
vo_unit_texts_text_Land_UO_EA_Man_Siege_Tower_03att_cult_eastern	Man that tower!	true
vo_unit_texts_text_Land_UO_EA_Man_Siege_Tower_04att_cult_eastern	Take up your positions!	true
vo_unit_texts_text_Land_UO_EA_Man_Siege_Tower_05att_cult_eastern	Deploy to the tower!	true
vo_unit_texts_text_Naval_UO_EA_Attack_Attack_Ranged_01att_cult_eastern	Loose!	true
vo_unit_texts_text_Land_UO_BA_Guard_On_01att_cult_barbarian	Guard!	true
vo_unit_texts_text_Land_UO_BA_Guard_On_02att_cult_barbarian	Keep watch!	true
vo_unit_texts_text_Land_UO_BA_Guard_On_03att_cult_barbarian	Be on guard!	true
vo_unit_texts_text_Land_UO_BA_Guard_On_04att_cult_barbarian	On watch!	true
vo_unit_texts_text_Land_UO_BA_Guard_On_05att_cult_barbarian	Hold!	true
vo_unit_texts_text_Naval_UO_EA_Attack_Attack_Ranged_02att_cult_eastern	Fire!	true
vo_unit_texts_text_Naval_UO_EA_Attack_Attack_Ranged_03att_cult_eastern	Darken the skies!	true
vo_unit_texts_text_Naval_UO_EA_Attack_Attack_Ranged_04att_cult_eastern	Let them have it!	true
vo_unit_texts_text_Naval_UO_EA_Attack_Attack_Ranged_05att_cult_eastern	Take aim, fire!	true
vo_unit_texts_text_Naval_UO_BA_Fire_Artillery_Ships_04att_cult_eastern	Destroy the enemies ships!	true
vo_unit_texts_text_Naval_UO_BA_Fire_Artillery_Ships_05att_cult_eastern	Set them ablaze!	true
vo_unit_texts_text_Land_Mounted_US_RO_Selection_Pontic_Royal_Cavalryatt_cult_roman	Pontic Royal Cavalry!	true
vo_unit_texts_text_Naval_UO_BA_Fire_Artillery_Ships_02att_cult_eastern	Aim at the enemy ships!	true
vo_unit_texts_text_Naval_UO_BA_Fire_Artillery_Ships_03att_cult_eastern	Aim, fire!	true
vo_unit_texts_text_Naval_UO_BA_Fire_Artillery_Ships_01att_cult_eastern	Fire on enemy ships!	true
vo_unit_texts_text_Land_US_RO_Selection_Rome_05att_cult_eastern	Sons of Mars!	true
vo_unit_texts_text_Land_US_RO_Selection_Rome_04att_cult_eastern	Jupiter gives us strength!	true
vo_unit_texts_text_Land_US_RO_Selection_Rome_03att_cult_eastern	Romans ready for duty!	true
vo_unit_texts_text_Land_US_RO_Selection_Rome_02att_cult_eastern	Proud Romans all!	true
vo_unit_texts_text_Land_SA_RO_Use_the_Whip_01att_cult_roman	Get moving!	true
vo_unit_texts_text_Land_SA_RO_Use_the_Whip_02att_cult_roman	Move you dogs!	true
vo_unit_texts_text_Land_SA_RO_Use_the_Whip_03att_cult_roman	Take that!	true
vo_unit_texts_text_Land_US_RO_Selection_Rome_01att_cult_eastern	Brave Romans to a man!	true
vo_unit_texts_text_Land_UO_BA_Withdraw_01att_cult_barbarian	Withdraw!	true
vo_unit_texts_text_Land_UO_BA_Withdraw_02att_cult_barbarian	Pull back!	true
vo_unit_texts_text_Land_UO_BA_Withdraw_03att_cult_barbarian	Back!	true
vo_unit_texts_text_Land_UO_BA_Withdraw_04att_cult_barbarian	Warriors, withdraw!	true
vo_unit_texts_text_Land_UO_BA_Withdraw_05att_cult_barbarian	Back warriors, back!	true
vo_unit_texts_text_Land_UR_RO_Generic_Order_01att_cult_roman	Orders understood!	true
vo_unit_texts_text_Land_UR_RO_Generic_Order_02att_cult_roman	As you command!	true
vo_unit_texts_text_Land_UR_RO_Generic_Order_03att_cult_roman	By your command!	true
vo_unit_texts_text_Land_UR_RO_Generic_Order_04att_cult_roman	Yes commander!	true
vo_unit_texts_text_Land_UR_RO_Generic_Order_05att_cult_roman	Understood!	true
vo_unit_texts_text_Land_UO_EA_Melee_Button_on__02att_cult_eastern	Ready men!	true
vo_unit_texts_text_Land_UO_EA_Melee_Button_on__03att_cult_eastern	Prepare to engage!	true
vo_unit_texts_text_Land_UO_EA_Melee_Button_on__01att_cult_eastern	Ready your weapons!	true
vo_unit_texts_text_Land_UO_EA_Melee_Button_on__04att_cult_eastern	Ready yourselves!	true
vo_unit_texts_text_Land_UO_EA_Melee_Button_on__05att_cult_eastern	Draw weapons!	true
vo_unit_texts_text_Land_UO_EA_Melee_Button_off_02att_cult_eastern	Wait on my order!	true
vo_unit_texts_text_Land_UO_EA_Melee_Button_off_03att_cult_eastern	Reform!	true
vo_unit_texts_text_Land_UO_EA_Melee_Button_off_01att_cult_eastern	Form up!	true
vo_unit_texts_text_Land_UO_EA_Melee_Button_off_04att_cult_eastern	Stay on alert!	true
vo_unit_texts_text_Land_UO_EA_Melee_Button_off_05att_cult_eastern	Await my order!	true
vo_unit_texts_text_Land_UO_RO_Double_Click_Attack_01att_cult_roman	Charge!	true
vo_unit_texts_text_Land_UO_RO_Double_Click_Attack_02att_cult_roman	Advance!	true
vo_unit_texts_text_Land_UO_RO_Double_Click_Attack_03att_cult_roman	For glory!	true
vo_unit_texts_text_Land_UO_RO_Double_Click_Attack_04att_cult_roman	Forward!	true
vo_unit_texts_text_Land_UO_RO_Double_Click_Attack_05att_cult_roman	Engage!	true
vo_unit_texts_text_Land_SA_BA_Headhunt_01att_cult_barbarian	His head is mine!	true
vo_unit_texts_text_Land_SA_BA_Headhunt_02att_cult_barbarian	We're taking trophies!	true
vo_unit_texts_text_Land_SA_BA_Headhunt_03att_cult_barbarian	Take their heads!	true
vo_unit_texts_text_Naval_UO_RO_Fire_Artillery_Shore_Targets_01att_cult_roman	Fire on shore targets!	true
vo_unit_texts_text_Naval_UO_RO_Fire_Artillery_Shore_Targets_02att_cult_roman	Take aim, fire on the shore!	true
vo_unit_texts_text_Naval_UO_RO_Fire_Artillery_Shore_Targets_03att_cult_roman	Targets marked, fire!	true
vo_unit_texts_text_Naval_UO_RO_Fire_Artillery_Shore_Targets_04att_cult_roman	Destroy shore targets!	true
vo_unit_texts_text_Naval_UO_RO_Fire_Artillery_Shore_Targets_05att_cult_roman	Artillery, fire on the enemy!	true
vo_unit_texts_text_Land_UR_EA_Attack_Pontus_01att_cult_eastern	Zeus hear us!	true
vo_unit_texts_text_Land_UR_EA_Attack_Pontus_02att_cult_eastern	Fury of the gods!	true
vo_unit_texts_text_Land_UR_EA_Attack_Pontus_03att_cult_eastern	Hail the King!	true
vo_unit_texts_text_Land_UR_EA_Attack_Pontus_04att_cult_eastern	Blood for Pontus!	true
vo_unit_texts_text_Land_UR_EA_Attack_Pontus_05att_cult_eastern	For Zeus!	true
vo_unit_texts_text_Land_UO_RO_Skirmish_Off_01att_cult_roman	Close up!	true
vo_unit_texts_text_Land_UO_RO_Skirmish_Off_02att_cult_roman	Close the ranks!	true
vo_unit_texts_text_Land_UO_RO_Skirmish_Off_03att_cult_roman	Close ranks!	true
vo_unit_texts_text_Land_UO_RO_Skirmish_Off_04att_cult_roman	Fall in!	true
vo_unit_texts_text_Land_UO_RO_Skirmish_Off_05att_cult_roman	Assemble!	true
vo_unit_texts_text_Land_UO_EA_Attack_Pontus_05att_cult_eastern	By Zeus!	true
vo_unit_texts_text_Land_UO_EA_Attack_Pontus_04att_cult_eastern	The gods demand blood!	true
vo_unit_texts_text_Land_UO_EA_Attack_Pontus_01att_cult_eastern	Attack! Warriors of Pontus!	true
vo_unit_texts_text_Land_UO_EA_Attack_Pontus_03att_cult_eastern	For our King!	true
vo_unit_texts_text_Land_UO_EA_Attack_Pontus_02att_cult_eastern	With the fury of the gods!	true
vo_unit_texts_text_Land_SA_BA_Get_Into_Formation_01att_cult_barbarian	Formation! Move!	true
vo_unit_texts_text_Land_SA_BA_Get_Into_Formation_02att_cult_barbarian	Get organised!	true
vo_unit_texts_text_Land_SA_BA_Get_Into_Formation_03att_cult_barbarian	Organise yourselves!	true
vo_unit_texts_text_Land_UO_BA_Generic_Order_Gaul_01att_cult_barbarian	For our ancestors!	true
vo_unit_texts_text_Land_UO_BA_Generic_Order_Gaul_02att_cult_barbarian	For Gaul!	true
vo_unit_texts_text_Land_UO_BA_Generic_Order_Gaul_03att_cult_barbarian	We are Gaul!	true
vo_unit_texts_text_Land_UO_BA_Generic_Order_Gaul_04att_cult_barbarian	All for Gaul!	true
vo_unit_texts_text_Land_UO_BA_Generic_Order_Gaul_05att_cult_barbarian	For the gods!	true
vo_unit_texts_text_Land_UR_BA_Generic_Order_Gaul_01att_cult_barbarian	For our ancestors!	true
vo_unit_texts_text_Land_UR_BA_Generic_Order_Gaul_02att_cult_barbarian	For Gaul!	true
vo_unit_texts_text_Land_UR_BA_Generic_Order_Gaul_03att_cult_barbarian	Mighty Gaul!	true
vo_unit_texts_text_Land_UR_BA_Generic_Order_Gaul_04att_cult_barbarian	Mother to us all!	true
vo_unit_texts_text_Land_UR_BA_Generic_Order_Gaul_05att_cult_barbarian	For the gods!	true
vo_unit_texts_text_Land_UO_BA_Single_Click_Ranged_Attack_01att_cult_barbarian	Loose!	true
vo_unit_texts_text_Land_UO_BA_Single_Click_Ranged_Attack_02att_cult_barbarian	Fire!	true
vo_unit_texts_text_Land_UO_BA_Single_Click_Ranged_Attack_03att_cult_barbarian	Now!	true
vo_unit_texts_text_Land_UO_BA_Single_Click_Ranged_Attack_04att_cult_barbarian	Fire on 'em!	true
vo_unit_texts_text_Land_UO_BA_Single_Click_Ranged_Attack_05att_cult_barbarian	Take aim!	true
vo_unit_texts_text_Naval_UR_EA_Generic_Order_04att_cult_eastern	As you wish!	true
vo_unit_texts_text_Naval_UR_EA_Generic_Order_05att_cult_eastern	Understood!	true
vo_unit_texts_text_Naval_UR_EA_Generic_Order_01att_cult_eastern	Orders understood!	true
vo_unit_texts_text_Naval_UR_EA_Generic_Order_02att_cult_eastern	As you command!	true
vo_unit_texts_text_Naval_UR_EA_Generic_Order_03att_cult_eastern	Yes, my lord!	true
vo_unit_texts_text_Naval_US_BA_Selection_Fire_Potsatt_cult_barbarian	Fire pots ready!	true
vo_unit_texts_text_Land_UO_EA_Generic_Order_Parthia_04att_cult_eastern	For Parthia!	true
vo_unit_texts_text_Land_SA_BA_Stand_and_Fight_01att_cult_barbarian	Death holds no fear for us!	true
vo_unit_texts_text_Land_SA_BA_Stand_and_Fight_02att_cult_barbarian	Stand and fight!	true
vo_unit_texts_text_Land_SA_BA_Stand_and_Fight_03att_cult_barbarian	Death?! Ha!	true
vo_unit_texts_text_Land_UO_EA_Generic_Order_Parthia_05att_cult_eastern	Who are we?!	true
vo_unit_texts_text_Land_UO_EA_Generic_Order_Parthia_02att_cult_eastern	For Ahura Mazdah!	true
vo_unit_texts_text_Land_UO_EA_Generic_Order_Parthia_03att_cult_eastern	In service to the King!	true
vo_unit_texts_text_Land_UO_EA_Generic_Order_Parthia_01att_cult_eastern	For the King!	true
vo_unit_texts_text_Land_UR_EA_Generic_Order_Parthia_03att_cult_eastern	His majesty!	true
vo_unit_texts_text_Land_UR_EA_Generic_Order_Parthia_02att_cult_eastern	For Ahura Mazdah!	true
vo_unit_texts_text_Land_UR_EA_Generic_Order_Parthia_01att_cult_eastern	For the King!	true
vo_unit_texts_text_Land_UR_EA_Generic_Order_Parthia_05att_cult_eastern	Sons of Parthia!	true
vo_unit_texts_text_Land_UR_EA_Generic_Order_Parthia_04att_cult_eastern	For Parthia!	true
vo_unit_texts_text_Land_UO_EA_Move_Siege_Tower_01att_cult_eastern	Siege towers, now!	true
vo_unit_texts_text_Land_UO_EA_Move_Siege_Tower_02att_cult_eastern	Get that tower moving!	true
vo_unit_texts_text_Land_UO_EA_Move_Siege_Tower_03att_cult_eastern	To your positions!	true
vo_unit_texts_text_Land_UO_EA_Move_Siege_Tower_04att_cult_eastern	To the tower!	true
vo_unit_texts_text_Land_UO_EA_Move_Siege_Tower_05att_cult_eastern	Put your backs in to it!	true
vo_unit_texts_text_Land_Mounted_UO_BA_Dismount_01att_cult_barbarian	Dismount!	true
vo_unit_texts_text_Land_Mounted_UO_BA_Dismount_02att_cult_barbarian	Riders, dismount!	true
vo_unit_texts_text_Land_Mounted_UO_BA_Dismount_03att_cult_barbarian	Dismount, now!	true
vo_unit_texts_text_Land_Mounted_UO_BA_Dismount_04att_cult_barbarian	On your feet!	true
vo_unit_texts_text_Land_Mounted_UO_BA_Dismount_05att_cult_barbarian	Warriors, dismount!	true
vo_unit_texts_text_Land_US_BA_Selection_Scutariiatt_cult_barbarian	Scutarii!	true
vo_unit_texts_text_Land_US_EA_Selection_Infantry_pike_men_generic_5att_cult_eastern	Pikes ready!	true
vo_unit_texts_text_Land_US_RO_Selection_Infantry_pike_men_generic_5att_cult_eastern	Pikes at the ready!	true
vo_unit_texts_text_Land_US_EA_Selection_Infantry_pike_men_generic_4att_cult_eastern	Pike infantry ready!	true
vo_unit_texts_text_Land_US_RO_Selection_Infantry_pike_men_generic_4att_cult_eastern	Pike men ready for orders!	true
vo_unit_texts_text_Land_US_EA_Selection_Infantry_pike_men_generic_3att_cult_eastern	Pike men awaiting orders!	true
vo_unit_texts_text_Land_US_RO_Selection_Infantry_pike_men_generic_3att_cult_eastern	Pikes ready!	true
vo_unit_texts_text_Land_US_EA_Selection_Infantry_pike_men_generic_2att_cult_eastern	Pike men at your command!	true
vo_unit_texts_text_Land_US_RO_Selection_Infantry_pike_men_generic_2att_cult_eastern	Pike infantry at your command!	true
vo_unit_texts_text_Land_US_EA_Selection_Infantry_pike_men_generic_1att_cult_eastern	Pike men!	true
vo_unit_texts_text_Land_US_RO_Selection_Infantry_pike_men_generic_1att_cult_eastern	Pike infantry ready!	true
vo_unit_texts_text_Land_Mounted_UO_EA_Dismount_01att_cult_eastern	Dismount!	true
vo_unit_texts_text_Land_Mounted_UO_EA_Dismount_03att_cult_eastern	Dismount, now!	true
vo_unit_texts_text_Land_Mounted_UO_EA_Dismount_02att_cult_eastern	Riders, dismount!	true
vo_unit_texts_text_Land_Mounted_UO_EA_Dismount_05att_cult_eastern	Men, dismount!	true
vo_unit_texts_text_Land_Mounted_UO_EA_Dismount_04att_cult_eastern	On your feet!	true
vo_unit_texts_text_Land_UO_RO_Generic_Order_Macedon_01att_cult_roman	For Macedon!	true
vo_unit_texts_text_Land_UO_RO_Generic_Order_Macedon_02att_cult_roman	Macedon!	true
vo_unit_texts_text_Land_UO_RO_Generic_Order_Macedon_03att_cult_roman	In service of the People!	true
vo_unit_texts_text_Land_UO_RO_Generic_Order_Macedon_04att_cult_roman	Happy to serve the People!	true
vo_unit_texts_text_Land_UO_RO_Generic_Order_Macedon_05att_cult_roman	For the gods of Olympus!	true
vo_unit_texts_text_Land_UR_RO_Generic_Order_Macedon_01att_cult_roman	For Macedon!	true
vo_unit_texts_text_Land_UR_RO_Generic_Order_Macedon_02att_cult_roman	Macedon!	true
vo_unit_texts_text_Land_UR_RO_Generic_Order_Macedon_03att_cult_roman	For the People!	true
vo_unit_texts_text_Land_UR_RO_Generic_Order_Macedon_04att_cult_roman	As Macedon commands!	true
vo_unit_texts_text_Land_UR_RO_Generic_Order_Macedon_05att_cult_roman	The gods!	true
vo_unit_texts_text_Land_UO_BA_Skirmish_Leftatt_cult_barbarian	Skirmish left! 	true
vo_unit_texts_text_Land_US_RO_Selection_Silver_Shield_Pikemenatt_cult_eastern	Silver Shield Pikemen!	true
vo_unit_texts_text_Land_GO_EA_Lock_Formation_05att_cult_eastern	Fix formation!	true
vo_unit_texts_text_Land_GO_EA_Lock_Formation_04att_cult_eastern	Hold this formation!	true
vo_unit_texts_text_Land_GO_EA_Lock_Formation_01att_cult_eastern	Lock formation!	true
vo_unit_texts_text_Land_GO_EA_Lock_Formation_03att_cult_eastern	Maintain the lines!	true
vo_unit_texts_text_Land_GO_EA_Lock_Formation_02att_cult_eastern	Keep this formation!	true
vo_unit_texts_text_Naval_UO_RO_Hold_Water_01att_cult_roman	Halt!	true
vo_unit_texts_text_Naval_UO_RO_Hold_Water_02att_cult_roman	Hold water!	true
vo_unit_texts_text_Naval_UO_RO_Hold_Water_03att_cult_roman	Stop!	true
vo_unit_texts_text_Naval_UO_RO_Hold_Water_04att_cult_roman	Halt now!	true
vo_unit_texts_text_Naval_UO_RO_Hold_Water_05att_cult_roman	Hold!	true
vo_unit_texts_text_Land_US_BA_Selection_Gauls_01att_cult_barbarian	Warriors of Gaul!	true
vo_unit_texts_text_Land_US_BA_Selection_Gauls_02att_cult_barbarian	Sons of Gaul!	true
vo_unit_texts_text_Land_US_BA_Selection_Gauls_03att_cult_barbarian	Gallic warriors!	true
vo_unit_texts_text_Land_US_BA_Selection_Gauls_04att_cult_barbarian	We are Gaul!	true
vo_unit_texts_text_Land_US_BA_Selection_Gauls_05att_cult_barbarian	Boars of Gaul!	true
vo_unit_texts_text_Land_UO_BA_Double_Click_Melee_Attack_01att_cult_barbarian	Hack them!	true
vo_unit_texts_text_Land_UO_BA_Double_Click_Melee_Attack_02att_cult_barbarian	Cut them!	true
vo_unit_texts_text_Land_UO_BA_Double_Click_Melee_Attack_03att_cult_barbarian	Stab them!	true
vo_unit_texts_text_Land_UO_BA_Double_Click_Melee_Attack_04att_cult_barbarian	Slash them!	true
vo_unit_texts_text_Land_UO_BA_Double_Click_Melee_Attack_05att_cult_barbarian	Bleed them!	true
vo_unit_texts_text_Land_Mounted_US_BA_Selection_Scutarii_Cavalryatt_cult_barbarian	Scutarii Cavalry!	true
vo_unit_texts_text_Land_US_RO_Selection_Infantry_missile_generic_4att_cult_eastern	Missile infantry!	true
vo_unit_texts_text_Land_US_RO_Selection_Infantry_missile_generic_5att_cult_eastern	Missiles awaiting targets!	true
vo_unit_texts_text_Land_US_RO_Selection_Infantry_missile_generic_1att_cult_eastern	Missile infantry ready!	true
vo_unit_texts_text_Land_US_RO_Selection_Infantry_missile_generic_2att_cult_eastern	Missile infantry at your command!	true
vo_unit_texts_text_Land_US_RO_Selection_Infantry_missile_generic_3att_cult_eastern	Missiles, ready and waiting!	true
vo_unit_texts_text_Land_UO_EA_Guard_On_03att_cult_eastern	Defensive positions!	true
vo_unit_texts_text_Land_UO_EA_Guard_On_02att_cult_eastern	Hold position!	true
vo_unit_texts_text_Land_UO_EA_Guard_On_01att_cult_eastern	Guard!	true
vo_unit_texts_text_Land_UO_EA_Guard_On_05att_cult_eastern	Stay alert!	true
vo_unit_texts_text_Land_UO_EA_Guard_On_04att_cult_eastern	On watch!	true
vo_unit_texts_text_Land_Mounted_US_EA_Selection_Mercenary_Cappadocian_Cavalryatt_cult_eastern	Mercenary Cappadocian Cavalry!	true
vo_unit_texts_text_Land_UO_RO_Halt_01att_cult_roman	Halt!	true
vo_unit_texts_text_Land_UO_RO_Halt_02att_cult_roman	Stop!	true
vo_unit_texts_text_Land_UO_RO_Halt_03att_cult_roman	Halt men!	true
vo_unit_texts_text_Land_UO_RO_Halt_04att_cult_roman	Stop now!	true
vo_unit_texts_text_Land_UO_RO_Halt_05att_cult_roman	Halt now!	true
vo_unit_texts_text_Land_UO_RO_Skirmish_Centreatt_cult_roman	Centre skirmish! 	true
vo_unit_texts_text_Land_UO_BA_Hold_Position_on_01att_cult_barbarian	Hold position!	true
vo_unit_texts_text_Land_UO_BA_Hold_Position_on_02att_cult_barbarian	Hold steady!	true
vo_unit_texts_text_Land_UO_BA_Hold_Position_on_03att_cult_barbarian	Hold lads, hold!	true
vo_unit_texts_text_Land_UO_BA_Hold_Position_on_04att_cult_barbarian	Keep this position!	true
vo_unit_texts_text_Land_UO_BA_Hold_Position_on_05att_cult_barbarian	Hold here!	true
vo_unit_texts_text_Land_UO_RO_Single_Click_Melee_Attack_Heightened_01att_cult_roman	Hack them down!	true
vo_unit_texts_text_Land_UO_RO_Single_Click_Melee_Attack_Heightened_02att_cult_roman	Cut them down!	true
vo_unit_texts_text_Land_UO_RO_Single_Click_Melee_Attack_Heightened_03att_cult_roman	To arms!	true
vo_unit_texts_text_Land_UO_RO_Single_Click_Melee_Attack_Heightened_04att_cult_roman	Break the lines!	true
vo_unit_texts_text_Land_UO_RO_Single_Click_Melee_Attack_Heightened_05att_cult_roman	Attack their position!	true
vo_unit_texts_text_Land_UO_EA_Change_Facing_05att_cult_eastern	About face!	true
vo_unit_texts_text_Land_UO_EA_Change_Facing_04att_cult_eastern	Face your target!	true
vo_unit_texts_text_Land_UO_EA_Change_Facing_03att_cult_eastern	Move the artillery!	true
vo_unit_texts_text_Land_UO_EA_Change_Facing_02att_cult_eastern	Switch targets!	true
vo_unit_texts_text_Land_UO_EA_Change_Facing_01att_cult_eastern	Change facing!	true
vo_unit_texts_text_Land_UO_BA_Man_Siege_Tower_01att_cult_barbarian	Inside, come on!	true
vo_unit_texts_text_Land_UO_BA_Man_Siege_Tower_02att_cult_barbarian	Into the tower!	true
vo_unit_texts_text_Land_UO_BA_Man_Siege_Tower_03att_cult_barbarian	To your positions!	true
vo_unit_texts_text_Land_UO_BA_Man_Siege_Tower_04att_cult_barbarian	Man the tower!	true
vo_unit_texts_text_Land_UO_BA_Man_Siege_Tower_05att_cult_barbarian	Get on the tower!	true
vo_unit_texts_text_Naval_UO_RO_Fire_Artillery_Ships_01att_cult_roman	Fire on enemy ships!	true
vo_unit_texts_text_Naval_UO_RO_Fire_Artillery_Ships_02att_cult_roman	Target enemy ships!	true
vo_unit_texts_text_Naval_UO_RO_Fire_Artillery_Ships_03att_cult_roman	Aim, fire!	true
vo_unit_texts_text_Naval_UO_RO_Fire_Artillery_Ships_04att_cult_roman	Destroy the enemies ships!	true
vo_unit_texts_text_Naval_UO_RO_Fire_Artillery_Ships_05att_cult_roman	Set them ablaze!	true
vo_unit_texts_text_Land_UO_BA_Move_Ram_01att_cult_barbarian	Man the ram!	true
vo_unit_texts_text_Land_UO_BA_Move_Ram_02att_cult_barbarian	To the ram!	true
vo_unit_texts_text_Land_UO_BA_Move_Ram_03att_cult_barbarian	Get that ram moving!	true
vo_unit_texts_text_Land_UO_BA_Move_Ram_04att_cult_barbarian	Come on, get it moving!	true
vo_unit_texts_text_Land_UO_BA_Move_Ram_05att_cult_barbarian	Move the ram!	true
vo_unit_texts_text_Land_US_RO_Selection_Agema_Spearsatt_cult_roman	Agema Spears!	true
vo_unit_texts_text_Land_SA_RO_Into_the_Breach_Group_01att_cult_roman	In to the breach!	true
vo_unit_texts_text_Land_SA_RO_Into_the_Breach_Group_02att_cult_roman	Fight your way through!	true
vo_unit_texts_text_Land_SA_RO_Into_the_Breach_Group_03att_cult_roman	Advance, into the breach!	true
vo_unit_texts_text_Land_GO_RO_Lock_Formation_01att_cult_roman	Stay as you are!	true
vo_unit_texts_text_Land_GO_RO_Lock_Formation_02att_cult_roman	Anyone who breaks formation will be punished!	true
vo_unit_texts_text_Land_GO_RO_Lock_Formation_03att_cult_roman	Hold formation!	true
vo_unit_texts_text_Land_GO_RO_Lock_Formation_04att_cult_roman	Stay in formation!	true
vo_unit_texts_text_Land_GO_RO_Lock_Formation_05att_cult_roman	Don't break formation!	true
vo_unit_texts_text_Land_GO_EA_Group_Created_03att_cult_eastern	Band together!	true
vo_unit_texts_text_Land_GO_EA_Group_Created_02att_cult_eastern	Battle group ready!	true
vo_unit_texts_text_Land_GO_EA_Group_Created_01att_cult_eastern	Come together!	true
vo_unit_texts_text_Land_GO_EA_Group_Created_05att_cult_eastern	Battle group awaiting orders!	true
vo_unit_texts_text_Land_GO_EA_Group_Created_04att_cult_eastern	We attack as one!	true
vo_unit_texts_text_Naval_UO_RO_Single_Click_Move_To_01att_cult_roman	Moving out!	true
vo_unit_texts_text_Naval_UO_RO_Single_Click_Move_To_02att_cult_roman	To the oars!	true
vo_unit_texts_text_Naval_UO_RO_Single_Click_Move_To_03att_cult_roman	Set oars!	true
vo_unit_texts_text_Naval_UO_RO_Single_Click_Move_To_04att_cult_roman	Move out!	true
vo_unit_texts_text_Naval_UO_RO_Single_Click_Move_To_05att_cult_roman	Give way!	true
vo_unit_texts_text_Land_US_BA_Selection_Special_generic_1att_cult_barbarian	Savage dogs!	true
vo_unit_texts_text_Land_US_BA_Selection_Special_generic_2att_cult_barbarian	Easy boy, easy!	true
vo_unit_texts_text_Land_US_BA_Selection_Special_generic_3att_cult_barbarian	Dogs ready and hungry!	true
vo_unit_texts_text_Land_UO_BA_Tight_Formation_01att_cult_barbarian	Tight formation!	true
vo_unit_texts_text_Land_UO_BA_Tight_Formation_02att_cult_barbarian	Come together!	true
vo_unit_texts_text_Land_UO_BA_Tight_Formation_03att_cult_barbarian	Form tight formation!	true
vo_unit_texts_text_Land_UO_BA_Tight_Formation_04att_cult_barbarian	Warriors, together!	true
vo_unit_texts_text_Land_UO_BA_Tight_Formation_05att_cult_barbarian	Close up! Now!	true
vo_unit_texts_text_Land_Mounted_UO_EA_Mount_05att_cult_eastern	Riders, mount up!	true
vo_unit_texts_text_Land_Mounted_UO_EA_Mount_04att_cult_eastern	Mount up, men!	true
vo_unit_texts_text_Land_Mounted_UO_EA_Mount_01att_cult_eastern	Mount up!	true
vo_unit_texts_text_Land_Mounted_UO_EA_Mount_03att_cult_eastern	Mount!	true
vo_unit_texts_text_Land_Mounted_UO_EA_Mount_02att_cult_eastern	To the saddle!	true
vo_unit_texts_text_Land_UO_EA_Double_Click_Attack_Heightened_03att_cult_eastern	For glory!	true
vo_unit_texts_text_Land_UO_EA_Double_Click_Attack_Heightened_02att_cult_eastern	For honour!	true
vo_unit_texts_text_Land_UO_EA_Double_Click_Attack_Heightened_01att_cult_eastern	Charge!	true
vo_unit_texts_text_Land_UO_EA_Double_Click_Attack_Heightened_05att_cult_eastern	Engage!	true
vo_unit_texts_text_Land_UO_EA_Double_Click_Attack_Heightened_04att_cult_eastern	Forward!	true
vo_unit_texts_text_Land_Mounted_US_RO_Selection_Hellenic_Royal_Cavalryatt_cult_roman	Hellenic Royal Cavalry!	true
vo_unit_texts_text_Land_SA_RO_Raise_Banner_01att_cult_roman	Raise the banners!	true
vo_unit_texts_text_Land_SA_RO_Raise_Banner_02att_cult_roman	To the banners!	true
vo_unit_texts_text_Land_SA_RO_Raise_Banner_03att_cult_roman	Hold the banners high!	true
vo_unit_texts_text_Land_US_RO_Selection_Auxiliary_Cimmerian_Archersatt_cult_eastern	Auxiliary Cimmerian Archers!	true
vo_unit_texts_text_Land_US_BA_Selection_Cavalry_missile_generic_1att_cult_barbarian	Missile riders!	true
vo_unit_texts_text_Land_US_BA_Selection_Cavalry_missile_generic_2att_cult_barbarian	Our aim is true!	true
vo_unit_texts_text_Land_US_BA_Selection_Cavalry_missile_generic_3att_cult_barbarian	Mounted missile warriors!	true
vo_unit_texts_text_Land_US_BA_Selection_Cavalry_missile_generic_4att_cult_barbarian	The gods guide our shots!	true
vo_unit_texts_text_Land_US_BA_Selection_Cavalry_missile_generic_5att_cult_barbarian	Missile-armed riders!	true
vo_unit_texts_text_Land_SA_RO_Taunt_Group_01att_cult_roman	You fight like women!	true
vo_unit_texts_text_Land_SA_RO_Taunt_Group_02att_cult_roman	Have your gods forsaken you?!	true
vo_unit_texts_text_Land_SA_RO_Taunt_Group_03att_cult_roman	Your battle is lost!	true
vo_unit_texts_text_Naval_UO_RO_Turn_Right_01att_cult_roman	To the Right!	true
vo_unit_texts_text_Naval_UO_RO_Turn_Right_02att_cult_roman	Turn right	true
vo_unit_texts_text_Naval_UO_RO_Turn_Right_03att_cult_roman	To starboard!	true
vo_unit_texts_text_Naval_UO_RO_Turn_Right_04att_cult_roman	Right!	true
vo_unit_texts_text_Naval_UO_RO_Turn_Right_05att_cult_roman	Starboard!	true
vo_unit_texts_text_Land_SA_BA_Brace!_01att_cult_barbarian	Hold lads, hold!	true
vo_unit_texts_text_Land_SA_BA_Brace!_02att_cult_barbarian	Brace!	true
vo_unit_texts_text_Land_SA_BA_Brace!_03att_cult_barbarian	Get ready, get ready!	true
vo_unit_texts_text_Naval_UO_RO_Double_Click_Move_To_01att_cult_roman	Row!	true
vo_unit_texts_text_Naval_UO_RO_Double_Click_Move_To_02att_cult_roman	Set a course!	true
vo_unit_texts_text_Naval_UO_RO_Double_Click_Move_To_03att_cult_roman	Move out, double time!	true
vo_unit_texts_text_Naval_UO_RO_Double_Click_Move_To_04att_cult_roman	Get to the oars!	true
vo_unit_texts_text_Naval_UO_RO_Double_Click_Move_To_05att_cult_roman	Get moving!	true
vo_unit_texts_text_Land_US_EA_Selection_Nubian_Bowmenatt_cult_eastern	Nubian Bowmen!	true
vo_unit_texts_text_Naval_UO_BA_Stop_Turning_01att_cult_eastern	Halt the turn!	true
vo_unit_texts_text_Naval_UO_BA_Stop_Turning_03att_cult_eastern	Stop the turn!	true
vo_unit_texts_text_Naval_UO_BA_Stop_Turning_02att_cult_eastern	Cease turning!	true
vo_unit_texts_text_Naval_UO_BA_Stop_Turning_05att_cult_eastern	Stop turning, now!	true
vo_unit_texts_text_Naval_UO_BA_Stop_Turning_04att_cult_eastern	Halt turning!	true
vo_unit_texts_text_Land_Mounted_UO_BA_Single_Click_Move_To_Heightened_01att_cult_barbarian	Riders, forward!	true
vo_unit_texts_text_Land_Mounted_UO_BA_Single_Click_Move_To_Heightened_02att_cult_barbarian	On me!	true
vo_unit_texts_text_Land_Mounted_UO_BA_Single_Click_Move_To_Heightened_03att_cult_barbarian	Ride out!	true
vo_unit_texts_text_Land_Mounted_UO_BA_Single_Click_Move_To_Heightened_04att_cult_barbarian	Riders, move out!	true
vo_unit_texts_text_Land_Mounted_UO_BA_Single_Click_Move_To_Heightened_05att_cult_barbarian	Follow me!	true
vo_unit_texts_text_Land_SA_RO_Inspire_Group_01att_cult_roman	For honour and glory!	true
vo_unit_texts_text_Land_SA_RO_Inspire_Group_02att_cult_roman	Glory awaits!	true
vo_unit_texts_text_Land_SA_RO_Inspire_Group_03att_cult_roman	On to victory!	true
vo_unit_texts_text_Land_US_BA_Selection_Oathswornatt_cult_barbarian	Oathsworn warriors!	true
vo_unit_texts_text_Land_UO_BA_Hold_Position_off_01att_cult_barbarian	Ready yourselves!	true
vo_unit_texts_text_Land_UO_BA_Hold_Position_off_02att_cult_barbarian	Prepare to move out!	true
vo_unit_texts_text_Land_UO_BA_Hold_Position_off_03att_cult_barbarian	Leave the position!	true
vo_unit_texts_text_Land_UO_BA_Hold_Position_off_04att_cult_barbarian	We don't need this position!	true
vo_unit_texts_text_Land_UO_BA_Hold_Position_off_05att_cult_barbarian	Leave it!	true
vo_unit_texts_text_Land_SA_RO_Killing_Spree_01att_cult_roman	Their blood sustains me!	true
vo_unit_texts_text_Land_SA_RO_Killing_Spree_02att_cult_roman	I must have blood!	true
vo_unit_texts_text_Land_SA_RO_Killing_Spree_03att_cult_roman	Is there no one else?!	true
vo_unit_texts_text_Land_UO_BA_Attack_Germania_01att_cult_barbarian	For the Old Father!	true
vo_unit_texts_text_Land_UO_BA_Attack_Germania_02att_cult_barbarian	Germania!	true
vo_unit_texts_text_Land_UO_BA_Attack_Germania_03att_cult_barbarian	Bringers of death!	true
vo_unit_texts_text_Land_UO_BA_Attack_Germania_04att_cult_barbarian	Attack, for Germania!	true
vo_unit_texts_text_Land_UO_BA_Attack_Germania_05att_cult_barbarian	Who do we honour?!	true
vo_unit_texts_text_Naval_UO_RO_Drop_Anchor_01att_cult_roman	Drop anchor!	true
vo_unit_texts_text_Naval_UO_RO_Drop_Anchor_02att_cult_roman	Let go the anchor!	true
vo_unit_texts_text_Naval_UO_RO_Drop_Anchor_03att_cult_roman	Deploy the anchor!	true
vo_unit_texts_text_Naval_UO_RO_Drop_Anchor_04att_cult_roman	Ride at anchor!	true
vo_unit_texts_text_Naval_UO_RO_Drop_Anchor_05att_cult_roman	Come to anchor!	true
vo_unit_texts_text_Land_UR_BA_Attack_Germania_01att_cult_barbarian	For the Old Father!	true
vo_unit_texts_text_Land_UR_BA_Attack_Germania_02att_cult_barbarian	Germania!	true
vo_unit_texts_text_Land_UR_BA_Attack_Germania_03att_cult_barbarian	Death!	true
vo_unit_texts_text_Land_UR_BA_Attack_Germania_04att_cult_barbarian	For our people!	true
vo_unit_texts_text_Land_UR_BA_Attack_Germania_05att_cult_barbarian	For our forefathers!	true
vo_unit_texts_text_Land_UO_BA_Single_Click_Melee_Attack_01att_cult_barbarian	Hack them down!	true
vo_unit_texts_text_Land_UO_BA_Single_Click_Melee_Attack_02att_cult_barbarian	Cut them down!	true
vo_unit_texts_text_Land_UO_BA_Single_Click_Melee_Attack_03att_cult_barbarian	Take their heads!	true
vo_unit_texts_text_Land_UO_BA_Single_Click_Melee_Attack_04att_cult_barbarian	Make them bleed!	true
vo_unit_texts_text_Land_UO_BA_Single_Click_Melee_Attack_05att_cult_barbarian	Cut them!	true
vo_unit_texts_text_Land_UO_EA_Move_Ram_02att_cult_eastern	To the ram!	true
vo_unit_texts_text_Land_UO_EA_Move_Ram_03att_cult_eastern	Get that ram moving!	true
vo_unit_texts_text_Land_UO_EA_Move_Ram_01att_cult_eastern	Prepare the ram!	true
vo_unit_texts_text_Land_UO_EA_Move_Ram_04att_cult_eastern	Take positions!	true
vo_unit_texts_text_Land_UO_EA_Move_Ram_05att_cult_eastern	Move the ram!	true
vo_unit_texts_text_Land_SA_EA_Brace!_Group_01att_cult_eastern	Brace, men!	true
vo_unit_texts_text_Land_SA_EA_Brace!_Group_02att_cult_eastern	Get ready, get ready!	true
vo_unit_texts_text_Land_SA_EA_Brace!_Group_03att_cult_eastern	Stay strong!	true
vo_unit_texts_text_Land_UR_EA_Move_To_01att_cult_eastern	Moving out!	true
vo_unit_texts_text_Land_UR_EA_Move_To_03att_cult_eastern	On the move!	true
vo_unit_texts_text_Land_UR_EA_Move_To_02att_cult_eastern	On the way!	true
vo_unit_texts_text_Land_UR_EA_Move_To_05att_cult_eastern	Huh!	true
vo_unit_texts_text_Land_UR_EA_Move_To_04att_cult_eastern	Heading out!	true
vo_unit_texts_text_Land_UO_BA_Loose_Formation_01att_cult_barbarian	Loose formation!	true
vo_unit_texts_text_Land_UO_BA_Loose_Formation_02att_cult_barbarian	Spread out!	true
vo_unit_texts_text_Land_UO_BA_Loose_Formation_03att_cult_barbarian	Loose formation, now!	true
vo_unit_texts_text_Land_UO_BA_Loose_Formation_04att_cult_barbarian	Warriors loose formation!	true
vo_unit_texts_text_Land_UO_BA_Loose_Formation_05att_cult_barbarian	Warriors, spread out!	true
vo_unit_texts_text_Naval_UO_RO_Attack_Close_Quarters_01att_cult_roman	Get at them!	true
vo_unit_texts_text_Naval_UO_RO_Attack_Close_Quarters_02att_cult_roman	Show them steel!	true
vo_unit_texts_text_Naval_UO_RO_Attack_Close_Quarters_03att_cult_roman	Hack them down!	true
vo_unit_texts_text_Naval_UO_RO_Attack_Close_Quarters_04att_cult_roman	Weapons ready!	true
vo_unit_texts_text_Naval_UO_RO_Attack_Close_Quarters_05att_cult_roman	Attack!	true
vo_unit_texts_text_Land_UO_RO_Single_Click_Attack_01att_cult_roman	Attack!	true
vo_unit_texts_text_Land_UO_RO_Single_Click_Attack_02att_cult_roman	To victory!	true
vo_unit_texts_text_Land_UO_RO_Single_Click_Attack_03att_cult_roman	Engage!	true
vo_unit_texts_text_Land_UO_RO_Single_Click_Attack_04att_cult_roman	Ready your weapons!	true
vo_unit_texts_text_Land_UO_RO_Single_Click_Attack_05att_cult_roman	To arms!	true
vo_unit_texts_text_Naval_UR_BA_Move_To_01att_cult_barbarian	Moving out!	true
vo_unit_texts_text_Naval_UR_BA_Move_To_02att_cult_barbarian	Heave!	true
vo_unit_texts_text_Naval_UR_BA_Move_To_03att_cult_barbarian	Oars, aye!	true
vo_unit_texts_text_Naval_UR_BA_Move_To_04att_cult_barbarian	Pull!	true
vo_unit_texts_text_Naval_UR_BA_Move_To_05att_cult_barbarian	Oars ready!	true
vo_unit_texts_text_Land_SA_RO_Push_01att_cult_roman	Push!	true
vo_unit_texts_text_Land_SA_RO_Push_02att_cult_roman	Put your backs in to it!	true
vo_unit_texts_text_Land_SA_RO_Push_03att_cult_roman	Forward, push!	true
vo_unit_texts_text_Naval_UO_BA_Decrease_Rowing_Speed_04att_cult_eastern	Ease off the oars!	true
vo_unit_texts_text_Naval_UO_BA_Increase_Rowing_Speed_04att_cult_eastern	Hard on the oars!	true
vo_unit_texts_text_Naval_UO_EA_Decrease_Rowing_Speed_04att_cult_eastern	Calm the oars!	true
vo_unit_texts_text_Naval_UO_EA_Increase_Rowing_Speed_04att_cult_eastern	Faster!	true
vo_unit_texts_text_Naval_UO_BA_Decrease_Rowing_Speed_05att_cult_eastern	Slow speed!	true
vo_unit_texts_text_Naval_UO_BA_Increase_Rowing_Speed_05att_cult_eastern	Faster!	true
vo_unit_texts_text_Naval_UO_EA_Decrease_Rowing_Speed_05att_cult_eastern	Ease off!	true
vo_unit_texts_text_Naval_UO_EA_Increase_Rowing_Speed_05att_cult_eastern	Full oars, full effort!	true
vo_unit_texts_text_Naval_UO_BA_Decrease_Rowing_Speed_01att_cult_eastern	Easy on the oars!	true
vo_unit_texts_text_Naval_UO_BA_Increase_Rowing_Speed_01att_cult_eastern	Row faster!	true
vo_unit_texts_text_Naval_UO_EA_Decrease_Rowing_Speed_01att_cult_eastern	Hold water!	true
vo_unit_texts_text_Naval_UO_EA_Increase_Rowing_Speed_01att_cult_eastern	More speed!	true
vo_unit_texts_text_Naval_UO_BA_Decrease_Rowing_Speed_02att_cult_eastern	Slow up!	true
vo_unit_texts_text_Naval_UO_BA_Increase_Rowing_Speed_02att_cult_eastern	Full speed ahead!	true
vo_unit_texts_text_Naval_UO_EA_Decrease_Rowing_Speed_02att_cult_eastern	Steady ahead!	true
vo_unit_texts_text_Naval_UO_EA_Increase_Rowing_Speed_02att_cult_eastern	Increase speed!	true
vo_unit_texts_text_Naval_UO_BA_Decrease_Rowing_Speed_03att_cult_eastern	Lift oars!	true
vo_unit_texts_text_Naval_UO_BA_Increase_Rowing_Speed_03att_cult_eastern	Row curse you!	true
vo_unit_texts_text_Naval_UO_EA_Decrease_Rowing_Speed_03att_cult_eastern	Drop the speed!	true
vo_unit_texts_text_Naval_UO_EA_Increase_Rowing_Speed_03att_cult_eastern	Give me more oars!	true
vo_unit_texts_text_Land_UO_EA_Embark_03att_cult_eastern	Get aboard!	true
vo_unit_texts_text_Land_UO_EA_Embark_02att_cult_eastern	Embark!	true
vo_unit_texts_text_Land_UO_EA_Embark_01att_cult_eastern	To the ships!	true
vo_unit_texts_text_Land_UO_EA_Embark_05att_cult_eastern	Embark, now!	true
vo_unit_texts_text_Land_UO_EA_Embark_04att_cult_eastern	Board the ships!	true
vo_unit_texts_text_Naval_US_BA_Selection_Transport_Ship_01att_cult_barbarian	Transport ships!	true
vo_unit_texts_text_Naval_US_BA_Selection_Transport_Ship_02att_cult_barbarian	Transports ready and waiting!	true
vo_unit_texts_text_Naval_US_BA_Selection_Transport_Ship_03att_cult_barbarian	Transport ships aye!	true
vo_unit_texts_text_Naval_US_BA_Selection_Transport_Ship_04att_cult_barbarian	Transports!	true
vo_unit_texts_text_Naval_US_BA_Selection_Transport_Ship_05att_cult_barbarian	Transports awaiting your word!	true
vo_unit_texts_text_Land_US_EA_Selection_Pontus_05att_cult_eastern	The Gods are with us!	true
vo_unit_texts_text_Land_US_EA_Selection_Pontus_04att_cult_eastern	Pontic warriors!	true
vo_unit_texts_text_Land_US_EA_Selection_Pontus_01att_cult_eastern	We serve the King!	true
vo_unit_texts_text_Land_US_EA_Selection_Pontus_03att_cult_eastern	May Zeus protect me!	true
vo_unit_texts_text_Land_US_EA_Selection_Pontus_02att_cult_eastern	Forever loyal to the King!	true
vo_unit_texts_text_Naval_UR_EA_Move_To_01att_cult_eastern	Moving out!	true
vo_unit_texts_text_Naval_UR_EA_Move_To_02att_cult_eastern	Heave!	true
vo_unit_texts_text_Naval_UR_EA_Move_To_03att_cult_eastern	Pull!	true
vo_unit_texts_text_Naval_UR_EA_Move_To_04att_cult_eastern	Oars manned!	true
vo_unit_texts_text_Land_Mounted_US_RO_Selection_Aspis_Companion_Cavalryatt_cult_roman	Aspis Companion Cavalry!	true
vo_unit_texts_text_Naval_UR_EA_Move_To_05att_cult_eastern	Oars ready!	true
vo_unit_texts_text_Land_UO_RO_Attack_Rome_01att_cult_roman	Victory for Rome!	true
vo_unit_texts_text_Land_UO_RO_Attack_Rome_02att_cult_roman	Glory to Rome!	true
vo_unit_texts_text_Land_UO_RO_Attack_Rome_03att_cult_roman	Rome is mother to us all!	true
vo_unit_texts_text_Land_UO_RO_Attack_Rome_04att_cult_roman	Mars aid us!	true
vo_unit_texts_text_Land_UO_RO_Attack_Rome_05att_cult_roman	Attack! For Rome!	true
vo_unit_texts_text_Naval_UO_EA_Stop_Turning_01att_cult_eastern	Halt the turn!	true
vo_unit_texts_text_Naval_UO_EA_Stop_Turning_03att_cult_eastern	Stop the turn!	true
vo_unit_texts_text_Land_UR_RO_Attack_Rome_01att_cult_roman	Victory to Rome!	true
vo_unit_texts_text_Land_UR_RO_Attack_Rome_02att_cult_roman	Glory to Rome!	true
vo_unit_texts_text_Land_UR_RO_Attack_Rome_03att_cult_roman	Mother Rome!	true
vo_unit_texts_text_Land_UR_RO_Attack_Rome_04att_cult_roman	Mars!	true
vo_unit_texts_text_Land_UR_RO_Attack_Rome_05att_cult_roman	Jupiter protect us!	true
vo_unit_texts_text_Naval_UO_EA_Stop_Turning_02att_cult_eastern	Cease turning!	true
vo_unit_texts_text_Naval_UO_EA_Stop_Turning_05att_cult_eastern	Stop turning, now!	true
vo_unit_texts_text_Naval_UO_EA_Stop_Turning_04att_cult_eastern	Halt turning!	true
vo_unit_texts_text_Land_Mounted_US_RO_Selection_Hellenic_Cataphractsatt_cult_roman	Hellenic Cataphracts!	true
vo_unit_texts_text_Land_US_BA_Selection_Short_01att_cult_barbarian	Orders?	true
vo_unit_texts_text_Land_US_BA_Selection_Short_02att_cult_barbarian	Warriors ready!	true
vo_unit_texts_text_Land_US_BA_Selection_Short_03att_cult_barbarian	Battle ready!	true
vo_unit_texts_text_Land_US_BA_Selection_Short_04att_cult_barbarian	Rahhh!	true
vo_unit_texts_text_Land_US_BA_Selection_Short_05att_cult_barbarian	Ready!	true
vo_unit_texts_text_Land_US_BA_Selection_Infantry_spearmen_generic_1att_cult_barbarian	Spears ready!	true
vo_unit_texts_text_Land_US_BA_Selection_Infantry_spearmen_generic_2att_cult_barbarian	You have our spears!	true
vo_unit_texts_text_Land_US_BA_Selection_Infantry_spearmen_generic_3att_cult_barbarian	Spearmen!	true
vo_unit_texts_text_Land_US_BA_Selection_Infantry_spearmen_generic_4att_cult_barbarian	Our spears are yours!	true
vo_unit_texts_text_Land_US_BA_Selection_Infantry_spearmen_generic_5att_cult_barbarian	Spearmen ready for battle!	true
vo_unit_texts_text_Land_Mounted_US_EA_Selection_Auxiliary_Sabaean_Cavalryatt_cult_eastern	Sabaean Cavalry!	true
vo_unit_texts_text_Land_US_RO_Selection_Silver_Shield_Swordsmenatt_cult_eastern	Silver Shield Swordsmen!	true
vo_unit_texts_text_Land_Mounted_UO_EA_Single_Click_Move_To_05att_cult_eastern	Follow me!	true
vo_unit_texts_text_Land_Mounted_UO_EA_Single_Click_Move_To_04att_cult_eastern	Riders, move out!	true
vo_unit_texts_text_Land_Mounted_UO_EA_Single_Click_Move_To_01att_cult_eastern	Riders, forward!	true
vo_unit_texts_text_Land_Mounted_UO_EA_Single_Click_Move_To_03att_cult_eastern	Ride out!	true
vo_unit_texts_text_Land_Mounted_UO_EA_Single_Click_Move_To_02att_cult_eastern	Riders, on me!	true
vo_unit_texts_text_Naval_UO_BA_Single_Click_Attack_03att_cult_eastern	For the tribe!	true
vo_unit_texts_text_Naval_UO_EA_Single_Click_Attack_04att_cult_eastern	Forward!	true
vo_unit_texts_text_Naval_UO_BA_Single_Click_Attack_02att_cult_eastern	Kill them!	true
vo_unit_texts_text_Naval_UO_EA_Single_Click_Attack_05att_cult_eastern	Advance!	true
vo_unit_texts_text_Naval_UO_BA_Single_Click_Attack_01att_cult_eastern	Destroy them!	true
vo_unit_texts_text_Naval_UO_EA_Single_Click_Attack_01att_cult_eastern	Attack!	true
vo_unit_texts_text_Naval_UO_BA_Single_Click_Attack_05att_cult_eastern	Slaughter them!	true
vo_unit_texts_text_Naval_UO_EA_Single_Click_Attack_02att_cult_eastern	Engage the enemy!	true
vo_unit_texts_text_Naval_UO_BA_Single_Click_Attack_04att_cult_eastern	Strike them down!	true
vo_unit_texts_text_Naval_UO_EA_Single_Click_Attack_03att_cult_eastern	Death to the enemy!	true
vo_unit_texts_text_Naval_UR_BA_Generic_Order_01att_cult_barbarian	Aye!	true
vo_unit_texts_text_Naval_UR_BA_Generic_Order_02att_cult_barbarian	As you say!	true
vo_unit_texts_text_Naval_UR_BA_Generic_Order_03att_cult_barbarian	Alright!	true
vo_unit_texts_text_Naval_UR_BA_Generic_Order_04att_cult_barbarian	Got yah!	true
vo_unit_texts_text_Naval_UR_BA_Generic_Order_05att_cult_barbarian	Understood!	true
vo_unit_texts_text_Land_Mounted_US_BA_Selection_Thracian_Royal_Cavalryatt_cult_barbarian	Thracian Royal Cavalry!	true
vo_unit_texts_text_Naval_US_RO_Selection_Scorpiosatt_cult_eastern	Scorpios ready!	true
vo_unit_texts_text_Land_UO_RO_Dismount_01att_cult_roman	Dismount!	true
vo_unit_texts_text_Land_UO_RO_Dismount_02att_cult_roman	Riders, dismount!	true
vo_unit_texts_text_Land_UO_RO_Dismount_03att_cult_roman	Dismount, now!	true
vo_unit_texts_text_Land_UO_RO_Dismount_04att_cult_roman	On your feet!	true
vo_unit_texts_text_Land_UO_RO_Dismount_05att_cult_roman	Men, dismount!	true
vo_unit_texts_text_Land_GO_BA_Lock_Formation_01att_cult_barbarian	Stay as you are!	true
vo_unit_texts_text_Land_GO_BA_Lock_Formation_02att_cult_barbarian	Stay where I put yah!	true
vo_unit_texts_text_Land_GO_BA_Lock_Formation_03att_cult_barbarian	Hold formation!	true
vo_unit_texts_text_Land_GO_BA_Lock_Formation_04att_cult_barbarian	Stay together!	true
vo_unit_texts_text_Land_GO_BA_Lock_Formation_05att_cult_barbarian	Don't break formation!	true
vo_unit_texts_text_Land_UO_EA_Single_Click_Ranged_Attack_05att_cult_eastern	Find your targets!	true
vo_unit_texts_text_Land_UO_EA_Single_Click_Ranged_Attack_04att_cult_eastern	Fire on the enemy!	true
vo_unit_texts_text_Land_UO_EA_Single_Click_Ranged_Attack_01att_cult_eastern	Fill the skies!	true
vo_unit_texts_text_Land_UO_EA_Single_Click_Ranged_Attack_03att_cult_eastern	Loose!	true
vo_unit_texts_text_Land_UO_EA_Single_Click_Ranged_Attack_02att_cult_eastern	Fire!	true
vo_unit_texts_text_Land_UO_RO_Melee_Button_off_01att_cult_roman	Form up!	true
vo_unit_texts_text_Land_UO_RO_Melee_Button_off_02att_cult_roman	Wait on my order!	true
vo_unit_texts_text_Land_UO_RO_Melee_Button_off_03att_cult_roman	Reform!	true
vo_unit_texts_text_Land_UO_RO_Melee_Button_off_04att_cult_roman	Stay on alert!	true
vo_unit_texts_text_Land_UO_RO_Melee_Button_off_05att_cult_roman	Await my order!	true
vo_unit_texts_text_Naval_US_RO_Selection_Artillery_Ship_01att_cult_roman	Artillery ships ready!	true
vo_unit_texts_text_Naval_US_RO_Selection_Artillery_Ship_02att_cult_roman	Artillery awaiting orders!	true
vo_unit_texts_text_Naval_US_RO_Selection_Artillery_Ship_03att_cult_roman	Artillery ships reporting!	true
vo_unit_texts_text_Naval_US_RO_Selection_Artillery_Ship_04att_cult_roman	Firepower ready!	true
vo_unit_texts_text_Naval_US_RO_Selection_Artillery_Ship_05att_cult_roman	Artillery at your command!	true
vo_unit_texts_text_Land_UO_EA_Single_Click_Attack_05att_cult_eastern	To arms!	true
vo_unit_texts_text_Land_UO_EA_Single_Click_Attack_04att_cult_eastern	Death to the enemy!	true
vo_unit_texts_text_Land_UO_EA_Single_Click_Attack_01att_cult_eastern	Attack!	true
vo_unit_texts_text_Land_UO_EA_Single_Click_Attack_03att_cult_eastern	Engage!	true
vo_unit_texts_text_Land_UO_EA_Single_Click_Attack_02att_cult_eastern	To victory!	true
vo_unit_texts_text_Land_UR_BA_Generic_Order_01att_cult_barbarian	Aye!	true
vo_unit_texts_text_Land_UR_BA_Generic_Order_02att_cult_barbarian	As you say!	true
vo_unit_texts_text_Land_UR_BA_Generic_Order_03att_cult_barbarian	Alright!	true
vo_unit_texts_text_Land_UR_BA_Generic_Order_04att_cult_barbarian	Got yah!	true
vo_unit_texts_text_Land_UR_BA_Generic_Order_05att_cult_barbarian	Understood!	true
vo_unit_texts_text_Land_SA_RO_Brace!_01att_cult_roman	Brace!	true
vo_unit_texts_text_Land_SA_RO_Brace!_02att_cult_roman	Prepare  for impact!	true
vo_unit_texts_text_Land_SA_RO_Brace!_03att_cult_roman	Brace yourselves!	true
vo_unit_texts_text_Land_UO_RO_Withdraw_01att_cult_roman	Withdraw!	true
vo_unit_texts_text_Land_UO_RO_Withdraw_02att_cult_roman	Pull back!	true
vo_unit_texts_text_Land_UO_RO_Withdraw_03att_cult_roman	Back! Back! Withdraw!	true
vo_unit_texts_text_Land_UO_RO_Withdraw_04att_cult_roman	On my order, Withdraw!	true
vo_unit_texts_text_Land_UO_RO_Withdraw_05att_cult_roman	Back men, back!	true
vo_unit_texts_text_Land_Mounted_US_BA_Selection_Sarmatian_Royal_Lancersatt_cult_barbarian	Sarmatian Royal Lancers!	true
vo_unit_texts_text_Land_UO_BA_Skirmish_Off_01att_cult_barbarian	Close up!	true
vo_unit_texts_text_Land_UO_BA_Skirmish_Off_02att_cult_barbarian	Back together!	true
vo_unit_texts_text_Land_UO_BA_Skirmish_Off_03att_cult_barbarian	Warriors, draw near!	true
vo_unit_texts_text_Land_UO_BA_Skirmish_Off_04att_cult_barbarian	Together lads!	true
vo_unit_texts_text_Land_UO_BA_Skirmish_Off_05att_cult_barbarian	Come together!	true
vo_unit_texts_text_Land_SA_RO_Stand_and_Fight_01att_cult_roman	Stand and fight!	true
vo_unit_texts_text_Land_SA_RO_Stand_and_Fight_02att_cult_roman	Hold your ground!	true
vo_unit_texts_text_Land_SA_RO_Stand_and_Fight_03att_cult_roman	Death is only the beginning!	true
vo_unit_texts_text_Land_US_EA_Selection_Parthia_05att_cult_eastern	For Parthia!	true
vo_unit_texts_text_Land_US_EA_Selection_Parthia_04att_cult_eastern	Ahura Mazdah protect us!	true
vo_unit_texts_text_Land_US_EA_Selection_Parthia_03att_cult_eastern	What is the King's bidding?	true
vo_unit_texts_text_Land_US_EA_Selection_Parthia_02att_cult_eastern	We serve the King!	true
vo_unit_texts_text_Land_US_EA_Selection_Parthia_01att_cult_eastern	For the King!	true
vo_unit_texts_text_Land_US_BA_Selection_Thracian_Noblesatt_cult_barbarian	Thracian Nobles!	true
vo_unit_texts_text_Land_US_RO_Selection_Cavalry_missile_generic_1att_cult_eastern	Missile cavalry ready!	true
vo_unit_texts_text_Land_US_RO_Selection_Cavalry_missile_generic_2att_cult_eastern	Swift and accurate!	true
vo_unit_texts_text_Land_US_RO_Selection_Cavalry_missile_generic_3att_cult_eastern	Missile armed riders!	true
vo_unit_texts_text_Land_US_RO_Selection_Cavalry_missile_generic_4att_cult_eastern	Cavalry! Missiles ready!	true
vo_unit_texts_text_Land_US_RO_Selection_Cavalry_missile_generic_5att_cult_eastern	Missile cavalry at your command!	true
vo_unit_texts_text_Land_Mounted_UO_EA_Double_Click_Move_To_04att_cult_eastern	Riders, advance!	true
vo_unit_texts_text_Land_Mounted_UO_EA_Double_Click_Move_To_05att_cult_eastern	Advance at speed!	true
vo_unit_texts_text_Land_Mounted_UO_EA_Double_Click_Move_To_02att_cult_eastern	Forward!	true
vo_unit_texts_text_Land_Mounted_UO_EA_Double_Click_Move_To_03att_cult_eastern	Quickly now!	true
vo_unit_texts_text_Land_Mounted_UO_EA_Double_Click_Move_To_01att_cult_eastern	Riders, at the double!	true
vo_unit_texts_text_Land_SA_BA_Use_the_Whip_01att_cult_barbarian	Get moving!	true
vo_unit_texts_text_Land_SA_BA_Use_the_Whip_02att_cult_barbarian	Move, curse yah!	true
vo_unit_texts_text_Land_SA_BA_Use_the_Whip_03att_cult_barbarian	Get a shift on!	true
vo_unit_texts_text_Land_Mounted_US_BA_Selection_Heroic_Ridersatt_cult_barbarian	Heroic Riders!	true
vo_unit_texts_text_Land_UO_RO_Guard_On_01att_cult_roman	Guard!	true
vo_unit_texts_text_Land_UO_RO_Guard_On_02att_cult_roman	Hold position!	true
vo_unit_texts_text_Land_UO_RO_Guard_On_03att_cult_roman	Defensive positions!	true
vo_unit_texts_text_Land_UO_RO_Guard_On_04att_cult_roman	On watch!	true
vo_unit_texts_text_Land_UO_RO_Guard_On_05att_cult_roman	Hold!	true
vo_unit_texts_text_Land_UO_BA_Generic_Order_Germania_01att_cult_barbarian	For Germania!	true
vo_unit_texts_text_Land_UO_BA_Generic_Order_Germania_02att_cult_barbarian	We serve Germania!	true
vo_unit_texts_text_Land_UO_BA_Generic_Order_Germania_03att_cult_barbarian	Woden watches over us!	true
vo_unit_texts_text_Land_UO_BA_Generic_Order_Germania_04att_cult_barbarian	Proud to act for Germania!	true
vo_unit_texts_text_Land_UO_BA_Generic_Order_Germania_05att_cult_barbarian	Servants of Woden!	true
vo_unit_texts_text_Land_UR_BA_Generic_Order_Germania_01att_cult_barbarian	For Germania!	true
vo_unit_texts_text_Land_UR_BA_Generic_Order_Germania_02att_cult_barbarian	For our honoured home!	true
vo_unit_texts_text_Land_UR_BA_Generic_Order_Germania_03att_cult_barbarian	Woden hear us!	true
vo_unit_texts_text_Land_UR_BA_Generic_Order_Germania_04att_cult_barbarian	Proud soons of Germania!	true
vo_unit_texts_text_Land_UR_BA_Generic_Order_Germania_05att_cult_barbarian	Woden!	true
vo_unit_texts_text_Land_US_RO_Selection_Cimmerian_Heavy_Archersatt_cult_eastern	Cimmerian Heavy Archers!	true
vo_unit_texts_text_Land_UO_EA_Skirmish_On_05att_cult_eastern	Open the lines!	true
vo_unit_texts_text_Land_UO_EA_Skirmish_On_04att_cult_eastern	Double the ranks!	true
vo_unit_texts_text_Land_UO_EA_Skirmish_On_03att_cult_eastern	Skirmish lines!	true
vo_unit_texts_text_Land_UO_EA_Skirmish_On_02att_cult_eastern	Open the ranks!	true
vo_unit_texts_text_Land_UO_EA_Skirmish_On_01att_cult_eastern	Skirmish!	true
vo_unit_texts_text_Land_Mounted_UO_RO_Dismount_01att_cult_roman	Dismount!	true
vo_unit_texts_text_Land_Mounted_UO_RO_Dismount_02att_cult_roman	Riders, dismount!	true
vo_unit_texts_text_Land_Mounted_UO_RO_Dismount_03att_cult_roman	Dismount, now!	true
vo_unit_texts_text_Land_Mounted_UO_RO_Dismount_04att_cult_roman	On your feet!	true
vo_unit_texts_text_Land_Mounted_UO_RO_Dismount_05att_cult_roman	Men, dismount!	true
vo_unit_texts_text_Land_US_BA_Selection_Lusitani_Noblesatt_cult_barbarian	Lusitani Nobles!	true
vo_unit_texts_text_Land_UO_EA_Skirmish_Off_01att_cult_eastern	Close up!	true
vo_unit_texts_text_Land_UO_EA_Skirmish_Off_03att_cult_eastern	Close ranks!	true
vo_unit_texts_text_Land_UO_EA_Skirmish_Off_02att_cult_eastern	Close the ranks!	true
vo_unit_texts_text_Land_UO_EA_Skirmish_Off_05att_cult_eastern	Assemble!	true
vo_unit_texts_text_Land_UO_EA_Skirmish_Off_04att_cult_eastern	Fall in!	true
vo_unit_texts_text_Land_US_EA_Selection_Carthage_05att_cult_eastern	The Gods are with us!	true
vo_unit_texts_text_Land_US_EA_Selection_Carthage_04att_cult_eastern	Loyal sons of Carthage!	true
vo_unit_texts_text_Land_US_EA_Selection_Carthage_03att_cult_eastern	Ba'al Hammon gives us strength!	true
vo_unit_texts_text_Land_US_EA_Selection_Carthage_02att_cult_eastern	Ba'al Hammon guards us!	true
vo_unit_texts_text_Land_US_EA_Selection_Carthage_01att_cult_eastern	Ba'al Hammon has blessed us!	true
vo_unit_texts_text_Naval_US_RO_Selection_Fire_Potsatt_cult_roman	Fire pots ready!	true
vo_unit_texts_text_Land_UO_BA_Double_Click_Attack_01att_cult_barbarian	Charge!	true
vo_unit_texts_text_Land_UO_BA_Double_Click_Attack_02att_cult_barbarian	Yahhhh!	true
vo_unit_texts_text_Land_UO_BA_Double_Click_Attack_03att_cult_barbarian	Kill! Kill! Kill!	true
vo_unit_texts_text_Land_UO_BA_Double_Click_Attack_04att_cult_barbarian	Ahhh!	true
vo_unit_texts_text_Land_UO_BA_Double_Click_Attack_05att_cult_barbarian	Rahhhh!	true
vo_unit_texts_text_Land_US_BA_Selection_Heroic_Noblesatt_cult_barbarian	Heroic Nobles!	true
vo_unit_texts_text_Land_UO_BA_Single_Click_Melee_Attack_Heightened_01att_cult_barbarian	Hack them down!	true
vo_unit_texts_text_Land_UO_BA_Single_Click_Melee_Attack_Heightened_02att_cult_barbarian	Cut them down!	true
vo_unit_texts_text_Land_UO_BA_Single_Click_Melee_Attack_Heightened_03att_cult_barbarian	Take their heads!	true
vo_unit_texts_text_Land_UO_BA_Single_Click_Melee_Attack_Heightened_04att_cult_barbarian	Make them bleed!	true
vo_unit_texts_text_Land_UO_BA_Single_Click_Melee_Attack_Heightened_05att_cult_barbarian	Bleed them!	true
vo_unit_texts_text_Land_GO_RO_Group_Disbanded_01att_cult_roman	Battle group disbanded!	true
vo_unit_texts_text_Land_GO_RO_Group_Disbanded_02att_cult_roman	Breaking battle group!	true
vo_unit_texts_text_Land_GO_RO_Group_Disbanded_03att_cult_roman	Battle group disbanding!	true
vo_unit_texts_text_Land_GO_RO_Group_Disbanded_04att_cult_roman	Group disbanded!	true
vo_unit_texts_text_Land_GO_RO_Group_Disbanded_05att_cult_roman	Disbanding battle group!	true
vo_unit_texts_text_Land_SA_BA_Brace_Group_01att_cult_barbarian	Hold lads, hold!	true
vo_unit_texts_text_Land_SA_BA_Brace_Group_02att_cult_barbarian	Brace!	true
vo_unit_texts_text_Land_SA_BA_Brace_Group_03att_cult_barbarian	Get ready, get ready!	true
vo_unit_texts_text_Land_UO_RO_Hold_Position_on_01att_cult_roman	Hold position!	true
vo_unit_texts_text_Land_UO_RO_Hold_Position_on_02att_cult_roman	Hold steady!	true
vo_unit_texts_text_Land_UO_RO_Hold_Position_on_03att_cult_roman	Hold men, hold!	true
vo_unit_texts_text_Land_UO_RO_Hold_Position_on_04att_cult_roman	Keep this position!	true
vo_unit_texts_text_Land_UO_RO_Hold_Position_on_05att_cult_roman	Hold here, men!	true
vo_unit_texts_text_Land_UO_BA_Halt_01att_cult_barbarian	Halt!	true
vo_unit_texts_text_Land_UO_BA_Halt_02att_cult_barbarian	Stop!	true
vo_unit_texts_text_Land_UO_BA_Halt_03att_cult_barbarian	Wait here!	true
vo_unit_texts_text_Land_UO_BA_Halt_04att_cult_barbarian	Stop now!	true
vo_unit_texts_text_Land_UO_BA_Halt_05att_cult_barbarian	Warriors, stop!	true
vo_unit_texts_text_Land_UO_BA_Skirmish_Centreatt_cult_barbarian	Centre skirmish! 	true
vo_unit_texts_text_Naval_US_RO_Selection_Corvusatt_cult_eastern	Corvus ready!	true
vo_unit_texts_text_Naval_UO_RO_Double_Click_Move_To_Heightened_01att_cult_roman	Row!	true
vo_unit_texts_text_Naval_UO_RO_Double_Click_Move_To_Heightened_02att_cult_roman	Set a course!	true
vo_unit_texts_text_Naval_UO_RO_Double_Click_Move_To_Heightened_03att_cult_roman	Move out, double time!	true
vo_unit_texts_text_Naval_UO_RO_Double_Click_Move_To_Heightened_04att_cult_roman	Get to the oars!	true
vo_unit_texts_text_Naval_UO_RO_Double_Click_Move_To_Heightened_05att_cult_roman	Get moving!	true
vo_unit_texts_text_Land_UO_RO_Double_Click_Melee_Attack_01att_cult_roman	Attack!	true
vo_unit_texts_text_Land_UO_RO_Double_Click_Melee_Attack_02att_cult_roman	Engage the enemy!	true
vo_unit_texts_text_Land_UO_RO_Double_Click_Melee_Attack_03att_cult_roman	Hack them down!	true
vo_unit_texts_text_Land_UO_RO_Double_Click_Melee_Attack_04att_cult_roman	Break their lines!	true
vo_unit_texts_text_Land_UO_RO_Double_Click_Melee_Attack_05att_cult_roman	Attack at the double!	true
vo_unit_texts_text_Land_Mounted_UO_RO_Double_Click_Move_To_Heightened_01att_cult_roman	Riders, at the double!	true
vo_unit_texts_text_Land_Mounted_UO_RO_Double_Click_Move_To_Heightened_02att_cult_roman	Forward!	true
vo_unit_texts_text_Land_Mounted_UO_RO_Double_Click_Move_To_Heightened_03att_cult_roman	Quickly now!	true
vo_unit_texts_text_Land_Mounted_UO_RO_Double_Click_Move_To_Heightened_04att_cult_roman	Riders, advance!	true
vo_unit_texts_text_Land_Mounted_UO_RO_Double_Click_Move_To_Heightened_05att_cult_roman	Advance at speed!	true
vo_unit_texts_text_Naval_US_EA_Selection_generic_04att_cult_eastern	Our oars are set!	true
vo_unit_texts_text_Naval_US_EA_Selection_generic_05att_cult_eastern	Your orders, my lord?	true
vo_unit_texts_text_Naval_US_EA_Selection_generic_01att_cult_eastern	We are at your command!	true
vo_unit_texts_text_Naval_US_EA_Selection_generic_02att_cult_eastern	On your orders!	true
vo_unit_texts_text_Naval_US_EA_Selection_generic_03att_cult_eastern	We await your word!	true
vo_unit_texts_text_Land_UO_BA_Single_Click_Attack_01att_cult_barbarian	Attack!	true
vo_unit_texts_text_Land_UO_BA_Single_Click_Attack_02att_cult_barbarian	Kill 'em!	true
vo_unit_texts_text_Land_UO_BA_Single_Click_Attack_03att_cult_barbarian	Wipe them out!	true
vo_unit_texts_text_Land_UO_BA_Single_Click_Attack_04att_cult_barbarian	Deahahh geetta!	true
vo_unit_texts_text_Land_UO_BA_Single_Click_Attack_05att_cult_barbarian	Roar!	true
vo_unit_texts_text_Naval_UR_RO_Move_To_01att_cult_roman	Moving out!	true
vo_unit_texts_text_Naval_UR_RO_Move_To_02att_cult_roman	Heave!	true
vo_unit_texts_text_Naval_UR_RO_Move_To_03att_cult_roman	Oars, aye!	true
vo_unit_texts_text_Naval_UR_RO_Move_To_04att_cult_roman	Setting sail!	true
vo_unit_texts_text_Naval_UR_RO_Move_To_05att_cult_roman	Oars ready!	true
vo_unit_texts_text_Land_UO_BA_Double_Click_Attack_Heightened_01att_cult_barbarian	Charge!	true
vo_unit_texts_text_Land_UO_BA_Double_Click_Attack_Heightened_02att_cult_barbarian	Yahhhh!	true
vo_unit_texts_text_Land_UO_BA_Double_Click_Attack_Heightened_03att_cult_barbarian	Kill! Kill! Kill!	true
vo_unit_texts_text_Land_UO_BA_Double_Click_Attack_Heightened_04att_cult_barbarian	Ahhh!	true
vo_unit_texts_text_Land_UO_BA_Double_Click_Attack_Heightened_05att_cult_barbarian	Rahhhh!	true
vo_unit_texts_text_Land_Mounted_US_BA_Selection_Steppe_Noble_Lancersatt_cult_barbarian	Steppe Noble Lancers!	true
vo_unit_texts_text_Land_US_EA_Selection_Cavalry_missile_generic_4att_cult_eastern	Cavalry! Missiles ready!	true
vo_unit_texts_text_Land_US_EA_Selection_Cavalry_missile_generic_5att_cult_eastern	Missile cavalry at your command!	true
vo_unit_texts_text_Land_US_EA_Selection_Cavalry_missile_generic_2att_cult_eastern	Swift and accurate!	true
vo_unit_texts_text_Land_US_EA_Selection_Cavalry_missile_generic_3att_cult_eastern	Missile armed riders!	true
vo_unit_texts_text_Land_US_EA_Selection_Cavalry_missile_generic_1att_cult_eastern	Missile cavalry!	true
vo_unit_texts_text_Land_UO_EA_Generic_Order_Pontus_01att_cult_eastern	For the King!	true
vo_unit_texts_text_Land_UR_EA_Generic_Order_Pontus_01att_cult_eastern	For the King!	true
vo_unit_texts_text_Land_UO_EA_Generic_Order_Pontus_03att_cult_eastern	Gods honour us!	true
vo_unit_texts_text_Land_UR_EA_Generic_Order_Pontus_03att_cult_eastern	For the gods!	true
vo_unit_texts_text_Land_UO_EA_Generic_Order_Pontus_02att_cult_eastern	Proud servants of the King!	true
vo_unit_texts_text_Land_UR_EA_Generic_Order_Pontus_02att_cult_eastern	For Pontus!	true
vo_unit_texts_text_Land_UO_EA_Generic_Order_Pontus_05att_cult_eastern	For Pontus!	true
vo_unit_texts_text_Land_UR_EA_Generic_Order_Pontus_05att_cult_eastern	The King!	true
vo_unit_texts_text_Land_UO_EA_Generic_Order_Pontus_04att_cult_eastern	It is the King's will.	true
vo_unit_texts_text_Land_UR_EA_Generic_Order_Pontus_04att_cult_eastern	By Zeus!	true
vo_unit_texts_text_Naval_US_RO_Selection_Harpaxatt_cult_eastern	Harpax at the ready!	true
vo_unit_texts_text_Land_US_EA_Selection_Infantry_melee_generic_5att_cult_eastern	Ready to march!	true
vo_unit_texts_text_Land_US_EA_Selection_Infantry_melee_generic_4att_cult_eastern	Melee infantry at the ready!	true
vo_unit_texts_text_Land_US_EA_Selection_Infantry_melee_generic_1att_cult_eastern	Melee infantry!	true
vo_unit_texts_text_Land_US_EA_Selection_Infantry_melee_generic_3att_cult_eastern	Infantry at your command!	true
vo_unit_texts_text_Land_US_EA_Selection_Infantry_melee_generic_2att_cult_eastern	Melee infantry ready!	true
vo_unit_texts_text_Land_US_RO_Selection_Infantry_melee_generic_2att_cult_eastern	Melee infantry at your command!	true
vo_unit_texts_text_Land_US_RO_Selection_Infantry_melee_generic_3att_cult_eastern	Melee troops awaiting orders!	true
vo_unit_texts_text_Land_US_RO_Selection_Infantry_melee_generic_1att_cult_eastern	Melee infantry ready!	true
vo_unit_texts_text_Land_US_RO_Selection_Infantry_melee_generic_4att_cult_eastern	Melee infantry!	true
vo_unit_texts_text_Land_US_RO_Selection_Infantry_melee_generic_5att_cult_eastern	Melee troops!	true
vo_unit_texts_text_Land_UO_RO_Generic_Order_Rome_01att_cult_roman	In the name of Rome!	true
vo_unit_texts_text_Land_UO_RO_Generic_Order_Rome_02att_cult_roman	For Rome!	true
vo_unit_texts_text_Land_UO_RO_Generic_Order_Rome_03att_cult_roman	Happy to serve Rome!	true
vo_unit_texts_text_Land_UO_RO_Generic_Order_Rome_04att_cult_roman	In service to Rome!	true
vo_unit_texts_text_Land_UO_RO_Generic_Order_Rome_05att_cult_roman	For the gods!	true
vo_unit_texts_text_Land_UR_RO_Generic_Order_Rome_01att_cult_roman	In Rome's name!	true
vo_unit_texts_text_Land_UR_RO_Generic_Order_Rome_02att_cult_roman	For Rome!	true
vo_unit_texts_text_Land_UR_RO_Generic_Order_Rome_03att_cult_roman	Rome!	true
vo_unit_texts_text_Land_UR_RO_Generic_Order_Rome_04att_cult_roman	Yes Imperator!	true
vo_unit_texts_text_Land_UR_RO_Generic_Order_Rome_05att_cult_roman	For the gods!	true
vo_unit_texts_text_Land_UO_RO_Move_Ram_01att_cult_roman	Man the battering ram!	true
vo_unit_texts_text_Land_UO_RO_Move_Ram_02att_cult_roman	To the ram!	true
vo_unit_texts_text_Land_UO_RO_Move_Ram_03att_cult_roman	Get that ram moving!	true
vo_unit_texts_text_Land_UO_RO_Move_Ram_04att_cult_roman	Take positions!	true
vo_unit_texts_text_Land_UO_RO_Move_Ram_05att_cult_roman	Move the ram!	true
vo_unit_texts_text_Land_US_RO_Selection_Thureos_Spearsatt_cult_eastern	Thureos Spears!	true
vo_unit_texts_text_Land_UO_EA_Double_Click_Attack_03att_cult_eastern	For glory!	true
vo_unit_texts_text_Land_UO_EA_Double_Click_Attack_02att_cult_eastern	For honour!	true
vo_unit_texts_text_Land_UO_EA_Double_Click_Attack_01att_cult_eastern	Charge!	true
vo_unit_texts_text_Land_UO_EA_Double_Click_Attack_05att_cult_eastern	Engage!	true
vo_unit_texts_text_Land_UO_EA_Double_Click_Attack_04att_cult_eastern	Forward!	true
vo_unit_texts_text_Land_SA_EA_Rally_and_Inspire_01att_cult_eastern	Remember! We are heroes!	true
vo_unit_texts_text_Land_SA_EA_Rally_and_Inspire_03att_cult_eastern	On to victory!	true
vo_unit_texts_text_Land_SA_EA_Rally_and_Inspire_02att_cult_eastern	Duty and honour!	true
vo_unit_texts_text_Land_Mounted_US_EA_Selection_Royal_Cataphractsatt_cult_eastern	Royal Cataphracts!	true
vo_unit_texts_text_Naval_UO_RO_Turn_Left_01att_cult_roman	To the left!	true
vo_unit_texts_text_Naval_UO_RO_Turn_Left_02att_cult_roman	Turn left!	true
vo_unit_texts_text_Naval_UO_RO_Turn_Left_03att_cult_roman	Left!	true
vo_unit_texts_text_Naval_UO_RO_Turn_Left_04att_cult_roman	To port!	true
vo_unit_texts_text_Naval_UO_RO_Turn_Left_05att_cult_roman	Port!	true
vo_unit_texts_text_Land_Mounted_UO_RO_Single_Click_Move_To_Heightened_01att_cult_roman	Riders, forward!	true
vo_unit_texts_text_Land_Mounted_UO_RO_Single_Click_Move_To_Heightened_02att_cult_roman	Riders, on me!	true
vo_unit_texts_text_Land_Mounted_UO_RO_Single_Click_Move_To_Heightened_03att_cult_roman	Ride out!	true
vo_unit_texts_text_Land_Mounted_UO_RO_Single_Click_Move_To_Heightened_04att_cult_roman	Riders, move out!	true
vo_unit_texts_text_Land_Mounted_UO_RO_Single_Click_Move_To_Heightened_05att_cult_roman	Follow me!	true
vo_unit_texts_text_Land_SA_EA_Break-Off_01att_cult_eastern	Pull back!	true
vo_unit_texts_text_Land_SA_EA_Break-Off_02att_cult_eastern	Disengage!	true
vo_unit_texts_text_Land_SA_EA_Break-Off_03att_cult_eastern	Break from the enemy!	true
vo_unit_texts_text_Land_SA_RO_Get_Into_Formation_01att_cult_roman	Formation! Move!	true
vo_unit_texts_text_Land_SA_RO_Get_Into_Formation_02att_cult_roman	Into formation!	true
vo_unit_texts_text_Land_SA_RO_Get_Into_Formation_03att_cult_roman	Organise yourselves!	true
vo_unit_texts_text_Naval_UO_RO_Single_Click_Move_To_Heightened_01att_cult_roman	Moving out!	true
vo_unit_texts_text_Naval_UO_RO_Single_Click_Move_To_Heightened_02att_cult_roman	To the oars!	true
vo_unit_texts_text_Naval_UO_RO_Single_Click_Move_To_Heightened_03att_cult_roman	Set oars!	true
vo_unit_texts_text_Naval_UO_RO_Single_Click_Move_To_Heightened_04att_cult_roman	Move out!	true
vo_unit_texts_text_Naval_UO_RO_Single_Click_Move_To_Heightened_05att_cult_roman	Give way!	true
vo_unit_texts_text_Naval_UO_BA_Double_Click_Attack_05att_cult_eastern	Rahhhh!	true
vo_unit_texts_text_Naval_UO_EA_Double_Click_Attack_02att_cult_eastern	Smash them!	true
vo_unit_texts_text_Naval_UO_BA_Double_Click_Attack_04att_cult_eastern	Attack!	true
vo_unit_texts_text_Naval_UO_EA_Double_Click_Attack_03att_cult_eastern	Engage!	true
vo_unit_texts_text_Naval_UO_EA_Double_Click_Attack_01att_cult_eastern	Destroy them!	true
vo_unit_texts_text_Naval_UO_BA_Double_Click_Attack_01att_cult_eastern	At them!	true
vo_unit_texts_text_Naval_UO_BA_Double_Click_Attack_03att_cult_eastern	End them!	true
vo_unit_texts_text_Naval_UO_EA_Double_Click_Attack_04att_cult_eastern	For glory!	true
vo_unit_texts_text_Naval_UO_BA_Double_Click_Attack_02att_cult_eastern	Break them!	true
vo_unit_texts_text_Naval_UO_EA_Double_Click_Attack_05att_cult_eastern	To victory!	true
vo_unit_texts_text_Land_US_RO_Selection_Evocati_Cohortatt_cult_eastern	Evocati!	true
vo_unit_texts_text_Land_US_BA_Selection_Noble_Spearsatt_cult_barbarian	Noble Spears!	true
vo_unit_texts_text_Land_UO_EA_Guard_Off_05att_cult_eastern	At ease, men!	true
vo_unit_texts_text_Land_UO_EA_Guard_Off_04att_cult_eastern	Stand on guard!	true
vo_unit_texts_text_Land_UO_EA_Guard_Off_01att_cult_eastern	Stand down!	true
vo_unit_texts_text_Land_UO_EA_Guard_Off_03att_cult_eastern	Stand down, men!	true
vo_unit_texts_text_Land_UO_EA_Guard_Off_02att_cult_eastern	At ease!	true
vo_unit_texts_text_Land_SA_EA_Raise_Banner_01att_cult_eastern	Raise the banner!	true
vo_unit_texts_text_Land_SA_EA_Raise_Banner_03att_cult_eastern	Rally to the banners!	true
vo_unit_texts_text_Land_SA_EA_Raise_Banner_02att_cult_eastern	To the banners!	true
vo_unit_texts_text_Naval_UO_BA_Turn_Left_04att_cult_eastern	To port!	true
vo_unit_texts_text_Naval_UO_EA_Turn_Left_04att_cult_eastern	To port!	true
vo_unit_texts_text_Naval_UO_BA_Turn_Left_05att_cult_eastern	Port!	true
vo_unit_texts_text_Naval_UO_EA_Turn_Left_05att_cult_eastern	Port!	true
vo_unit_texts_text_Naval_UO_BA_Turn_Left_02att_cult_eastern	Turn left!	true
vo_unit_texts_text_Naval_UO_EA_Turn_Left_02att_cult_eastern	Turn left!	true
vo_unit_texts_text_Naval_UO_BA_Turn_Left_03att_cult_eastern	Left!	true
vo_unit_texts_text_Naval_UO_EA_Turn_Left_03att_cult_eastern	Left!	true
vo_unit_texts_text_Naval_UO_BA_Turn_Left_01att_cult_eastern	To the left!	true
vo_unit_texts_text_Naval_UO_EA_Turn_Left_01att_cult_eastern	To the left!	true
vo_unit_texts_text_Land_UO_RO_Loose_Formation_01att_cult_roman	Loose formation!	true
vo_unit_texts_text_Land_UO_RO_Loose_Formation_02att_cult_roman	Spread out!	true
vo_unit_texts_text_Land_UO_RO_Loose_Formation_03att_cult_roman	Loosen the ranks!	true
vo_unit_texts_text_Land_UO_RO_Loose_Formation_04att_cult_roman	Form loose formation!	true
vo_unit_texts_text_Land_UO_RO_Loose_Formation_05att_cult_roman	Into loose formation, now!	true
vo_unit_texts_text_Land_SA_BA_Raise_Banner_01att_cult_barbarian	Raise the banners!	true
vo_unit_texts_text_Land_SA_BA_Raise_Banner_02att_cult_barbarian	Hold 'em high!	true
vo_unit_texts_text_Land_SA_BA_Raise_Banner_03att_cult_barbarian	Get the banners up!	true
vo_unit_texts_text_Land_UO_RO_Single_Click_Melee_Attack_01att_cult_roman	Hack them down!	true
vo_unit_texts_text_Land_UO_RO_Single_Click_Melee_Attack_02att_cult_roman	Cut them down!	true
vo_unit_texts_text_Land_UO_RO_Single_Click_Melee_Attack_03att_cult_roman	To arms!	true
vo_unit_texts_text_Land_UO_RO_Single_Click_Melee_Attack_04att_cult_roman	Break the lines!	true
vo_unit_texts_text_Land_UO_RO_Single_Click_Melee_Attack_05att_cult_roman	Attack their position!	true
vo_unit_texts_text_Land_UO_RO_Hold_Position_off_01att_cult_roman	Ready, men!	true
vo_unit_texts_text_Land_UO_RO_Hold_Position_off_02att_cult_roman	Prepare to move out!	true
vo_unit_texts_text_Land_UO_RO_Hold_Position_off_03att_cult_roman	Wait my order!	true
vo_unit_texts_text_Land_UO_RO_Hold_Position_off_04att_cult_roman	Positions!	true
vo_unit_texts_text_Land_UO_RO_Hold_Position_off_05att_cult_roman	Ready yourselves, men!	true
vo_unit_texts_text_Land_UO_EA_Generic_Order_Egypt_03att_cult_eastern	Servants of mighty Pharaoh!	true
vo_unit_texts_text_Land_UR_EA_Generic_Order_Egypt_03att_cult_eastern	Ever in service!	true
vo_unit_texts_text_Land_UO_EA_Generic_Order_Egypt_02att_cult_eastern	As you say, my lord!	true
vo_unit_texts_text_Land_UR_EA_Generic_Order_Egypt_02att_cult_eastern	Proud to serve!	true
vo_unit_texts_text_Land_UO_EA_Generic_Order_Egypt_01att_cult_eastern	For Pharaoh the divine!	true
vo_unit_texts_text_Land_UR_EA_Generic_Order_Egypt_01att_cult_eastern	For the Pharaoh!	true
vo_unit_texts_text_Land_UO_EA_Generic_Order_Egypt_05att_cult_eastern	Sons of the Nile!	true
vo_unit_texts_text_Land_UR_EA_Generic_Order_Egypt_05att_cult_eastern	For Egypt!	true
vo_unit_texts_text_Land_UO_EA_Generic_Order_Egypt_04att_cult_eastern	For Egypt!	true
vo_unit_texts_text_Land_UR_EA_Generic_Order_Egypt_04att_cult_eastern	Proud sons of Egypt!	true
vo_unit_texts_text_Land_UO_RO_Skirmish_Leftatt_cult_roman	Skirmish left! 	true
vo_unit_texts_text_Land_US_EA_Selection_Numidian_Noble_Infantryatt_cult_eastern	Numidian Noble Infantry!	true
vo_unit_texts_text_Land_SA_BA_Taunt_Group_01att_cult_barbarian	Your weakness sickens us!	true
vo_unit_texts_text_Land_SA_BA_Taunt_Group_02att_cult_barbarian	Our children fight better than you!	true
vo_unit_texts_text_Land_SA_BA_Taunt_Group_03att_cult_barbarian	We do not fear you!	true
vo_unit_texts_text_Land_US_RO_Selection_Foot_Companionsatt_cult_eastern	Foot Companions!	true
vo_unit_texts_text_Land_UO_RO_Single_Click_Ranged_Attack_01att_cult_roman	Loose!	true
vo_unit_texts_text_Land_UO_RO_Single_Click_Ranged_Attack_02att_cult_roman	Fire!	true
vo_unit_texts_text_Land_UO_RO_Single_Click_Ranged_Attack_03att_cult_roman	Now!	true
vo_unit_texts_text_Land_UO_RO_Single_Click_Ranged_Attack_04att_cult_roman	Fire on the enemy!	true
vo_unit_texts_text_Land_UO_RO_Single_Click_Ranged_Attack_05att_cult_roman	Take aim!	true
vo_unit_texts_text_Land_US_RO_Selection_Royal_Thorax_Swordsmenatt_cult_eastern	Royal Thorax Swordsmen!	true
vo_unit_texts_text_Land_US_RO_Selection_Macedon_01att_cult_eastern	Warriors of Macedon!	true
vo_unit_texts_text_Land_US_RO_Selection_Macedon_03att_cult_eastern	Hades can wait!	true
vo_unit_texts_text_Land_US_RO_Selection_Macedon_02att_cult_eastern	Macedonians ready!	true
vo_unit_texts_text_Land_US_RO_Selection_Macedon_05att_cult_eastern	Sons of Ares!	true
vo_unit_texts_text_Land_US_RO_Selection_Macedon_04att_cult_eastern	Proud sons of Macedon!	true
vo_unit_texts_text_Land_UO_BA_Attack_Gaul_01att_cult_barbarian	Victory for Gaul!	true
vo_unit_texts_text_Land_UO_BA_Attack_Gaul_02att_cult_barbarian	By Toutatis!	true
vo_unit_texts_text_Land_UO_BA_Attack_Gaul_03att_cult_barbarian	What are we brothers?!	true
vo_unit_texts_text_Land_UO_BA_Attack_Gaul_04att_cult_barbarian	What do we say?!	true
vo_unit_texts_text_Land_UO_BA_Attack_Gaul_05att_cult_barbarian	Gaul!	true
vo_unit_texts_text_Land_UR_BA_Attack_Gaul_01att_cult_barbarian	Victory to Gaul!	true
vo_unit_texts_text_Land_UR_BA_Attack_Gaul_02att_cult_barbarian	By Toutatis!	true
vo_unit_texts_text_Land_UR_BA_Attack_Gaul_03att_cult_barbarian	We are mighty boars!	true
vo_unit_texts_text_Land_UR_BA_Attack_Gaul_04att_cult_barbarian	Not today Ogmois!	true
vo_unit_texts_text_Land_UR_BA_Attack_Gaul_05att_cult_barbarian	Gaul!	true
vo_unit_texts_text_Land_US_BA_Selection_Spear_Noblesatt_cult_barbarian	Spear Nobles!	true
vo_unit_texts_text_Naval_US_RO_Selection_Transport_Ship_04att_cult_eastern	Transports!	true
vo_unit_texts_text_Naval_US_RO_Selection_Transport_Ship_05att_cult_eastern	Transports ready for orders!	true
vo_unit_texts_text_Naval_US_RO_Selection_Transport_Ship_01att_cult_eastern	Transport ships!	true
vo_unit_texts_text_Naval_US_RO_Selection_Transport_Ship_02att_cult_eastern	Transports ready and waiting!	true
vo_unit_texts_text_Naval_US_RO_Selection_Transport_Ship_03att_cult_eastern	Transport ships at your command!	true
vo_unit_texts_text_Land_SA_BA_Druidic_Chant_01att_cult_barbarian	Mighty oaks! Hear my words and grant us strength.	true
vo_unit_texts_text_Land_SA_BA_Druidic_Chant_02att_cult_barbarian	Mother, maiden, crone, mother, maiden, crone	true
vo_unit_texts_text_Land_SA_BA_Druidic_Chant_03att_cult_barbarian	Gods of the earth and sky bless our warriors!	true
vo_unit_texts_text_Land_SA_BA_Inspire_Group_01att_cult_barbarian	Fight, or I'll kill yah!	true
vo_unit_texts_text_Land_SA_BA_Inspire_Group_02att_cult_barbarian	Are you men or Romans?!	true
vo_unit_texts_text_Land_SA_BA_Inspire_Group_03att_cult_barbarian	We will bath in their blood!	true
vo_unit_texts_text_Naval_US_RO_Selection_Artillery_Ship_03att_cult_eastern	Artillery ships reporting!	true
vo_unit_texts_text_Naval_US_RO_Selection_Artillery_Ship_02att_cult_eastern	Artillery awaiting orders!	true
vo_unit_texts_text_Naval_US_RO_Selection_Artillery_Ship_01att_cult_eastern	Artillery ships ready!	true
vo_unit_texts_text_Naval_US_RO_Selection_Artillery_Ship_05att_cult_eastern	Artillery at your command!	true
vo_unit_texts_text_Naval_US_RO_Selection_Artillery_Ship_04att_cult_eastern	Firepower ready!	true
vo_unit_texts_text_Land_US_RO_Selection_Italian_Noble_Infantryatt_cult_eastern	Italian Noble Infantry!	true
vo_unit_texts_text_Land_UO_RO_Man_Siege_Tower_01att_cult_roman	Man that siege tower!	true
vo_unit_texts_text_Land_UO_RO_Man_Siege_Tower_02att_cult_roman	Into the tower!	true
vo_unit_texts_text_Land_UO_RO_Man_Siege_Tower_03att_cult_roman	To your positions!	true
vo_unit_texts_text_Land_UO_RO_Man_Siege_Tower_04att_cult_roman	Man the tower!	true
vo_unit_texts_text_Land_UO_RO_Man_Siege_Tower_05att_cult_roman	Take up your positions!	true
vo_unit_texts_text_Naval_SA_EA_Flaming_Projectile_03att_cult_eastern	Set them ablaze!	true
vo_unit_texts_text_Naval_SA_EA_Flaming_Projectile_02att_cult_eastern	Fire! Burn them!	true
vo_unit_texts_text_Naval_SA_EA_Flaming_Projectile_01att_cult_eastern	Give them fire!	true
vo_unit_texts_text_Land_SA_BA_Into__the_Breach_Group_01att_cult_barbarian	Last one in's a Roman bastard!	true
vo_unit_texts_text_Land_SA_BA_Into__the_Breach_Group_02att_cult_barbarian	Get in there!	true
vo_unit_texts_text_Land_SA_BA_Into__the_Breach_Group_03att_cult_barbarian	Get 'em!	true
vo_unit_texts_text_Naval_UO_BA_Drop_Anchor_01att_cult_eastern	Drop anchor!	true
vo_unit_texts_text_Naval_UO_BA_Drop_Anchor_02att_cult_eastern	Let go the anchor!	true
vo_unit_texts_text_Naval_UO_EA_Drop_Anchor_05att_cult_eastern	Come to anchor!	true
vo_unit_texts_text_Naval_UO_BA_Drop_Anchor_03att_cult_eastern	Ride at anchor!	true
vo_unit_texts_text_Naval_UO_EA_Drop_Anchor_04att_cult_eastern	Ride at anchor!	true
vo_unit_texts_text_Naval_UO_BA_Drop_Anchor_04att_cult_eastern	Come to anchor!	true
vo_unit_texts_text_Naval_UO_EA_Drop_Anchor_03att_cult_eastern	Deploy the anchor!	true
vo_unit_texts_text_Naval_UO_BA_Drop_Anchor_05att_cult_eastern	Anchors down!	true
vo_unit_texts_text_Naval_UO_EA_Drop_Anchor_02att_cult_eastern	Let go the anchor!	true
vo_unit_texts_text_Naval_UO_EA_Drop_Anchor_01att_cult_eastern	Drop anchor!	true
vo_unit_texts_text_Land_US_BA_Selection_Illyrian_Thureos_Spearsatt_cult_barbarian	Illyrian Thureos Spears!	true
vo_unit_texts_text_Land_UO_RO_Tight_Formation_01att_cult_roman	Tight formation!	true
vo_unit_texts_text_Land_UO_RO_Tight_Formation_02att_cult_roman	Stand together!	true
vo_unit_texts_text_Land_UO_RO_Tight_Formation_03att_cult_roman	Form tight formation!	true
vo_unit_texts_text_Land_UO_RO_Tight_Formation_04att_cult_roman	Close ranks!	true
vo_unit_texts_text_Land_UO_RO_Tight_Formation_05att_cult_roman	Into tight formation, now!	true
vo_unit_texts_text_Naval_US_RO_Selection_Transport_Ship_01att_cult_roman	Transport ships!	true
vo_unit_texts_text_Naval_US_RO_Selection_Transport_Ship_02att_cult_roman	Transports ready and waiting!	true
vo_unit_texts_text_Naval_US_RO_Selection_Transport_Ship_03att_cult_roman	Transport ships at your command!	true
vo_unit_texts_text_Naval_US_RO_Selection_Transport_Ship_04att_cult_roman	Transports!	true
vo_unit_texts_text_Naval_US_RO_Selection_Transport_Ship_05att_cult_roman	Transports ready for orders!	true
vo_unit_texts_text_Land_SA_BA_Push_01att_cult_barbarian	Put yah backs in to it!	true
vo_unit_texts_text_Land_SA_BA_Push_02att_cult_barbarian	Push!	true
vo_unit_texts_text_Land_SA_BA_Push_03att_cult_barbarian	Push, curse you!	true
vo_unit_texts_text_Land_US_BA_Selection_Galatian_Royal_Guardatt_cult_barbarian	Galatian Royal Guard!	true
vo_unit_texts_text_Land_Mounted_UO_BA_Double_Click_Move_To_01att_cult_barbarian	Horsemen, forward!	true
vo_unit_texts_text_Land_Mounted_UO_BA_Double_Click_Move_To_02att_cult_barbarian	Forward!	true
vo_unit_texts_text_Land_Mounted_UO_BA_Double_Click_Move_To_03att_cult_barbarian	Quickly now!	true
vo_unit_texts_text_Land_Mounted_UO_BA_Double_Click_Move_To_04att_cult_barbarian	Riders, advance!	true
vo_unit_texts_text_Land_Mounted_UO_BA_Double_Click_Move_To_05att_cult_barbarian	Advance at speed!	true
vo_unit_texts_text_Land_Mounted_US_RO_Selection_Ptolemaic_Cavalryatt_cult_roman	Ptolemaic Cavalry!	true
vo_unit_texts_text_Land_UO_EA_Attack_Egypt_04att_cult_eastern	Attack! Warriors of Egypt!	true
vo_unit_texts_text_Land_UR_EA_Attack_Egypt_04att_cult_eastern	Wrath of Pharaoh!	true
vo_unit_texts_text_Land_UO_EA_Attack_Egypt_05att_cult_eastern	Deliver them to their Gods!	true
vo_unit_texts_text_Land_UR_EA_Attack_Egypt_05att_cult_eastern	Ammit take them!	true
vo_unit_texts_text_Land_UO_EA_Attack_Egypt_02att_cult_eastern	Pharaoh's wrath!	true
vo_unit_texts_text_Land_UR_EA_Attack_Egypt_02att_cult_eastern	Victory to Pharaoh!	true
vo_unit_texts_text_Land_UO_EA_Attack_Egypt_03att_cult_eastern	A thousand deaths!	true
vo_unit_texts_text_Land_UR_EA_Attack_Egypt_03att_cult_eastern	A thousand deaths!	true
vo_unit_texts_text_Land_UO_EA_Attack_Egypt_01att_cult_eastern	Wash over them!	true
vo_unit_texts_text_Land_UR_EA_Attack_Egypt_01att_cult_eastern	By Ra!	true
vo_unit_texts_text_Land_SA_RO_Flaming_Projectile_01att_cult_roman	Give them fire!	true
vo_unit_texts_text_Land_SA_RO_Flaming_Projectile_02att_cult_roman	Burn them!	true
vo_unit_texts_text_Land_SA_RO_Flaming_Projectile_03att_cult_roman	Set them alight!	true
vo_unit_texts_text_Land_SA_RO_Inspire_01att_cult_roman	For honour and glory!	true
vo_unit_texts_text_Land_SA_RO_Inspire_02att_cult_roman	Glory awaits!	true
vo_unit_texts_text_Land_SA_RO_Inspire_03att_cult_roman	Victoria! Lead us!	true
vo_unit_texts_text_Land_US_EA_Selection_Nubian_Spearmenatt_cult_eastern	Nubian Spearmen!	true
vo_unit_texts_text_Land_SA_RO_Break_Off_01att_cult_roman	Break off!	true
vo_unit_texts_text_Land_SA_RO_Break_Off_02att_cult_roman	Pull back!	true
vo_unit_texts_text_Land_SA_RO_Break_Off_03att_cult_roman	Back, back now!	true
vo_unit_texts_text_Land_US_RO_Selection_Triariiatt_cult_eastern	Triarii!	true
vo_unit_texts_text_Naval_UO_RO_Up_Anchor_01att_cult_roman	Up anchor!	true
vo_unit_texts_text_Naval_UO_RO_Up_Anchor_02att_cult_roman	Raise the anchor!	true
vo_unit_texts_text_Naval_UO_RO_Up_Anchor_03att_cult_roman	Haul up the anchor!	true
vo_unit_texts_text_Naval_UO_RO_Up_Anchor_04att_cult_roman	Anchors aweigh!	true
vo_unit_texts_text_Naval_UO_RO_Up_Anchor_05att_cult_roman	Anchors a loft!	true
vo_unit_texts_text_Land_US_EA_Selection_Auxiliary_Sabaean_Archersatt_cult_eastern	Sabaean Archers!	true
vo_unit_texts_text_Naval_SA_BA_Flaming_Projectile_01att_cult_barbarian	Give them fire!	true
vo_unit_texts_text_Naval_SA_BA_Flaming_Projectile_02att_cult_barbarian	Fire! Burn them!	true
vo_unit_texts_text_Naval_SA_BA_Flaming_Projectile_03att_cult_barbarian	Set them ablaze!	true
vo_unit_texts_text_Land_UO_BA_Embark_01att_cult_barbarian	To the ships!	true
vo_unit_texts_text_Land_UO_BA_Embark_02att_cult_barbarian	Embark!	true
vo_unit_texts_text_Land_UO_BA_Embark_03att_cult_barbarian	Get aboard!	true
vo_unit_texts_text_Land_UO_BA_Embark_04att_cult_barbarian	Board the ships!	true
vo_unit_texts_text_Land_UO_BA_Embark_05att_cult_barbarian	Embark, now!	true
vo_unit_texts_text_Land_SA_EA_Flaming_Projectile_02att_cult_eastern	Burn them!	true
vo_unit_texts_text_Land_SA_EA_Flaming_Projectile_03att_cult_eastern	Set them alight!	true
vo_unit_texts_text_Land_SA_EA_Flaming_Projectile_01att_cult_eastern	Give them fire!	true
vo_unit_texts_text_Land_US_EA_Selection_Cavalry_shock_generic_5att_cult_eastern	Armoured horsemen!	true
vo_unit_texts_text_Land_US_RO_Selection_Cavalry_shock_generic_5att_cult_eastern	Heavy cavalry ready and willing!	true
vo_unit_texts_text_Land_US_EA_Selection_Cavalry_shock_generic_4att_cult_eastern	Ready to ride!	true
vo_unit_texts_text_Land_US_RO_Selection_Cavalry_shock_generic_4att_cult_eastern	Ready to ride!	true
vo_unit_texts_text_Land_US_EA_Selection_Cavalry_shock_generic_3att_cult_eastern	Shock cavalry ready!	true
vo_unit_texts_text_Land_US_RO_Selection_Cavalry_shock_generic_3att_cult_eastern	Heavy horse at your command!	true
vo_unit_texts_text_Land_US_EA_Selection_Cavalry_shock_generic_2att_cult_eastern	Heavy horse at your command!	true
vo_unit_texts_text_Land_US_RO_Selection_Cavalry_shock_generic_2att_cult_eastern	The brave ready for orders!	true
vo_unit_texts_text_Land_US_EA_Selection_Cavalry_shock_generic_1att_cult_eastern	Heavy cavalry!	true
vo_unit_texts_text_Land_US_RO_Selection_Cavalry_shock_generic_1att_cult_eastern	Shock cavalry ready!	true
vo_unit_texts_text_Land_US_RO_Selection_Perioikoi_Pikemenatt_cult_eastern	Perioikoi Pikemen!	true
vo_unit_texts_text_Land_Mounted_UO_BA_Mount_01att_cult_barbarian	Mount up!	true
vo_unit_texts_text_Land_Mounted_UO_BA_Mount_02att_cult_barbarian	To the saddle!	true
vo_unit_texts_text_Land_Mounted_UO_BA_Mount_03att_cult_barbarian	Mount!	true
vo_unit_texts_text_Land_Mounted_UO_BA_Mount_04att_cult_barbarian	Warriors, mount up!	true
vo_unit_texts_text_Land_Mounted_UO_BA_Mount_05att_cult_barbarian	Back on the horses!	true
vo_unit_texts_text_Land_Mounted_US_EA_Selection_Mercenary_Sabean_Cavalryatt_cult_eastern	Mercenary Sabean Cavalry!	true
vo_unit_texts_text_Naval_US_BA_Selection_Harpaxatt_cult_barbarian	Harpax armed and ready!	true
vo_unit_texts_text_Naval_US_BA_Selection_Corvusatt_cult_barbarian	Corvus ready!	true
vo_unit_texts_text_Land_Mounted_UO_BA_Single_Click_Move_To_01att_cult_barbarian	Riders, forward!	true
vo_unit_texts_text_Land_Mounted_UO_BA_Single_Click_Move_To_02att_cult_barbarian	On me!	true
vo_unit_texts_text_Land_Mounted_UO_BA_Single_Click_Move_To_03att_cult_barbarian	Ride out!	true
vo_unit_texts_text_Land_Mounted_UO_BA_Single_Click_Move_To_04att_cult_barbarian	Riders, move out!	true
vo_unit_texts_text_Land_Mounted_UO_BA_Single_Click_Move_To_05att_cult_barbarian	Follow me!	true
vo_unit_texts_text_Land_US_RO_Selection_Royal_Peltastsatt_cult_eastern	Royal Peltasts!	true
vo_unit_texts_text_Land_Mounted_US_BA_Selection_Auxiliary_Noble_Horseatt_cult_barbarian	Auxiliary Noble Horse!	true
vo_unit_texts_text_Land_UO_EA_Halt_01att_cult_eastern	Halt!	true
vo_unit_texts_text_Land_UO_EA_Fire_at_Will_05att_cult_eastern	Fire! 	true
vo_unit_texts_text_Land_UO_EA_Halt_03att_cult_eastern	Halt men!	true
vo_unit_texts_text_Land_UO_EA_Fire_at_Will_04att_cult_eastern	Fire at anyone!	true
vo_unit_texts_text_Land_UO_EA_Halt_02att_cult_eastern	Stop!	true
vo_unit_texts_text_Land_UO_EA_Fire_at_Will_03att_cult_eastern	Get them! Any of them!	true
vo_unit_texts_text_Land_UO_EA_Halt_05att_cult_eastern	Halt now!	true
vo_unit_texts_text_Land_UO_EA_Fire_at_Will_02att_cult_eastern	Pick your targets!	true
vo_unit_texts_text_Land_UO_EA_Halt_04att_cult_eastern	Stop now!	true
vo_unit_texts_text_Land_UO_EA_Fire_at_Will_01att_cult_eastern	Fire at will!	true
vo_unit_texts_text_Naval_US_RO_Selection_Assault_Ship_01att_cult_roman	Assault ships reporting!	true
vo_unit_texts_text_Naval_US_RO_Selection_Assault_Ship_02att_cult_roman	Crewed by fighters and ready!	true
vo_unit_texts_text_Naval_US_RO_Selection_Assault_Ship_03att_cult_roman	Assault ships ready for orders!	true
vo_unit_texts_text_Naval_US_RO_Selection_Assault_Ship_04att_cult_roman	Assault ships ready to attack!	true
vo_unit_texts_text_Naval_US_RO_Selection_Assault_Ship_05att_cult_roman	Ready, willing and able!	true
vo_unit_texts_text_Land_US_RO_Selection_Command_generic_1att_cult_eastern	You have orders, sir?	true
vo_unit_texts_text_Land_US_RO_Selection_generic_03att_cult_eastern	Yours to command!	true
vo_unit_texts_text_Land_US_RO_Selection_generic_02att_cult_eastern	Ready for orders! 	true
vo_unit_texts_text_Land_US_RO_Selection_Command_generic_3att_cult_eastern	Commander, at your service.	true
vo_unit_texts_text_Land_US_RO_Selection_generic_01att_cult_eastern	At your service!	true
vo_unit_texts_text_Land_US_RO_Selection_Command_generic_2att_cult_eastern	We await orders!	true
vo_unit_texts_text_Land_US_RO_Selection_generic_05att_cult_eastern	By your command!	true
vo_unit_texts_text_Land_US_RO_Selection_generic_04att_cult_eastern	We await your command!	true
vo_unit_texts_text_Land_SA_EA_Taunt_Group_01att_cult_eastern	We will walk on your corpses!	true
vo_unit_texts_text_Land_SA_EA_Taunt_Group_03att_cult_eastern	Your gods have deserted you!	true
vo_unit_texts_text_Land_SA_EA_Taunt_Group_02att_cult_eastern	Men should know when they're conquered!	true
vo_unit_texts_text_Land_UO_RO_Dog_Attack_01att_cult_roman	At them, brutes!	true
vo_unit_texts_text_Land_UO_RO_Dog_Attack_02att_cult_roman	Bite hard, boys!	true
vo_unit_texts_text_Land_UO_RO_Dog_Attack_03att_cult_roman	Savage them!	true
vo_unit_texts_text_Land_UO_RO_Dog_Attack_04att_cult_roman	Go on! Get them!	true
vo_unit_texts_text_Land_UO_RO_Dog_Attack_05att_cult_roman	Rip them to shreds!	true
vo_unit_texts_text_Land_UR_BA_Generic_Order_Briton_01att_cult_barbarian	Honour the gods!	true
vo_unit_texts_text_Land_UR_BA_Generic_Order_Briton_02att_cult_barbarian	Aye the gods!	true
vo_unit_texts_text_Land_UR_BA_Generic_Order_Briton_03att_cult_barbarian	Honoured ancestors!	true
vo_unit_texts_text_Land_UR_BA_Generic_Order_Briton_04att_cult_barbarian	Briton!	true
vo_unit_texts_text_Land_UR_BA_Generic_Order_Briton_05att_cult_barbarian	For the Mother!	true
vo_unit_texts_text_Land_SA_BA_Rally_01att_cult_barbarian	To me!	true
vo_unit_texts_text_Land_SA_BA_Rally_02att_cult_barbarian	Warriors never surrender!	true
vo_unit_texts_text_Land_SA_BA_Rally_03att_cult_barbarian	Remember your ancestors!	true
vo_unit_texts_text_Land_UO_EA_Single_Click_Melee_Attack_Heightened_01att_cult_eastern	Spill their blood!	true
vo_unit_texts_text_Land_UO_EA_Single_Click_Melee_Attack_Heightened_03att_cult_eastern	Bleed them!	true
vo_unit_texts_text_Land_UO_EA_Single_Click_Melee_Attack_Heightened_02att_cult_eastern	Cut them down!	true
vo_unit_texts_text_Land_UO_EA_Single_Click_Melee_Attack_Heightened_05att_cult_eastern	Break them!	true
vo_unit_texts_text_Land_UO_EA_Single_Click_Melee_Attack_Heightened_04att_cult_eastern	Shatter them!	true
vo_unit_texts_text_Land_US_EA_Selection_Mercenary_Sabaean_Archersatt_cult_eastern	Mercenary Sabaean Archers!	true
vo_unit_texts_text_Land_SA_BA_Steady_Retreat_01att_cult_barbarian	Pull back!	true
vo_unit_texts_text_Land_SA_BA_Steady_Retreat_02att_cult_barbarian	No need to run!	true
vo_unit_texts_text_Land_SA_BA_Steady_Retreat_03att_cult_barbarian	Steady, we're in no rush!	true
vo_unit_texts_text_Naval_GO_EA_Unlock_Formation_04att_cult_eastern	Break formation!	true
vo_unit_texts_text_Naval_GO_EA_Unlock_Formation_05att_cult_eastern	Leave formation!	true
vo_unit_texts_text_Naval_GO_EA_Unlock_Formation_02att_cult_eastern	Prepare to break formation!	true
vo_unit_texts_text_Land_UR_RO_Move_To_01att_cult_roman	Moving out!	true
vo_unit_texts_text_Land_UR_RO_Move_To_02att_cult_roman	Huh huh!	true
vo_unit_texts_text_Land_UR_RO_Move_To_03att_cult_roman	On the move!	true
vo_unit_texts_text_Land_UR_RO_Move_To_04att_cult_roman	Heading out!	true
vo_unit_texts_text_Land_UR_RO_Move_To_05att_cult_roman	Hah!	true
vo_unit_texts_text_Naval_GO_EA_Unlock_Formation_03att_cult_eastern	Release formation!	true
vo_unit_texts_text_Naval_GO_EA_Unlock_Formation_01att_cult_eastern	As you were!	true
vo_unit_texts_text_Land_US_EA_Selection_generic_03att_cult_eastern	We await your orders!	true
vo_unit_texts_text_Land_US_EA_Selection_generic_02att_cult_eastern	Orders, my lord?	true
vo_unit_texts_text_Land_US_EA_Selection_generic_01att_cult_eastern	We are at your command!	true
vo_unit_texts_text_Land_US_EA_Selection_generic_05att_cult_eastern	At the ready!	true
vo_unit_texts_text_Land_US_EA_Selection_generic_04att_cult_eastern	What are your orders?	true
vo_unit_texts_text_Land_US_RO_Selection_Special_generic_1att_cult_eastern	Animal handlers ready!	true
vo_unit_texts_text_Land_US_RO_Selection_Special_generic_3att_cult_eastern	Waiting to be unleashed!	true
vo_unit_texts_text_Land_US_RO_Selection_Special_generic_2att_cult_eastern	Our charges are yours to command!	true
vo_unit_texts_text_Land_US_EA_Selection_Cavalry_melee_generic_4att_cult_eastern	Melee cavalry ready!	true
vo_unit_texts_text_Land_US_RO_Selection_Cavalry_melee_generic_4att_cult_eastern	Swift melee cavalry!	true
vo_unit_texts_text_Land_US_EA_Selection_Cavalry_melee_generic_5att_cult_eastern	Swift riders!	true
vo_unit_texts_text_Land_US_RO_Selection_Cavalry_melee_generic_5att_cult_eastern	Melee cavalry!	true
vo_unit_texts_text_Land_US_EA_Selection_Cavalry_melee_generic_1att_cult_eastern	Melee cavalry!	true
vo_unit_texts_text_Land_US_RO_Selection_Cavalry_melee_generic_1att_cult_eastern	Melee cavalry ready!	true
vo_unit_texts_text_Land_US_EA_Selection_Cavalry_melee_generic_2att_cult_eastern	Melee cavalry at your command!	true
vo_unit_texts_text_Land_US_RO_Selection_Cavalry_melee_generic_2att_cult_eastern	Swift riders at your command!	true
vo_unit_texts_text_Land_US_EA_Selection_Cavalry_melee_generic_3att_cult_eastern	Melee cavalry awaiting orders!	true
vo_unit_texts_text_Land_US_RO_Selection_Cavalry_melee_generic_3att_cult_eastern	Melee horsemen!	true
vo_unit_texts_text_Land_SA_BA_Rapid_Advance_01att_cult_barbarian	Rapid advance!	true
vo_unit_texts_text_Land_SA_BA_Rapid_Advance_02att_cult_barbarian	Ruuunnnn!	true
vo_unit_texts_text_Land_SA_BA_Rapid_Advance_03att_cult_barbarian	Faster!	true
vo_unit_texts_text_Land_UO_BA_Skirmish_On_01att_cult_barbarian	Skirmish!	true
vo_unit_texts_text_Land_UO_BA_Skirmish_On_02att_cult_barbarian	Spread out!	true
vo_unit_texts_text_Land_UO_BA_Skirmish_On_03att_cult_barbarian	Keep yah distance!	true
vo_unit_texts_text_Land_UO_BA_Skirmish_On_04att_cult_barbarian	Spread out warriors!	true
vo_unit_texts_text_Land_UO_BA_Skirmish_On_05att_cult_barbarian	Warriors, skirmish!	true
vo_unit_texts_text_Land_UO_BA_Double_Click_Move_To_01att_cult_barbarian	Get running!	true
vo_unit_texts_text_Land_UO_BA_Double_Click_Move_To_02att_cult_barbarian	Run, curse you!	true
vo_unit_texts_text_Land_UO_BA_Double_Click_Move_To_03att_cult_barbarian	Warriors, move out!	true
vo_unit_texts_text_Land_UO_BA_Double_Click_Move_To_04att_cult_barbarian	Forward!	true
vo_unit_texts_text_Land_UO_BA_Double_Click_Move_To_05att_cult_barbarian	Move it!	true
vo_unit_texts_text_Naval_UO_BA_Turn_Right_02att_cult_eastern	Turn right	true
vo_unit_texts_text_Naval_UO_EA_Turn_Right_02att_cult_eastern	Turn right	true
vo_unit_texts_text_Naval_UO_BA_Turn_Right_03att_cult_eastern	To starboard!	true
vo_unit_texts_text_Naval_UO_EA_Turn_Right_03att_cult_eastern	To starboard!	true
vo_unit_texts_text_Land_UO_EA_Disembark_04att_cult_eastern	To the shore!	true
vo_unit_texts_text_Land_UO_EA_Disembark_05att_cult_eastern	All men ashore!	true
vo_unit_texts_text_Naval_UO_BA_Turn_Right_01att_cult_eastern	To the Right!	true
vo_unit_texts_text_Naval_UO_EA_Turn_Right_01att_cult_eastern	To the Right!	true
vo_unit_texts_text_Land_UO_EA_Disembark_02att_cult_eastern	Go ashore!	true
vo_unit_texts_text_Land_UO_EA_Disembark_03att_cult_eastern	Off the boats!	true
vo_unit_texts_text_Naval_UO_BA_Turn_Right_04att_cult_eastern	Right!	true
vo_unit_texts_text_Naval_UO_EA_Turn_Right_04att_cult_eastern	Right!	true
vo_unit_texts_text_Land_UO_EA_Disembark_01att_cult_eastern	Disembark!	true
vo_unit_texts_text_Naval_UO_BA_Turn_Right_05att_cult_eastern	Starboard!	true
vo_unit_texts_text_Naval_UO_EA_Turn_Right_05att_cult_eastern	Starboard!	true
vo_unit_texts_text_Land_UO_EA_Double_Click_Melee_Attack_05att_cult_eastern	Destroy them!	true
vo_unit_texts_text_Land_UO_EA_Double_Click_Melee_Attack_04att_cult_eastern	Break their lines!	true
vo_unit_texts_text_Land_UO_EA_Double_Click_Melee_Attack_01att_cult_eastern	Attack!	true
vo_unit_texts_text_Land_UO_EA_Double_Click_Melee_Attack_03att_cult_eastern	Hack them down!	true
vo_unit_texts_text_Land_UO_EA_Double_Click_Melee_Attack_02att_cult_eastern	Engage the enemy!	true
vo_unit_texts_text_Land_US_RO_Selection_Shield_Bearersatt_cult_eastern	Shield Bearers!	true
vo_unit_texts_text_Land_UO_RO_Guard_Off_01att_cult_roman	Stand down!	true
vo_unit_texts_text_Land_UO_RO_Guard_Off_02att_cult_roman	At ease!	true
vo_unit_texts_text_Land_UO_RO_Guard_Off_03att_cult_roman	Stand down, men!	true
vo_unit_texts_text_Land_UO_RO_Guard_Off_04att_cult_roman	Stand easy!	true
vo_unit_texts_text_Land_UO_RO_Guard_Off_05att_cult_roman	At ease, men!	true
vo_unit_texts_text_Naval_US_RO_Selection_Short_01att_cult_roman	Ships ready!	true
vo_unit_texts_text_Naval_US_RO_Selection_Short_02att_cult_roman	Commander?	true
vo_unit_texts_text_Naval_US_RO_Selection_Short_03att_cult_roman	Ships waiting!	true
vo_unit_texts_text_Naval_US_RO_Selection_Short_04att_cult_roman	Orders?	true
vo_unit_texts_text_Naval_US_RO_Selection_Short_05att_cult_roman	Ready for orders! 	true
vo_unit_texts_text_Land_SA_BA_Taunt_01att_cult_barbarian	Your weakness sickens us!	true
vo_unit_texts_text_Land_SA_BA_Taunt_02att_cult_barbarian	Our children fight better than you!	true
vo_unit_texts_text_Land_SA_BA_Taunt_03att_cult_barbarian	We do not fear you!	true
vo_unit_texts_text_Land_UO_RO_Disembark_01att_cult_roman	Disembark!	true
vo_unit_texts_text_Land_UO_RO_Disembark_02att_cult_roman	Go ashore!	true
vo_unit_texts_text_Land_UO_RO_Disembark_03att_cult_roman	Off the boats!	true
vo_unit_texts_text_Land_UO_RO_Disembark_04att_cult_roman	To the shore!	true
vo_unit_texts_text_Land_UO_RO_Disembark_05att_cult_roman	All men ashore!	true
vo_unit_texts_text_Land_UO_RO_Single_Click_Move_To_Heightened_01att_cult_roman	Move out!	true
vo_unit_texts_text_Land_UO_RO_Single_Click_Move_To_Heightened_02att_cult_roman	On me!	true
vo_unit_texts_text_Land_UO_RO_Single_Click_Move_To_Heightened_03att_cult_roman	March!	true
vo_unit_texts_text_Land_UO_RO_Single_Click_Move_To_Heightened_04att_cult_roman	Marching order!	true
vo_unit_texts_text_Land_UO_RO_Single_Click_Move_To_Heightened_05att_cult_roman	Follow me!	true
vo_unit_texts_text_Land_UO_BA_Climb_01att_cult_barbarian	To the walls!	true
vo_unit_texts_text_Land_UO_BA_Climb_02att_cult_barbarian	Scale the walls!	true
vo_unit_texts_text_Land_UO_BA_Climb_03att_cult_barbarian	Get over the walls!	true
vo_unit_texts_text_Land_UO_BA_Climb_04att_cult_barbarian	Get climbing!	true
vo_unit_texts_text_Land_UO_BA_Climb_05att_cult_barbarian	Over the walls!	true
vo_unit_texts_text_Land_SA_BA_Frenzy_01att_cult_barbarian	Blahhh ahhh yahah!	true
vo_unit_texts_text_Land_SA_BA_Frenzy_02att_cult_barbarian	Yahh yahah yahahah!	true
vo_unit_texts_text_Land_SA_BA_Frenzy_03att_cult_barbarian	Blood, blood, BLOOD!	true
vo_unit_texts_text_Land_Mounted_US_BA_Selection_Noble_Ridersatt_cult_barbarian	Noble Riders!	true
vo_unit_texts_text_Land_US_EA_Selection_Chariot_generic_3att_cult_eastern	Your chariots await!	true
vo_unit_texts_text_Land_US_EA_Selection_Chariot_generic_2att_cult_eastern	Chariots at the ready!	true
vo_unit_texts_text_Land_US_EA_Selection_Chariot_generic_1att_cult_eastern	Chariots!	true
vo_unit_texts_text_Land_UO_BA_Skirmish_Rightatt_cult_barbarian	Skirmish right! 	true
vo_unit_texts_text_Land_US_EA_Selection_Artillery_field_generic_1att_cult_eastern	Field artillery!	true
vo_unit_texts_text_Land_US_EA_Selection_Artillery_siege_generic_1att_cult_eastern	We bring destruction!	true
vo_unit_texts_text_Land_UO_BA_Change_Facing_01att_cult_barbarian	Change facing!	true
vo_unit_texts_text_Land_UO_BA_Change_Facing_02att_cult_barbarian	Move the artillery!	true
vo_unit_texts_text_Land_UO_BA_Change_Facing_03att_cult_barbarian	Realign the artillery!	true
vo_unit_texts_text_Land_UO_BA_Change_Facing_04att_cult_barbarian	Switch targets!	true
vo_unit_texts_text_Land_UO_BA_Change_Facing_05att_cult_barbarian	Over there!	true
vo_unit_texts_text_Land_US_EA_Selection_Artillery_field_generic_2att_cult_eastern	Field artillery ready!	true
vo_unit_texts_text_Land_US_EA_Selection_Artillery_siege_generic_2att_cult_eastern	Siege artillery ready!	true
vo_unit_texts_text_Land_US_EA_Selection_Artillery_field_generic_3att_cult_eastern	Artillery at your command!	true
vo_unit_texts_text_Land_US_EA_Selection_Artillery_siege_generic_3att_cult_eastern	Siege artillery awaiting orders!	true
vo_unit_texts_text_Naval_US_RO_Selection_Scorpiosatt_cult_roman	Scorpios ready!	true
vo_unit_texts_text_Naval_GO_BA_Unlock_Formation_04att_cult_eastern	Return to your positions!	true
vo_unit_texts_text_Naval_GO_BA_Unlock_Formation_05att_cult_eastern	Leave formation!	true
vo_unit_texts_text_Naval_GO_BA_Unlock_Formation_02att_cult_eastern	Do as you please!	true
vo_unit_texts_text_Naval_GO_BA_Unlock_Formation_03att_cult_eastern	Break formation!	true
vo_unit_texts_text_Naval_GO_BA_Unlock_Formation_01att_cult_eastern	As you were!	true
vo_unit_texts_text_Land_UO_BA_Single_Click_Move_To_01att_cult_barbarian	Move out!	true
vo_unit_texts_text_Land_UO_BA_Single_Click_Move_To_02att_cult_barbarian	Get moving!	true
vo_unit_texts_text_Land_UO_BA_Single_Click_Move_To_03att_cult_barbarian	Warriors on me!	true
vo_unit_texts_text_Land_UO_BA_Single_Click_Move_To_04att_cult_barbarian	Lets go!	true
vo_unit_texts_text_Land_UO_BA_Single_Click_Move_To_05att_cult_barbarian	Follow me!	true
vo_unit_texts_text_Land_SA_BA_War_Cry_Group_01att_cult_barbarian	BLOOOD!	true
vo_unit_texts_text_Land_SA_BA_War_Cry_Group_02att_cult_barbarian	Ahhhhhhh!	true
vo_unit_texts_text_Land_SA_BA_War_Cry_Group_03att_cult_barbarian	Dehh hett dahhh haa dahh whoo daaah!	true
vo_unit_texts_text_Land_UO_BA_Fire_at_Will_01att_cult_barbarian	Fire at will!	true
vo_unit_texts_text_Land_UO_BA_Fire_at_Will_02att_cult_barbarian	Pick your targets!	true
vo_unit_texts_text_Land_UO_BA_Fire_at_Will_03att_cult_barbarian	Get them! Any of them!	true
vo_unit_texts_text_Land_UO_BA_Fire_at_Will_04att_cult_barbarian	Fire at anyone!	true
vo_unit_texts_text_Land_UO_BA_Fire_at_Will_05att_cult_barbarian	Fire! 	true
vo_unit_texts_text_Land_US_RO_Selection_Hastatiatt_cult_eastern	Hastati!	true
vo_unit_texts_text_Land_UO_EA_Single_Click_Move_To_04att_cult_eastern	Marching order!	true
vo_unit_texts_text_Land_UO_EA_Single_Click_Move_To_05att_cult_eastern	Follow me!	true
vo_unit_texts_text_Land_UO_EA_Single_Click_Move_To_01att_cult_eastern	Move out!	true
vo_unit_texts_text_Land_UO_EA_Single_Click_Move_To_02att_cult_eastern	On me!	true
vo_unit_texts_text_Land_UO_EA_Single_Click_Move_To_03att_cult_eastern	March!	true
vo_unit_texts_text_Land_UO_BA_Single_Click_Ranged_Attack_Heightened_01att_cult_barbarian	Loose!	true
vo_unit_texts_text_Land_UO_BA_Single_Click_Ranged_Attack_Heightened_02att_cult_barbarian	Fire!	true
vo_unit_texts_text_Land_UO_BA_Single_Click_Ranged_Attack_Heightened_03att_cult_barbarian	Now!	true
vo_unit_texts_text_Land_UO_BA_Single_Click_Ranged_Attack_Heightened_04att_cult_barbarian	Fire on 'em!	true
vo_unit_texts_text_Land_UO_BA_Single_Click_Ranged_Attack_Heightened_05att_cult_barbarian	Take aim!	true
vo_unit_texts_text_Land_SA_RO_Into_the_Breach_01att_cult_roman	In to the breach!	true
vo_unit_texts_text_Land_SA_RO_Into_the_Breach_02att_cult_roman	Fight your way through!	true
vo_unit_texts_text_Land_SA_RO_Into_the_Breach_03att_cult_roman	Advance, into the breach!	true
vo_unit_texts_text_Land_UO_EA_Single_Click_Melee_Attack_01att_cult_eastern	Spill their blood!	true
vo_unit_texts_text_Land_UO_EA_Single_Click_Melee_Attack_02att_cult_eastern	Cut them down!	true
vo_unit_texts_text_Land_UO_EA_Single_Click_Melee_Attack_03att_cult_eastern	Bleed them!	true
vo_unit_texts_text_Land_UO_EA_Single_Click_Melee_Attack_04att_cult_eastern	Shatter them!	true
vo_unit_texts_text_Land_UO_EA_Single_Click_Melee_Attack_05att_cult_eastern	Break them!	true
vo_unit_texts_text_Land_SA_EA_Push_01att_cult_eastern	Push!	true
vo_unit_texts_text_Land_SA_EA_Push_02att_cult_eastern	Get in there and push!	true
vo_unit_texts_text_Land_SA_EA_Push_03att_cult_eastern	Forward, push!	true
vo_unit_texts_text_Land_Mounted_US_BA_Selection_Mercenary_Noble_Horseatt_cult_barbarian	Mercenary Noble Horse!	true
vo_unit_texts_text_Land_UO_BA_Attack_Briton_01att_cult_barbarian	The Mother wants blood!	true
vo_unit_texts_text_Land_UO_BA_Attack_Briton_02att_cult_barbarian	What do we say?!	true
vo_unit_texts_text_Land_UO_BA_Attack_Briton_03att_cult_barbarian	Ancestors hear us!	true
vo_unit_texts_text_Land_UO_BA_Attack_Briton_04att_cult_barbarian	Bath the earth with their blood!	true
vo_unit_texts_text_Land_UO_BA_Attack_Briton_05att_cult_barbarian	Britons, attack!	true
vo_unit_texts_text_Land_UR_BA_Attack_Briton_01att_cult_barbarian	Blood, blood!	true
vo_unit_texts_text_Land_UR_BA_Attack_Briton_02att_cult_barbarian	The Crone can wait!	true
vo_unit_texts_text_Land_UR_BA_Attack_Briton_03att_cult_barbarian	Ancestors!	true
vo_unit_texts_text_Land_UR_BA_Attack_Briton_04att_cult_barbarian	Bleed them dry!	true
vo_unit_texts_text_Land_UR_BA_Attack_Briton_05att_cult_barbarian	For the tribe!	true
vo_unit_texts_text_Land_US_RO_Selection_Royal_Spartansatt_cult_eastern	Royal Spartans!	true
vo_unit_texts_text_Naval_UO_BA_Hold_Water_03att_cult_eastern	Stop!	true
vo_unit_texts_text_Naval_UO_EA_Hold_Water_03att_cult_eastern	Stop!	true
vo_unit_texts_text_Naval_UO_BA_Hold_Water_02att_cult_eastern	Back water!	true
vo_unit_texts_text_Naval_UO_EA_Hold_Water_02att_cult_eastern	Hold water!	true
vo_unit_texts_text_Naval_UO_BA_Hold_Water_01att_cult_eastern	Halt!	true
vo_unit_texts_text_Naval_UO_EA_Hold_Water_01att_cult_eastern	Halt!	true
vo_unit_texts_text_Naval_UO_BA_Hold_Water_05att_cult_eastern	Hold!	true
vo_unit_texts_text_Naval_UO_EA_Hold_Water_05att_cult_eastern	Hold!	true
vo_unit_texts_text_Land_US_BA_Selection_Sword_Mastersatt_cult_barbarian	Sword Masters!	true
vo_unit_texts_text_Naval_UO_BA_Hold_Water_04att_cult_eastern	I said stop!	true
vo_unit_texts_text_Naval_UO_EA_Hold_Water_04att_cult_eastern	Halt now!	true
vo_unit_texts_text_Land_SA_EA_Use_the_Whip_02att_cult_eastern	Forward you dogs!	true
vo_unit_texts_text_Land_SA_EA_Use_the_Whip_03att_cult_eastern	Faster! Move, move!	true
vo_unit_texts_text_Land_SA_EA_Use_the_Whip_01att_cult_eastern	Move curse you, move!	true
vo_unit_texts_text_Land_Mounted_US_BA_Selection_Noble_Cavalryatt_cult_barbarian	Noble Cavalry!	true
vo_unit_texts_text_Land_UO_BA_Mount_01att_cult_barbarian	Mount up!	true
vo_unit_texts_text_Land_UO_BA_Mount_02att_cult_barbarian	Into the saddle!	true
vo_unit_texts_text_Land_UO_BA_Mount_03att_cult_barbarian	Mount! Men!	true
vo_unit_texts_text_Land_UO_BA_Mount_04att_cult_barbarian	Warriors, mount up!	true
vo_unit_texts_text_Land_UO_BA_Mount_05att_cult_barbarian	Riders, mount up!	true
vo_unit_texts_text_Land_UO_EA_Double_Click_Move_To_05att_cult_eastern	Advance at speed!	true
vo_unit_texts_text_Land_UO_EA_Double_Click_Move_To_04att_cult_eastern	Double time!	true
vo_unit_texts_text_Land_UO_EA_Double_Click_Move_To_03att_cult_eastern	At speed!	true
vo_unit_texts_text_Land_UO_EA_Double_Click_Move_To_02att_cult_eastern	Quick march!	true
vo_unit_texts_text_Land_UO_EA_Double_Click_Move_To_01att_cult_eastern	At the double!	true
vo_unit_texts_text_Land_UO_RO_Double_Click_Move_To_Heightened_01att_cult_roman	At the double!	true
vo_unit_texts_text_Land_UO_RO_Double_Click_Move_To_Heightened_02att_cult_roman	Quick march!	true
vo_unit_texts_text_Land_UO_RO_Double_Click_Move_To_Heightened_03att_cult_roman	At speed!	true
vo_unit_texts_text_Land_UO_RO_Double_Click_Move_To_Heightened_04att_cult_roman	Double time!	true
vo_unit_texts_text_Land_UO_RO_Double_Click_Move_To_Heightened_05att_cult_roman	Advance at speed!	true
vo_unit_texts_text_Land_US_RO_Selection_Vigilesatt_cult_eastern	Vigiles!	true
vo_unit_texts_text_Naval_US_RO_Selection_Support_Ship_01att_cult_roman	Support ships ready!	true
vo_unit_texts_text_Naval_US_RO_Selection_Support_Ship_02att_cult_roman	Our missiles await your orders!	true
vo_unit_texts_text_Naval_US_RO_Selection_Support_Ship_03att_cult_roman	Support ships ready and waiting!	true
vo_unit_texts_text_Naval_US_RO_Selection_Support_Ship_04att_cult_roman	Support ships at your command!	true
vo_unit_texts_text_Naval_US_RO_Selection_Support_Ship_05att_cult_roman	At your command, support ships!	true
vo_unit_texts_text_Land_SA_RO_Rally_and_Inspire_01att_cult_roman	Remember, the gods are watching!	true
vo_unit_texts_text_Land_SA_RO_Rally_and_Inspire_02att_cult_roman	True men fear nothing!	true
vo_unit_texts_text_Land_SA_RO_Rally_and_Inspire_03att_cult_roman	Now is not our time, fight!	true
vo_unit_texts_text_Naval_UO_BA_Up_Anchor_01att_cult_eastern	Up anchor!	true
vo_unit_texts_text_Naval_UO_EA_Up_Anchor_01att_cult_eastern	Up anchor!	true
vo_unit_texts_text_Naval_UO_BA_Up_Anchor_02att_cult_eastern	Raise the anchor!	true
vo_unit_texts_text_Naval_UO_EA_Up_Anchor_02att_cult_eastern	Raise the anchor!	true
vo_unit_texts_text_Naval_UO_BA_Up_Anchor_03att_cult_eastern	Haul up the anchor!	true
vo_unit_texts_text_Naval_UO_EA_Up_Anchor_03att_cult_eastern	Haul up the anchor!	true
vo_unit_texts_text_Naval_UO_BA_Up_Anchor_04att_cult_eastern	Lift the anchor!	true
vo_unit_texts_text_Naval_UO_EA_Up_Anchor_04att_cult_eastern	Anchors aweigh!	true
vo_unit_texts_text_Naval_UO_BA_Up_Anchor_05att_cult_eastern	Anchors a loft!	true
vo_unit_texts_text_Naval_UO_EA_Up_Anchor_05att_cult_eastern	Anchors a loft!	true
vo_unit_texts_text_Naval_UO_BA_Go_Straight_01att_cult_eastern	Hold the course!	true
vo_unit_texts_text_Naval_UO_BA_Go_Straight_03att_cult_eastern	Keep a steady course!	true
vo_unit_texts_text_Naval_UO_EA_Go_Straight_04att_cult_eastern	Hold straight!	true
vo_unit_texts_text_Naval_UO_BA_Go_Straight_02att_cult_eastern	Straight ahead!	true
vo_unit_texts_text_Naval_UO_EA_Go_Straight_05att_cult_eastern	Straight course!	true
vo_unit_texts_text_Naval_UO_BA_Go_Straight_05att_cult_eastern	Straight course!	true
vo_unit_texts_text_Naval_UO_EA_Go_Straight_02att_cult_eastern	Straight ahead!	true
vo_unit_texts_text_Naval_UO_BA_Go_Straight_04att_cult_eastern	Hold straight!	true
vo_unit_texts_text_Naval_UO_EA_Go_Straight_03att_cult_eastern	Keep a steady course!	true
vo_unit_texts_text_Naval_UO_EA_Go_Straight_01att_cult_eastern	Keep this course!	true
vo_unit_texts_text_Naval_US_RO_Selection_generic_01att_cult_roman	Your orders?	true
vo_unit_texts_text_Naval_US_RO_Selection_generic_02att_cult_roman	By your command!	true
vo_unit_texts_text_Naval_US_RO_Selection_generic_03att_cult_roman	Ready and awaiting orders!	true
vo_unit_texts_text_Naval_US_RO_Selection_generic_04att_cult_roman	Ships at your command!	true
vo_unit_texts_text_Naval_US_RO_Selection_generic_05att_cult_roman	We await your command!	true
vo_unit_texts_text_Naval_SA_BA_Use_the_Whip_01att_cult_barbarian	Pull! Or you'll be sorry!	true
vo_unit_texts_text_Naval_SA_BA_Use_the_Whip_02att_cult_barbarian	Row you dogs!	true
vo_unit_texts_text_Naval_SA_BA_Use_the_Whip_03att_cult_barbarian	Harder! Put your backs in to it!	true
vo_unit_texts_text_Land_US_RO_Selection_Agrianian_Axemenatt_cult_eastern	Agrianian Axemen!	true
vo_unit_texts_text_Land_Mounted_US_RO_Selection_Companion_Cavalryatt_cult_roman	Companion Cavalry!	true
vo_unit_texts_text_Naval_UR_RO_Attack_01att_cult_roman	Engage!	true
vo_unit_texts_text_Naval_UR_RO_Attack_02att_cult_roman	Smash them!	true
vo_unit_texts_text_Naval_UR_RO_Attack_03att_cult_roman	Death to the enemy!	true
vo_unit_texts_text_Naval_UR_RO_Attack_04att_cult_roman	Destroy them!	true
vo_unit_texts_text_Naval_UR_RO_Attack_05att_cult_roman	Annihilate them!	true
vo_unit_texts_text_Land_SA_EA_Get_Into_Formation_03att_cult_eastern	Organise yourselves!	true
vo_unit_texts_text_Land_SA_EA_Get_Into_Formation_02att_cult_eastern	Into formation!	true
vo_unit_texts_text_Land_SA_EA_Get_Into_Formation_01att_cult_eastern	Formation! Move!	true
vo_unit_texts_text_Land_US_RO_Selection_Praetorian_Guardatt_cult_eastern	Praetorian Guard!	true
vo_unit_texts_text_Land_US_RO_Selection_Chariot_generic_1att_cult_eastern	Charioteers ready!	true
vo_unit_texts_text_Land_US_RO_Selection_Chariot_generic_3att_cult_eastern	Chariots at your command!	true
vo_unit_texts_text_Land_US_RO_Selection_Chariot_generic_2att_cult_eastern	Chariots awaiting orders!	true
vo_unit_texts_text_Land_US_RO_Selection_Artillery_field_generic_2att_cult_eastern	Field artillery awaiting orders!	true
vo_unit_texts_text_Land_US_RO_Selection_Artillery_siege_generic_2att_cult_eastern	Siege artillery awaiting orders!	true
vo_unit_texts_text_Land_US_RO_Selection_Artillery_field_generic_3att_cult_eastern	Field artillery! Yours to command!	true
vo_unit_texts_text_Land_US_RO_Selection_Artillery_siege_generic_3att_cult_eastern	Siege artillery at your command!	true
vo_unit_texts_text_Land_US_RO_Selection_Artillery_field_generic_1att_cult_eastern	Field artillery ready!	true
vo_unit_texts_text_Land_US_RO_Selection_Artillery_siege_generic_1att_cult_eastern	Siege artillery ready!	true
vo_unit_texts_text_Land_US_BA_Selection_Cavalry_shock_generic_1att_cult_barbarian	Heavy horsemen!	true
vo_unit_texts_text_Land_US_BA_Selection_Cavalry_shock_generic_2att_cult_barbarian	Ready to ride!	true
vo_unit_texts_text_Land_US_BA_Selection_Cavalry_shock_generic_3att_cult_barbarian	Mounted death!	true
vo_unit_texts_text_Land_US_BA_Selection_Cavalry_shock_generic_4att_cult_barbarian	Heavy cavalry!	true
vo_unit_texts_text_Land_US_BA_Selection_Cavalry_shock_generic_5att_cult_barbarian	We have no fear!	true
vo_unit_texts_text_Land_UR_BA_Attack_01att_cult_barbarian	Ahhhh!	true
vo_unit_texts_text_Land_UR_BA_Attack_02att_cult_barbarian	Kill!	true
vo_unit_texts_text_Land_UR_BA_Attack_03att_cult_barbarian	Attack!	true
vo_unit_texts_text_Land_UR_BA_Attack_04att_cult_barbarian	Yahhh haaa!	true
vo_unit_texts_text_Land_UR_BA_Attack_05att_cult_barbarian	Waggghhhh!	true
vo_unit_texts_text_Land_UO_RO_Melee_Button_on__01att_cult_roman	Ready your weapons!	true
vo_unit_texts_text_Land_UO_RO_Melee_Button_on__02att_cult_roman	Ready men!	true
vo_unit_texts_text_Land_UO_RO_Melee_Button_on__03att_cult_roman	Prepare to engage!	true
vo_unit_texts_text_Land_UO_RO_Melee_Button_on__04att_cult_roman	Ready yourselves!	true
vo_unit_texts_text_Land_UO_RO_Melee_Button_on__05att_cult_roman	Draw weapons!	true
vo_unit_texts_text_Land_UO_BA_Generic_Order_Briton_01att_cult_barbarian	Britannia protects us!	true
vo_unit_texts_text_Land_UO_BA_Generic_Order_Briton_02att_cult_barbarian	Anything for the gods!	true
vo_unit_texts_text_Land_UO_BA_Generic_Order_Briton_03att_cult_barbarian	Ancestors honour us!	true
vo_unit_texts_text_Land_UO_BA_Generic_Order_Briton_04att_cult_barbarian	For Briton!	true
vo_unit_texts_text_Land_UO_BA_Generic_Order_Briton_05att_cult_barbarian	For the Mother!	true
vo_unit_texts_text_Land_GO_BA_Group_Created_01att_cult_barbarian	Battle group ready!	true
vo_unit_texts_text_Land_GO_BA_Group_Created_02att_cult_barbarian	Grouped and ready!	true
vo_unit_texts_text_Land_GO_BA_Group_Created_03att_cult_barbarian	Battle group awaiting your word!	true
vo_unit_texts_text_Land_GO_BA_Group_Created_04att_cult_barbarian	Grouped and waiting!	true
vo_unit_texts_text_Land_GO_BA_Group_Created_05att_cult_barbarian	Warriors grouped!	true
vo_unit_texts_text_Naval_US_RO_Selection_Toweratt_cult_eastern	Towers ready!	true
vo_unit_texts_text_Land_US_RO_Selection_Velitesatt_cult_eastern	Velites!	true
vo_unit_texts_text_Land_SA_BA_Steady_Advance_01att_cult_barbarian	Forward! No running!	true
vo_unit_texts_text_Land_SA_BA_Steady_Advance_02att_cult_barbarian	Save your strength!	true
vo_unit_texts_text_Land_SA_BA_Steady_Advance_03att_cult_barbarian	Easy! They're not going anywhere!	true
vo_unit_texts_text_Land_US_BA_Selection_Cavalry_melee_generic_1att_cult_barbarian	Riders ready!	true
vo_unit_texts_text_Land_US_BA_Selection_Cavalry_melee_generic_2att_cult_barbarian	Mounted death!	true
vo_unit_texts_text_Land_US_BA_Selection_Cavalry_melee_generic_3att_cult_barbarian	Our horses love blood!	true
vo_unit_texts_text_Land_US_BA_Selection_Cavalry_melee_generic_4att_cult_barbarian	Swift horsemen!	true
vo_unit_texts_text_Land_US_BA_Selection_Cavalry_melee_generic_5att_cult_barbarian	Mounted warriors!	true
vo_unit_texts_text_Land_US_BA_Selection_Edetani_Noblesatt_cult_barbarian	Edetani Nobles!	true
vo_unit_texts_text_Land_US_RO_Selection_Rorariiatt_cult_eastern	Rorarii!	true
vo_unit_texts_text_Land_UO_RO_Move_Siege_Tower_01att_cult_roman	Siege towers, now!	true
vo_unit_texts_text_Land_UO_RO_Move_Siege_Tower_02att_cult_roman	Get that tower moving!	true
vo_unit_texts_text_Land_UO_RO_Move_Siege_Tower_03att_cult_roman	Move the tower!	true
vo_unit_texts_text_Land_UO_RO_Move_Siege_Tower_04att_cult_roman	To the tower!	true
vo_unit_texts_text_Land_UO_RO_Move_Siege_Tower_05att_cult_roman	Put your backs in to it!	true
vo_unit_texts_text_Land_UO_EA_Hold_Position_off_05att_cult_eastern	Ready yourselves!	true
vo_unit_texts_text_Land_UO_EA_Hold_Position_off_04att_cult_eastern	Positions!	true
vo_unit_texts_text_Land_UO_EA_Hold_Position_off_03att_cult_eastern	Wait on my order!	true
vo_unit_texts_text_Land_GO_RO_Unlock_Formation_01att_cult_roman	As you were!	true
vo_unit_texts_text_Land_GO_RO_Unlock_Formation_02att_cult_roman	Back to your positions!	true
vo_unit_texts_text_Land_GO_RO_Unlock_Formation_03att_cult_roman	Break formation!	true
vo_unit_texts_text_Land_GO_RO_Unlock_Formation_04att_cult_roman	Return to your positions!	true
vo_unit_texts_text_Land_GO_RO_Unlock_Formation_05att_cult_roman	Leave formation!	true
vo_unit_texts_text_Land_UO_EA_Hold_Position_off_02att_cult_eastern	Prepare to move out!	true
vo_unit_texts_text_Land_UO_EA_Hold_Position_off_01att_cult_eastern	Ready!	true
vo_unit_texts_text_Land_Mounted_US_BA_Selection_Edetani_Noble_Cavalryatt_cult_barbarian	Edetani Noble Cavalry!	true
vo_unit_texts_text_Land_Mounted_US_EA_Selection_Numidian_Noble_Cavalryatt_cult_eastern	Numidian Noble Cavalry!	true
vo_unit_texts_text_Naval_UO_BA_Repair_Ship_02att_cult_eastern	Get to the repairs!	true
vo_unit_texts_text_Naval_UO_EA_Repair_Ship_05att_cult_eastern	Repairs, now!	true
vo_unit_texts_text_Naval_UO_BA_Repair_Ship_03att_cult_eastern	Repair the ships!	true
vo_unit_texts_text_Naval_UO_EA_Repair_Ship_04att_cult_eastern	Fix that damage!	true
vo_unit_texts_text_Naval_UO_BA_Repair_Ship_01att_cult_eastern	Look to repairs!	true
vo_unit_texts_text_Naval_UO_EA_Repair_Ship_01att_cult_eastern	We need repairs!	true
vo_unit_texts_text_Naval_UO_BA_Repair_Ship_04att_cult_eastern	See to the repairs!	true
vo_unit_texts_text_Naval_UO_EA_Repair_Ship_03att_cult_eastern	We are damaged. Repairs!	true
vo_unit_texts_text_Naval_UO_BA_Repair_Ship_05att_cult_eastern	Repairs, now!	true
vo_unit_texts_text_Naval_UO_EA_Repair_Ship_02att_cult_eastern	Get to the repairs!	true
vo_unit_texts_text_Naval_GO_RO_Unlock_Formation_01att_cult_eastern	As you were!	true
vo_unit_texts_text_Naval_GO_RO_Unlock_Formation_02att_cult_eastern	Back to your positions!	true
vo_unit_texts_text_Naval_US_BA_Selection_Toweratt_cult_barbarian	Towers ready!	true
vo_unit_texts_text_Naval_GO_RO_Unlock_Formation_03att_cult_eastern	Break formation!	true
vo_unit_texts_text_Naval_GO_RO_Unlock_Formation_04att_cult_eastern	Return to your positions!	true
vo_unit_texts_text_Naval_GO_RO_Unlock_Formation_05att_cult_eastern	Leave formation!	true
vo_unit_texts_text_Land_US_RO_Selection_Perioikoi_Spearsatt_cult_eastern	Perioikoi Spears!	true
